ZipCode,Total_Population,Male_Total,Female_Total,X0_to_19,X20_to_39,X40_to_59,X60_plus
30165,70,33,37,12,8,25,25
31905,9,5,4,2,3,2,2
35004,10427,5037,5390,2698,3394,2674,1661
35005,7942,3806,4136,2070,1961,2221,1690
35006,3121,1594,1527,830,688,970,633
35007,26225,12886,13339,7930,7120,7486,3689
35010,20816,9967,10849,5305,4897,5783,4831
35013,124,68,56,52,54,15,3
35014,4546,2453,2093,982,1226,1489,849
35016,16778,8183,8595,4428,3774,4727,3849
35019,2117,1068,1049,565,491,617,444
35020,27139,12796,14343,7555,6924,7459,5201
35022,18888,8956,9932,4748,4636,5413,4091
35023,25436,13005,12431,5920,6835,7243,5438
35031,7933,3985,3948,2212,1926,2146,1649
35032,66,29,37,20,18,16,12
35033,3403,1680,1723,861,773,1048,721
35034,5541,3671,1870,1045,2111,1667,718
35035,1581,780,801,423,402,462,294
35036,297,119,178,103,78,67,49
35040,14965,7230,7735,4195,5251,3516,2003
35042,5831,2854,2977,1490,1419,1538,1384
35043,9234,4505,4729,2861,2372,2709,1292
35044,7713,3581,4132,2187,1851,2071,1604
35045,14870,7237,7633,3990,3855,3918,3107
35046,5108,2545,2563,1349,1216,1461,1082
35049,3996,1997,1999,1112,1022,1087,775
35051,8787,4639,4148,2181,2413,2553,1640
35052,277,67,210,14,6,4,253
35053,2617,1322,1295,515,478,814,810
35054,4101,2029,2072,893,780,1265,1163
35055,19427,9305,10122,4924,5008,4909,4586
35057,12630,6265,6365,3347,2978,3631,2674
35058,9936,4959,4977,2684,2387,2702,2163
35060,414,192,222,101,98,126,89
35061,1465,702,763,331,344,438,352
35062,7944,3932,4012,2082,1852,2257,1753
35063,3866,1923,1943,1050,929,1126,761
35064,11458,5049,6409,3253,2853,3156,2196
35068,7232,3500,3732,1818,2459,1713,1242
35070,265,132,133,56,60,82,67
35071,15661,7285,8376,3729,3719,4435,3778
35072,5193,2547,2646,1350,1130,1575,1138
35073,2382,1148,1234,507,507,727,641
35074,93,47,46,28,19,33,13
35077,13142,6478,6664,3304,3216,3497,3125
35078,2082,1003,1079,534,423,656,469
35079,8810,4392,4418,2448,2193,2523,1646
35080,15881,7645,8236,5241,4558,4361,1721
35082,7,3,4,1,2,4,0
35083,3268,1616,1652,890,798,908,672
35085,8933,4377,4556,2525,2367,2431,1610
35087,2115,1069,1046,552,490,651,422
35089,2238,1093,1145,559,498,723,458
35091,2719,1317,1402,888,718,776,337
35094,14212,6902,7310,3477,3750,4064,2921
35096,7815,3866,3949,2028,1944,2352,1491
35097,1748,864,884,464,388,507,389
35098,1375,696,679,388,374,349,264
35111,16140,7886,8254,4141,4311,4679,3009
35112,801,404,397,216,228,245,112
35114,7172,3618,3554,2246,1900,2073,953
35115,14118,6788,7330,3800,4572,3413,2333
35116,4240,2058,2182,1089,890,1351,910
35117,5367,2611,2756,1377,1252,1583,1155
35118,3138,1480,1658,754,700,885,799
35119,116,52,64,26,18,37,35
35120,13842,6885,6957,4023,3929,3852,2038
35121,15570,7617,7953,4154,3767,4053,3596
35124,23020,11198,11822,6244,6589,6506,3681
35125,10456,5048,5408,2998,2790,2812,1856
35126,21725,10629,11096,5901,5161,6922,3741
35127,10099,4811,5288,2663,2202,3108,2126
35128,10197,4968,5229,2520,2363,3014,2300
35130,3233,1594,1639,757,717,972,787
35131,4159,2083,2076,1138,978,1203,840
35133,3907,1978,1929,1015,878,1156,858
35135,1812,909,903,460,416,592,344
35136,1796,923,873,337,357,561,541
35139,150,67,83,39,37,44,30
35143,3281,1637,1644,710,631,1057,883
35146,10948,6136,4812,2564,2770,3631,1983
35147,5468,2730,2738,1553,1732,1457,726
35148,2702,1250,1452,716,606,709,671
35149,630,308,322,172,162,177,119
35150,18472,8556,9916,4861,4542,5145,3924
35151,7632,3845,3787,1923,1673,2320,1716
35160,26822,13297,13525,6763,6803,7678,5578
35171,3281,1658,1623,922,868,925,566
35172,2986,1465,1521,749,712,874,651
35173,25176,12201,12975,7017,5533,7901,4725
35175,5041,2542,2499,1226,1098,1600,1117
35176,921,473,448,206,211,280,224
35178,3378,1641,1737,849,737,1050,742
35179,8958,4508,4450,2383,2121,2668,1786
35180,13794,6779,7015,3690,3460,3949,2695
35183,706,348,358,169,165,196,176
35184,5841,2934,2907,1631,1496,1650,1064
35186,4931,2489,2442,1332,1131,1436,1032
35187,32,19,13,8,11,5,8
35188,2715,1366,1349,807,712,755,441
35203,3798,2424,1374,490,1556,1210,542
35204,10337,4923,5414,2416,2561,3009,2351
35205,19686,9971,9715,3574,9101,4195,2816
35206,17177,7868,9309,4933,4176,5263,2805
35207,9010,4213,4797,2615,2091,2319,1985
35208,14855,6801,8054,4228,3766,4474,2387
35209,29544,14113,15431,7528,12135,6166,3715
35210,13952,6541,7411,3000,3688,3917,3347
35211,26236,11629,14607,6439,7328,6855,5614
35212,11539,5471,6068,3158,3456,3275,1650
35213,13185,6131,7054,3625,3122,3539,2899
35214,19592,8950,10642,5040,4560,5667,4325
35215,46951,21308,25643,14987,13190,12166,6608
35216,36408,17337,19071,9575,12225,8487,6121
35217,13729,6321,7408,3937,3360,3739,2693
35218,7353,3381,3972,2163,1904,2188,1098
35221,4834,2161,2673,1115,1029,1428,1262
35222,7884,3923,3961,1673,2521,2285,1405
35223,11043,5292,5751,3011,1816,3630,2586
35224,6094,2900,3194,1722,1522,1733,1117
35226,31471,15068,16403,8005,8165,8826,6475
35228,10419,4656,5763,3071,2501,3018,1829
35229,940,156,784,493,447,0,0
35233,1308,627,681,242,823,188,55
35234,6311,3098,3213,1328,1607,2054,1322
35235,19484,8926,10558,5157,5404,5338,3585
35242,49545,24273,25272,13566,12453,15730,7796
35243,17328,8177,9151,3729,5319,4575,3705
35244,32390,15510,16880,9043,8550,9804,4993
35254,1403,704,699,541,752,58,52
35401,39878,19395,20483,11708,18050,5783,4337
35404,21251,10509,10742,5289,8202,4721,3039
35405,37661,17735,19926,10344,12552,9311,5454
35406,13864,6647,7217,3547,3523,3810,2984
35441,1060,512,548,238,226,326,270
35442,4972,2321,2651,1399,1046,1425,1102
35443,2009,968,1041,610,441,587,371
35444,3699,1807,1892,1082,1097,987,533
35446,2234,1100,1134,618,528,677,411
35447,3460,1685,1775,878,844,1014,724
35452,3880,1978,1902,1075,923,1155,727
35453,11127,5552,5575,3056,3085,3148,1838
35456,3759,1875,1884,1037,887,1121,714
35457,82,46,36,22,10,37,13
35458,594,283,311,174,136,181,103
35459,872,395,477,207,169,268,228
35460,834,406,428,251,178,252,153
35461,1952,952,1000,409,377,637,529
35462,5061,2349,2712,1355,1011,1448,1247
35463,1749,875,874,455,390,553,351
35464,654,287,367,220,156,171,107
35466,6075,2928,3147,1669,1388,1729,1289
35469,221,111,110,47,37,72,65
35470,5468,2515,2953,1446,1769,1326,927
35473,14909,7182,7727,3616,4394,3891,3008
35474,6180,2995,3185,1771,1543,1770,1096
35475,14507,7174,7333,4157,3826,4236,2288
35476,8106,3627,4479,2049,2648,1602,1807
35477,335,159,176,87,71,98,79
35480,1343,650,693,352,352,369,270
35481,3668,1718,1950,934,737,1070,927
35490,3857,1953,1904,1148,1176,1013,520
35501,10424,5015,5409,2558,2667,2803,2396
35503,9068,4520,4548,2299,2103,2589,2077
35504,13596,6625,6971,3360,3099,3942,3195
35540,2415,1225,1190,613,574,674,554
35541,3597,1786,1811,747,671,1163,1016
35542,1021,531,490,256,223,296,246
35543,1137,580,557,291,274,322,250
35544,673,334,339,148,118,210,197
35545,100,46,54,22,16,21,41
35546,3901,1944,1957,1076,910,1056,859
35548,1558,749,809,366,351,408,433
35549,4341,2129,2212,1073,957,1241,1070
35550,5605,2662,2943,1382,1274,1637,1312
35552,1044,533,511,263,234,279,268
35553,4680,2281,2399,1139,1035,1381,1125
35554,1186,602,584,282,251,378,275
35555,10177,4960,5217,2528,2208,2856,2585
35559,57,28,29,22,11,17,7
35563,4340,2062,2278,1054,870,1220,1196
35564,2361,1151,1210,570,525,644,622
35565,13485,6637,6848,3424,3011,3912,3138
35570,11145,5709,5436,2554,2618,3157,2816
35571,895,454,441,216,206,269,204
35572,1131,571,560,266,204,367,294
35574,1507,767,740,314,289,441,463
35575,1018,489,529,248,219,287,264
35576,3217,1558,1659,740,687,897,893
35577,38,15,23,4,7,12,15
35578,5833,2883,2950,1514,1385,1709,1225
35579,3136,1532,1604,772,713,951,700
35580,3791,1843,1948,928,845,1138,880
35581,5778,2879,2899,1502,1390,1635,1251
35582,4093,1961,2132,1040,956,1094,1003
35584,460,219,241,115,109,135,101
35585,1418,711,707,372,291,459,296
35586,4469,2185,2284,1108,937,1313,1111
35587,1025,519,506,218,232,334,241
35592,4664,2237,2427,1193,1029,1316,1126
35593,1931,990,941,485,432,568,446
35594,7794,3815,3979,1911,1712,2193,1978
35601,34434,17115,17319,9243,9737,8798,6656
35603,30545,14720,15825,7994,7357,8886,6308
35610,2252,1099,1153,555,492,668,537
35611,25251,12155,13096,6354,6754,6783,5360
35613,20546,11334,9212,4880,5576,6625,3465
35614,7456,3773,3683,2046,1877,2153,1380
35615,68,32,36,18,12,29,9
35616,4043,1970,2073,921,834,1155,1133
35618,1870,874,996,461,444,536,429
35619,5135,2586,2549,1397,1231,1571,936
35620,8868,4448,4420,2549,2226,2612,1481
35621,2852,1444,1408,778,688,838,548
35622,7388,3659,3729,1856,1729,2120,1683
35630,32629,14944,17685,7952,9859,7447,7371
35633,20877,10275,10602,5238,4687,6253,4699
35634,9711,4727,4984,2338,1839,3076,2458
35640,24267,11911,12356,6583,5750,7163,4771
35643,2941,1424,1517,711,660,951,619
35645,14060,6853,7207,3722,3132,4151,3055
35646,4635,2244,2391,1113,988,1419,1115
35647,1030,524,506,278,223,308,221
35648,3635,1812,1823,957,753,1031,894
35649,68,33,35,14,7,25,22
35650,13971,6784,7187,3617,3213,4068,3073
35651,1312,657,655,364,326,349,273
35652,8190,3948,4242,1964,1758,2423,2045
35653,11150,5523,5627,3264,2962,2743,2181
35654,8685,4423,4262,2438,2351,2193,1703
35660,9042,4214,4828,2213,2237,2455,2137
35661,16617,8027,8590,4236,3772,4813,3796
35670,7676,3871,3805,1927,1706,2492,1551
35671,2107,1037,1070,540,462,698,407
35672,6445,3120,3325,1685,1468,1902,1390
35673,8199,4157,4042,2198,1944,2555,1502
35674,18475,8878,9597,4570,4236,5239,4430
35677,1921,997,924,464,446,584,427
35739,5146,2504,2642,1414,1293,1485,954
35740,3482,1696,1786,908,780,1007,787
35741,2933,1439,1494,737,540,981,675
35744,2570,1277,1293,695,597,728,550
35745,288,154,134,54,55,98,81
35746,856,430,426,232,215,248,161
35747,5901,2930,2971,1579,1330,1733,1259
35748,6276,3163,3113,1588,1254,2159,1275
35749,20575,10182,10393,6180,5092,6580,2723
35750,12783,6278,6505,3676,3096,3986,2025
35751,265,130,135,68,52,80,65
35752,2047,1001,1046,485,459,626,477
35754,5362,2689,2673,1362,1216,1635,1149
35755,586,301,285,105,88,166,227
35756,9016,4416,4600,2693,2377,2824,1122
35757,12840,6211,6629,3831,3217,4072,1720
35758,41875,20745,21130,12469,10286,13863,5257
35759,6406,3111,3295,1770,1481,1998,1157
35760,5065,2486,2579,1287,1224,1573,981
35761,11630,5745,5885,3377,3071,3470,1712
35763,14216,7016,7200,4408,2876,4534,2398
35764,653,332,321,152,148,196,157
35765,4013,2022,1991,1029,944,1145,895
35766,150,80,70,32,33,56,29
35768,11581,5632,5949,2802,2809,3239,2731
35769,9537,4619,4918,2304,2008,2691,2534
35771,3645,1820,1825,944,835,1076,790
35772,4908,2429,2479,1232,1177,1353,1146
35773,13018,6455,6563,3834,3547,3830,1807
35774,165,92,73,65,30,36,34
35775,636,333,303,153,140,214,129
35776,3395,1669,1726,872,764,1011,748
35801,21509,10593,10916,4337,5307,6114,5751
35802,21297,10167,11130,4600,4582,5916,6199
35803,25471,12438,13033,6259,5182,8358,5672
35805,22498,11395,11103,6009,8250,5312,2927
35806,18951,9396,9555,4452,6265,5397,2837
35808,1946,1305,641,754,967,210,15
35810,30617,14335,16282,8813,8283,7701,5820
35811,25955,12715,13240,6682,6381,7888,5004
35816,15228,7468,7760,3912,6408,3014,1894
35824,6070,3069,3001,1408,2561,1515,586
35896,636,147,489,321,310,4,1
35901,20045,9592,10453,4968,4882,5513,4682
35903,18088,8693,9395,4667,4550,5054,3817
35904,14194,6857,7337,3524,3311,3855,3504
35905,6410,3174,3236,1573,1447,1877,1513
35906,9897,4710,5187,2512,2340,2722,2323
35907,8345,4059,4286,2222,1924,2490,1709
35950,20826,10412,10414,6382,6167,4854,3423
35951,13098,6468,6630,4133,3540,3233,2192
35952,7727,3793,3934,2108,1826,2123,1670
35953,7319,3713,3606,1901,1759,2143,1516
35954,12416,6055,6361,3183,3039,3475,2719
35956,8842,4424,4418,2470,2041,2503,1828
35957,15693,7654,8039,4553,4075,3914,3151
35958,3582,1774,1808,923,813,1080,766
35959,4836,2393,2443,1114,940,1444,1338
35960,10087,4948,5139,2327,2077,2874,2809
35961,6514,3248,3266,1912,1716,1613,1273
35962,8300,4116,4184,2676,2107,2132,1385
35963,1704,856,848,464,406,502,332
35966,3914,1931,1983,1031,903,1146,834
35967,16630,8121,8509,4840,4219,4334,3237
35968,4575,2326,2249,1081,1201,1269,1024
35971,4914,2445,2469,1262,1147,1458,1047
35972,1139,573,566,284,272,321,262
35973,2870,1416,1454,715,635,864,656
35974,1589,768,821,437,374,431,347
35975,1058,523,535,266,258,297,237
35976,16272,7934,8338,3842,3444,4797,4189
35978,5390,2692,2698,1451,1222,1543,1174
35979,1398,695,703,406,349,366,277
35980,5161,2568,2593,1616,1307,1362,876
35981,2141,1027,1114,550,487,592,512
35983,3738,1847,1891,918,854,1123,843
35984,1889,914,975,382,350,526,631
35986,7744,3764,3980,2118,1899,2083,1644
35987,2666,1338,1328,666,648,743,609
35988,1940,954,986,608,540,456,336
35989,3573,1765,1808,1078,866,989,640
35990,38,24,14,10,8,9,11
36003,1975,950,1025,484,467,607,417
36005,1522,761,761,332,291,479,420
36006,1313,631,682,389,300,365,259
36009,2566,1241,1325,683,554,697,632
36010,4677,2206,2471,1074,1009,1335,1259
36013,562,270,292,167,94,207,94
36016,5150,3336,1814,920,1889,1475,866
36017,3318,2298,1020,544,1302,1002,470
36020,1123,557,566,331,262,302,228
36022,13092,5994,7098,3390,3827,3994,1881
36024,5428,2647,2781,1346,1123,1592,1367
36025,5729,3962,1767,1091,2495,1458,685
36026,1089,553,536,196,164,360,369
36027,16261,7610,8651,4564,3642,4385,3670
36028,1746,868,878,432,337,538,439
36029,723,345,378,175,159,218,171
36030,491,243,248,136,94,139,122
36031,156,60,96,47,34,35,40
36032,2339,1076,1263,714,526,641,458
36033,4299,2039,2260,983,905,1187,1224
36034,807,391,416,196,174,245,192
36035,1913,981,932,470,409,548,486
36036,2003,973,1030,474,448,646,435
36037,14074,6551,7523,3955,3388,3785,2946
36038,57,25,32,13,5,25,14
36039,253,106,147,83,54,69,47
36040,3976,1851,2125,1098,983,1172,723
36041,1318,677,641,374,309,376,259
36042,1500,731,769,372,325,435,368
36043,3666,1801,1865,843,768,1218,837
36046,1490,739,751,398,337,444,311
36047,1396,669,727,311,312,426,347
36048,1459,680,779,349,315,379,416
36049,5706,2715,2991,1498,1336,1542,1330
36051,2304,1132,1172,699,556,679,370
36052,739,371,368,183,95,286,175
36053,1967,924,1043,512,397,603,455
36054,15066,7297,7769,4651,4291,4010,2114
36064,6753,3367,3386,1959,1604,2067,1123
36066,19089,9087,10002,5689,5112,5075,3213
36067,26954,13195,13759,7938,6783,7732,4501
36069,1935,931,1004,367,376,584,608
36071,766,374,392,206,185,218,157
36075,2226,1056,1170,564,507,697,458
36078,13179,6401,6778,3740,3108,3687,2644
36079,9339,4548,4791,2426,2935,2326,1652
36080,2271,1118,1153,520,427,723,601
36081,15267,7201,8066,4017,5376,3317,2557
36082,1667,741,926,857,807,3,0
36083,9563,4458,5105,2411,2409,2599,2144
36088,4767,2034,2733,1575,1739,768,685
36089,8760,4906,3854,2180,2568,2475,1537
36091,3648,1810,1838,1028,926,1037,657
36092,20274,9251,11023,5432,5441,5834,3567
36093,9456,4686,4770,2484,1966,3046,1960
36104,9468,5087,4381,2535,3062,2334,1537
36105,12043,5581,6462,3238,2811,3430,2564
36106,15211,7004,8207,3760,4617,3837,2997
36107,9589,4749,4840,2809,3110,2229,1441
36108,21306,9844,11462,6300,5211,5478,4317
36109,24777,11545,13232,5872,6127,6668,6110
36110,12997,6202,6795,3993,3694,3283,2027
36111,12176,5556,6620,3434,3142,3293,2307
36112,553,423,130,102,439,9,3
36113,1902,1381,521,396,941,533,32
36115,623,328,295,299,245,77,2
36116,43790,19946,23844,14200,13885,10913,4792
36117,50268,24252,26016,12798,16289,13296,7885
36201,20156,9691,10465,5365,5180,5643,3968
36203,18799,9080,9719,5189,4874,5162,3574
36205,635,292,343,126,184,154,171
36206,11427,5436,5991,3071,2851,3128,2377
36207,19801,9446,10355,4623,4698,5737,4743
36250,4603,2243,2360,1277,1121,1373,832
36251,5103,2468,2635,1226,1176,1458,1243
36255,969,508,461,236,221,283,229
36256,1570,754,816,380,337,501,352
36258,1599,806,793,386,357,456,400
36260,4247,2074,2173,1167,997,1228,855
36262,1448,733,715,407,349,418,274
36263,658,335,323,163,135,201,159
36264,8659,4284,4375,2255,1980,2391,2033
36265,21060,10092,10968,5662,7029,4787,3582
36266,5582,2735,2847,1429,1192,1555,1406
36267,35,19,16,8,9,15,3
36268,5432,2624,2808,1452,1332,1517,1131
36269,1395,691,704,401,309,389,296
36271,6023,3089,2934,1600,1357,1900,1166
36272,13389,6690,6699,3463,3041,3868,3017
36273,2914,1454,1460,773,658,851,632
36274,11199,5252,5947,3122,2568,3022,2487
36276,2592,1243,1349,774,581,701,536
36277,5420,2536,2884,1553,1419,1436,1012
36278,4366,2187,2179,1019,864,1269,1214
36279,2645,1328,1317,674,589,830,552
36280,3932,1968,1964,1020,795,1159,958
36301,35759,16973,18786,9978,9232,9518,7031
36303,30217,14471,15746,8201,7721,8221,6074
36305,14470,6924,7546,3754,3847,4034,2835
36310,6783,3294,3489,1537,1372,1825,2049
36311,2770,1366,1404,707,613,804,646
36312,6187,3066,3121,1564,1374,1805,1444
36313,285,136,149,70,52,87,76
36314,595,299,296,150,125,186,134
36316,1722,868,854,398,373,524,427
36317,590,286,304,144,116,178,152
36318,1296,630,666,275,263,373,385
36319,2276,1136,1140,559,470,683,564
36320,3837,1891,1946,966,817,1210,844
36321,1632,789,843,441,386,468,337
36322,9072,4624,4448,2407,2547,2533,1585
36323,8255,4117,4138,2038,1856,2339,2022
36330,35530,17559,17971,9805,10368,9012,6345
36340,5490,2641,2849,1329,1240,1495,1426
36343,1579,737,842,362,314,473,430
36344,5732,2803,2929,1423,1245,1652,1412
36345,7822,3691,4131,2101,1853,2189,1679
36346,1456,731,725,389,318,400,349
36350,6540,3152,3388,1859,1818,1719,1144
36351,3146,1549,1597,758,700,970,718
36352,4885,2440,2445,1295,1138,1417,1035
36353,1968,986,982,503,431,551,483
36360,20157,9648,10509,5130,4566,5693,4768
36362,4637,2533,2104,1861,2512,241,23
36370,972,480,492,238,232,278,224
36371,720,348,372,156,149,236,179
36373,581,277,304,121,129,165,166
36374,970,482,488,224,193,283,270
36375,7390,3591,3799,1978,1695,2120,1597
36376,2445,1180,1265,650,573,743,479
36401,8314,3987,4327,2283,1753,2291,1987
36420,10673,5042,5631,2816,2528,2800,2529
36421,9241,4640,4601,2234,2064,2742,2201
36425,1008,472,536,259,205,317,227
36426,16202,7762,8440,4309,3720,4408,3765
36432,2420,1191,1229,566,499,731,624
36435,579,285,294,164,116,173,126
36436,531,253,278,148,117,163,103
36439,583,280,303,193,177,114,99
36441,3576,1714,1862,944,836,1029,767
36442,3555,1735,1820,857,716,995,987
36444,702,346,356,156,117,222,207
36445,5050,2439,2611,1400,1093,1479,1078
36446,490,231,259,121,115,136,118
36451,4977,2403,2574,1303,1163,1368,1143
36453,2198,1068,1130,531,400,654,613
36454,51,23,28,10,7,14,20
36455,465,235,230,127,108,116,114
36456,1820,901,919,412,388,558,462
36460,10738,5133,5605,3094,2387,2957,2300
36467,10058,4770,5288,2564,2101,2751,2642
36470,98,43,55,26,19,27,26
36471,1257,601,656,341,248,385,283
36473,106,50,56,32,21,27,26
36474,2926,1439,1487,704,650,862,710
36475,2208,1089,1119,575,431,693,509
36476,51,27,24,8,7,24,12
36477,4946,2448,2498,1281,1140,1353,1172
36480,1773,902,871,454,354,525,440
36481,593,268,325,168,116,169,140
36482,1090,495,595,278,229,348,235
36483,536,255,281,116,98,146,176
36502,18355,10202,8153,4421,5366,5100,3468
36505,1481,730,751,393,375,455,258
36507,19090,9362,9728,5411,4672,5154,3853
36509,1983,1000,983,631,522,485,345
36511,764,363,401,201,219,188,156
36512,46,25,21,9,17,13,7
36513,555,299,256,158,126,170,101
36518,2842,1401,1441,766,624,823,629
36521,5431,2714,2717,1544,1328,1563,996
36522,7183,3496,3687,2156,1703,1983,1341
36523,2818,1475,1343,685,585,927,621
36524,1232,587,645,294,233,346,359
36525,1935,1008,927,548,535,542,310
36526,27890,13587,14303,7458,6997,8162,5273
36527,12109,5929,6180,3441,2560,3776,2332
36528,1237,636,601,176,206,432,423
36529,478,239,239,142,111,144,81
36530,6873,3451,3422,1650,1440,2051,1732
36532,27829,13230,14599,7001,5194,7935,7699
36535,26767,12978,13789,6567,6516,6871,6813
36538,374,180,194,107,74,96,97
36539,802,414,388,240,169,224,169
36540,691,329,362,216,158,205,112
36541,15647,7758,7889,4539,3889,4448,2771
36542,12705,6278,6427,2656,3366,3540,3143
36543,66,34,32,21,18,15,12
36544,12476,6203,6273,3839,3188,3574,1875
36545,9941,4726,5215,2814,2187,2850,2090
36548,1136,556,580,315,242,353,226
36549,4271,2039,2232,527,485,1014,2245
36550,217,106,111,44,33,76,64
36551,8258,4354,3904,2164,2393,2350,1351
36553,3575,1707,1868,1133,879,970,593
36555,654,315,339,119,97,211,227
36556,308,147,161,80,56,87,85
36558,3854,1903,1951,1010,807,1101,936
36559,233,120,113,37,21,73,102
36560,3690,1769,1921,1035,832,1083,740
36561,5808,2884,2924,1140,1080,1824,1764
36562,1596,790,806,465,386,444,301
36564,107,53,54,11,5,27,64
36567,12672,6151,6521,3551,3253,3469,2399
36568,162,78,84,41,37,47,37
36569,928,475,453,262,213,263,190
36571,14423,7123,7300,3623,3540,4069,3191
36572,6340,3068,3272,1681,1428,1882,1349
36574,1341,674,667,308,242,460,331
36575,18345,9049,9296,5334,4783,5245,2983
36576,4143,2033,2110,1137,974,1225,807
36578,1749,908,841,508,395,514,332
36579,1590,797,793,397,315,482,396
36580,5420,2701,2719,1453,1293,1537,1137
36581,224,104,120,63,37,73,51
36582,24624,12008,12616,7022,6396,6904,4302
36583,639,325,314,170,140,175,154
36584,772,364,408,199,147,234,192
36585,972,487,485,278,216,279,199
36587,12053,6100,5953,3796,3068,3327,1862
36590,20,12,8,2,5,9,4
36602,1057,618,439,60,299,422,276
36603,7922,4182,3740,1704,2343,2213,1662
36604,10456,5165,5291,2694,3026,3017,1719
36605,30111,13970,16141,10144,7135,7780,5052
36606,18733,8783,9950,5207,5723,4878,2925
36607,6852,3159,3693,1601,1670,1804,1777
36608,36864,17516,19348,9787,11328,9008,6741
36609,25846,11873,13973,6762,8800,6048,4236
36610,13209,6050,7159,4168,3125,3505,2411
36611,6106,2823,3283,1792,1583,1520,1211
36612,4541,2083,2458,1392,1078,1204,867
36613,12749,6147,6602,3439,3157,3602,2551
36615,391,178,213,134,104,116,37
36616,27,13,14,10,10,4,3
36617,13967,6297,7670,3983,2879,3574,3531
36618,16737,7952,8785,4925,4214,4678,2920
36619,14269,7138,7131,3748,3257,4134,3130
36688,659,245,414,299,359,1,0
36693,17847,8468,9379,4205,3736,5125,4781
36695,45118,21643,23475,12724,12168,12972,7254
36701,24268,11119,13149,7064,5621,6633,4950
36703,13643,6299,7344,4239,3394,3540,2470
36720,784,340,444,275,175,199,135
36722,472,231,241,155,115,116,86
36723,230,113,117,66,47,72,45
36726,4814,2249,2565,1414,989,1345,1066
36727,61,36,25,8,13,26,14
36728,461,222,239,129,108,133,91
36732,8395,3802,4593,2423,1945,2287,1740
36736,1207,585,622,386,284,310,227
36738,952,463,489,280,213,247,212
36740,1328,645,683,346,263,413,306
36742,2554,1288,1266,689,508,788,569
36744,7419,3487,3932,2107,1682,2091,1539
36748,3260,1532,1728,761,700,889,910
36749,1089,543,546,285,264,334,206
36750,2901,1490,1411,829,728,781,563
36751,945,468,477,319,205,277,144
36752,1644,804,840,401,280,548,415
36753,85,48,37,19,13,27,26
36754,344,163,181,98,70,104,72
36756,6165,2926,3239,1793,1454,1448,1470
36758,1412,687,725,408,311,427,266
36759,1501,709,792,360,281,502,358
36761,1161,569,592,371,184,316,290
36763,139,77,62,23,19,39,58
36765,1294,600,694,371,243,378,302
36766,25,12,13,2,3,7,13
36767,2012,954,1058,575,404,591,442
36768,1096,522,574,265,233,303,295
36769,3014,1427,1587,970,683,780,581
36773,512,236,276,138,121,149,104
36775,800,393,407,179,162,265,194
36776,1489,682,807,467,329,422,271
36782,2405,1189,1216,641,488,699,577
36783,945,446,499,251,174,276,244
36784,7754,3597,4157,2188,1733,2093,1740
36785,1165,520,645,319,276,324,246
36786,3365,1545,1820,1111,820,849,585
36790,139,77,62,36,24,42,37
36792,1169,565,604,274,271,316,308
36793,568,283,285,113,130,152,173
36801,22214,10528,11686,6199,6186,5803,4026
36804,16861,8351,8510,4899,4323,4951,2688
36830,33201,16607,16594,8230,13424,7064,4483
36832,22071,11540,10531,4819,13029,2783,1440
36849,3150,1148,2002,2466,684,0,0
36850,2630,1265,1365,590,538,826,676
36852,2129,1036,1093,623,527,602,377
36853,8269,4032,4237,1738,1582,2407,2542
36854,14576,6994,7582,3885,3596,3976,3119
36855,1551,786,765,326,291,502,432
36856,3719,1834,1885,1284,1130,863,442
36858,441,205,236,99,72,162,108
36859,34,21,13,2,3,16,13
36860,1580,752,828,351,295,512,422
36861,3264,1662,1602,712,623,1072,857
36862,6623,3145,3478,1580,1468,1995,1580
36863,11672,5526,6146,2904,2608,3298,2862
36865,23,12,11,5,4,8,6
36866,3955,1927,2028,1020,966,1138,831
36867,22210,10214,11996,6486,6402,5463,3859
36869,18751,9207,9544,5292,5151,5101,3207
36870,18783,9138,9645,5785,5583,5042,2373
36871,1277,615,662,288,240,418,331
36874,7901,3931,3970,2162,1877,2480,1382
36875,4622,2284,2338,1186,955,1530,951
36877,11414,5550,5864,3280,2792,3401,1941
36879,2114,1054,1060,583,545,653,333
36901,329,148,181,86,69,113,61
36904,4098,1967,2131,956,890,1113,1139
36907,1930,904,1026,520,416,546,448
36908,2417,1207,1210,645,503,696,573
36910,35,15,20,6,7,11,11
36912,2017,934,1083,497,419,634,467
36913,53,23,30,10,3,20,20
36915,627,307,320,169,139,167,152
36916,709,348,361,151,142,250,166
36919,2143,1046,1097,603,452,607,481
36921,1035,491,544,255,214,289,277
36922,656,293,363,150,116,214,176
36925,3115,1350,1765,889,665,862,699
38852,51,24,27,9,7,16,19
99501,17603,9510,8093,3443,6249,5102,2809
99502,24168,12028,12140,7057,7037,7106,2968
99503,14563,7649,6914,3427,5054,4224,1858
99504,40914,20253,20661,12204,12719,10662,5329
99505,6174,3824,2350,2292,3565,310,7
99506,7749,4105,3644,3326,3922,480,21
99507,37850,18965,18885,10935,11754,11062,4099
99508,35857,17830,18027,11212,11008,9053,4584
99510,353,318,35,0,102,225,26
99513,0,0,0,0,0,0,0
99515,22441,11145,11296,6731,6137,6887,2686
99516,20095,10238,9857,5844,3352,8008,2891
99517,16645,8441,8204,4001,4932,5202,2510
99518,10225,5170,5055,2603,3430,2878,1314
99519,1316,1179,137,3,189,932,192
99540,320,184,136,49,75,131,65
99546,326,199,127,36,92,144,54
99547,61,36,25,19,13,19,10
99548,73,41,32,25,16,19,13
99549,102,57,45,38,27,25,12
99550,197,101,96,52,33,83,29
99551,627,304,323,265,165,134,63
99552,346,169,177,137,102,76,31
99553,1027,790,237,29,365,537,96
99554,677,343,334,324,152,128,73
99555,221,129,92,69,64,62,26
99556,2510,1325,1185,592,476,909,533
99557,726,377,349,271,182,186,87
99558,85,46,39,31,24,16,14
99559,7632,3972,3660,2865,2156,1939,672
99561,418,210,208,178,114,88,38
99563,938,508,430,441,267,180,50
99564,91,51,40,22,18,40,11
99565,78,40,38,23,21,23,11
99566,192,103,89,62,45,48,37
99567,9211,4737,4474,2656,2054,3315,1186
99568,279,149,130,59,41,117,62
99569,64,32,32,21,11,25,7
99571,160,93,67,31,39,72,18
99572,296,157,139,27,55,95,119
99573,1115,593,522,306,203,404,202
99574,2348,1254,1094,614,492,866,376
99575,105,58,47,41,19,33,12
99576,2603,1343,1260,877,631,779,316
99577,25771,12895,12876,7986,7242,8001,2542
99578,296,157,139,121,66,69,40
99579,109,79,30,20,18,52,19
99580,115,61,54,45,22,37,11
99581,762,429,333,323,192,172,75
99583,35,19,16,11,12,5,7
99585,417,219,198,199,116,74,28
99586,605,325,280,153,107,200,145
99587,2250,1240,1010,443,861,734,212
99588,980,513,467,257,215,328,180
99589,243,135,108,89,62,67,25
99590,194,99,95,82,55,37,20
99591,102,59,43,26,25,35,16
99602,178,92,86,65,44,48,21
99603,9840,4993,4847,2605,2100,3199,1936
99604,1093,563,530,486,296,226,85
99605,211,113,98,35,34,70,72
99606,469,223,246,178,143,105,43
99607,216,113,103,89,56,54,17
99609,569,302,267,268,148,101,52
99610,2167,1170,997,491,397,835,444
99611,15122,7876,7246,4435,3717,4695,2275
99612,938,577,361,168,282,384,104
99613,434,242,192,110,121,145,58
99614,639,333,306,298,149,134,58
99615,12899,6821,6078,4059,3682,3720,1438
99620,577,307,270,267,147,118,45
99621,723,377,346,319,192,141,71
99622,321,169,152,129,66,88,38
99624,90,50,40,21,22,23,24
99625,72,39,33,23,19,25,5
99626,282,137,145,110,82,64,26
99627,406,215,191,119,88,129,70
99628,443,231,212,166,116,111,50
99630,191,108,83,57,37,66,31
99631,228,121,107,63,47,79,39
99632,813,417,396,367,208,161,77
99633,544,284,260,137,104,231,72
99634,354,191,163,150,87,75,42
99636,510,281,229,226,130,99,55
99637,590,315,275,286,124,124,56
99638,18,9,9,1,2,6,9
99639,1131,604,527,217,161,436,317
99640,174,84,90,58,43,53,20
99641,496,266,230,223,131,102,40
99643,218,123,95,74,53,57,34
99644,175,94,81,51,43,51,30
99645,25176,12980,12196,7961,6265,7728,3222
99647,44,20,24,13,8,14,9
99648,113,60,53,36,33,26,18
99649,80,42,38,21,15,26,18
99650,568,295,273,262,160,104,42
99651,61,37,24,23,12,15,11
99652,3703,1957,1746,982,778,1328,615
99653,159,87,72,67,53,28,11
99654,52168,26869,25299,17302,13972,14957,5937
99655,669,347,322,287,186,135,61
99656,25,13,12,6,3,7,9
99657,329,178,151,145,114,50,20
99658,616,321,295,251,149,154,62
99659,401,211,190,189,109,72,31
99660,479,254,225,150,128,136,65
99661,978,612,366,180,305,392,101
99662,480,265,215,264,93,78,45
99663,414,218,196,90,76,128,120
99664,4932,2885,2047,1021,1472,1744,695
99665,83,42,41,27,17,30,9
99666,189,99,90,85,51,33,20
99667,65,37,28,4,7,35,19
99668,86,48,38,25,21,24,16
99669,14191,7173,7018,4055,3290,4285,2561
99670,79,46,33,18,10,36,15
99671,556,278,278,267,150,99,40
99672,3704,1966,1738,873,707,1352,772
99674,1444,750,694,372,255,541,276
99676,1546,828,718,319,303,625,299
99677,88,40,48,33,23,22,10
99678,891,464,427,372,204,228,87
99679,373,200,173,145,102,92,34
99680,408,216,192,196,83,82,47
99681,325,191,134,143,70,72,40
99682,373,287,86,56,94,184,39
99683,524,275,249,104,99,205,116
99684,688,371,317,236,159,192,101
99685,4224,2905,1319,636,1397,1852,339
99686,4005,2139,1866,1113,1048,1406,438
99688,2759,1472,1287,644,470,1031,614
99689,662,360,302,176,158,218,110
99690,280,147,133,124,81,51,24
99691,95,64,31,28,22,25,20
99692,152,90,62,32,51,60,9
99693,248,147,101,35,77,95,41
99694,1512,803,709,454,384,459,215
99695,7,4,3,2,1,2,2
99701,19019,9818,9201,4931,6534,4890,2664
99702,2647,1488,1159,1082,1389,165,11
99703,7065,4196,2869,2751,3911,395,8
99704,24,21,3,0,7,13,4
99705,22544,11785,10759,7217,6933,6244,2150
99706,13,8,5,1,5,5,2
99709,29830,15586,14244,7497,9674,8812,3847
99712,13866,7222,6644,3616,3411,4814,2025
99714,1385,736,649,409,281,464,231
99720,208,118,90,74,58,49,27
99721,324,180,144,124,102,74,24
99722,152,86,66,51,52,34,15
99723,4213,2165,2048,1542,1152,1149,370
99724,84,43,41,25,22,30,7
99726,30,18,12,1,4,18,7
99727,416,233,183,210,115,70,21
99729,231,137,94,53,52,79,47
99730,144,79,65,22,19,61,42
99732,10,7,3,0,2,5,3
99733,104,50,54,34,24,27,19
99734,845,761,84,3,488,324,30
99736,122,67,55,40,35,30,17
99737,5011,2838,2173,1486,1298,1543,684
99738,187,102,85,46,23,75,43
99739,330,182,148,142,100,66,22
99740,585,326,259,189,150,161,85
99741,470,241,229,141,115,144,70
99742,681,358,323,289,184,147,61
99743,1069,571,498,286,244,421,118
99744,226,126,100,60,38,90,38
99745,78,39,39,18,24,18,18
99746,277,137,140,118,69,51,39
99747,239,125,114,82,56,76,25
99748,190,116,74,60,53,51,26
99749,363,194,169,155,88,73,47
99750,374,178,196,174,98,69,33
99751,151,76,75,70,42,25,14
99752,3553,1937,1616,1174,1077,945,357
99753,332,183,149,160,83,63,26
99754,96,49,47,31,22,31,12
99755,217,117,100,30,68,89,30
99756,119,66,53,28,14,40,37
99757,17,8,9,2,0,9,6
99758,210,118,92,68,60,51,31
99759,189,106,83,69,67,41,12
99760,785,416,369,194,141,280,170
99761,514,268,246,234,118,113,49
99762,4038,2149,1889,1317,1153,1118,450
99763,668,375,293,302,154,154,58
99764,290,160,130,87,66,77,60
99765,264,144,120,80,62,83,39
99766,678,356,322,264,184,162,68
99767,24,13,11,7,5,6,6
99768,175,97,78,61,28,56,30
99769,671,347,324,248,189,153,81
99770,841,438,403,397,245,143,56
99771,251,136,115,108,62,60,21
99772,567,314,253,260,130,123,54
99773,262,131,131,121,62,48,31
99774,78,48,30,24,22,21,11
99775,1251,717,534,491,701,45,14
99776,124,65,59,33,28,37,26
99777,246,131,115,72,50,90,34
99778,254,137,117,100,80,53,21
99780,1535,826,709,418,315,512,290
99781,167,101,66,57,51,39,20
99782,556,299,257,219,152,136,49
99783,145,82,63,56,41,31,17
99784,190,109,81,75,45,53,17
99785,388,201,187,187,101,78,22
99786,259,132,127,102,53,70,34
99788,69,35,34,28,15,19,7
99789,402,208,194,142,119,104,37
99790,20,12,8,2,6,8,4
99791,237,139,98,101,67,49,20
99801,29164,14899,14265,7709,7609,9629,4217
99820,479,276,203,138,107,152,82
99824,2111,1051,1060,468,685,680,278
99825,120,64,56,31,24,42,23
99826,442,224,218,87,76,169,110
99827,2602,1325,1277,553,499,940,610
99829,777,415,362,179,165,267,166
99830,561,304,257,148,119,179,115
99832,104,66,38,15,18,43,28
99833,3202,1649,1553,815,711,1073,603
99835,8880,4480,4400,2291,2377,2693,1519
99836,52,29,23,15,14,18,5
99840,968,500,468,163,294,352,159
99841,133,69,64,17,15,51,50
99901,13508,6942,6566,3573,3431,4312,2192
99903,31,17,14,4,3,10,14
99918,231,142,89,43,38,98,52
99919,531,310,221,124,95,216,96
99921,1920,1064,856,537,444,658,281
99922,384,219,165,126,97,107,54
99923,87,51,36,13,9,37,28
99925,819,428,391,227,167,254,171
99926,1460,761,699,459,374,410,217
99927,94,63,31,13,15,45,21
99929,2338,1225,1113,568,430,781,559
84531,20,11,9,4,4,4,8
84536,280,130,150,104,74,72,30
85003,9369,5844,3525,2158,3542,2505,1164
85004,4965,2646,2319,1305,1808,1144,708
85006,25742,13315,12427,9030,8145,6079,2488
85007,14040,7490,6550,4093,3983,3990,1974
85008,56145,29146,26999,19278,20315,12055,4497
85009,52520,28808,23712,19861,17760,10537,4362
85012,6390,3338,3052,1135,1893,1774,1588
85013,19314,9859,9455,4122,5859,5887,3446
85014,24782,12685,12097,5820,8007,7282,3673
85015,37644,19013,18631,12467,11828,9143,4206
85016,33896,16976,16920,7629,10665,9272,6330
85017,38872,19945,18927,15189,12216,8293,3174
85018,36065,17821,18244,8352,9570,11052,7091
85019,25042,12608,12434,9626,7272,5537,2607
85020,32850,16163,16687,7318,8520,9694,7318
85021,37743,18978,18765,10969,11249,9346,6179
85022,46395,22366,24029,10736,13526,13546,8587
85023,31274,15535,15739,8628,9088,8684,4874
85024,22898,11107,11791,6003,7461,6728,2706
85027,37140,18850,18290,9702,12928,10024,4486
85028,19157,9283,9874,4011,3627,6402,5117
85029,43233,21328,21905,12569,12905,11285,6474
85031,30493,15278,15215,12638,8876,6221,2758
85032,65485,32618,32867,17356,19850,18068,10211
85033,53037,26504,26533,22254,16252,10483,4048
85034,5582,3014,2568,1894,1532,1507,649
85035,47486,23606,23880,19695,15598,9002,3191
85037,44771,22244,22527,17242,14566,9723,3240
85040,29352,14881,14471,11220,8981,6293,2858
85041,54947,27099,27848,20698,17155,11915,5179
85042,40962,20390,20572,13395,12633,10006,4928
85043,30560,15068,15492,12590,10124,5991,1855
85044,37993,18647,19346,8799,11318,11467,6409
85045,7238,3538,3700,2381,1395,2760,702
85048,33449,16411,17038,9891,7317,12550,3691
85050,25736,12307,13429,7102,6954,7591,4089
85051,40375,20242,20133,12623,11596,10505,5651
85053,28480,14379,14101,7846,8300,8023,4311
85054,5384,2663,2721,809,2323,1499,753
85083,18104,9100,9004,6146,4729,5468,1761
85085,17517,8651,8866,5242,6506,4265,1504
85086,40495,20373,20122,12732,9234,12302,6227
85087,7708,3969,3739,2072,1531,2632,1473
85118,12246,5927,6319,1445,1250,3379,6172
85119,21219,10338,10881,4224,3645,5774,7576
85120,28168,13771,14397,5798,5227,7004,10139
85121,2178,1043,1135,884,563,521,210
85122,50942,24741,26201,16016,12491,12026,10409
85123,10677,5250,5427,3129,2623,2564,2361
85128,14823,7263,7560,5132,3845,3612,2234
85131,18017,12475,5542,3801,7583,4569,2064
85132,33556,24971,8585,5252,14785,9154,4365
85135,630,310,320,193,128,147,162
85137,2329,1155,1174,630,425,583,691
85138,33633,16761,16872,11339,10960,7437,3897
85139,17979,9044,8935,6176,5160,4452,2191
85140,36711,18329,18382,14406,12356,6850,3099
85141,515,280,235,130,104,156,125
85142,48870,24452,24418,18816,14245,11275,4534
85143,35015,17198,17817,13221,11034,7145,3615
85145,2106,1079,1027,824,867,311,104
85147,4543,2196,2347,1798,1318,1008,419
85172,1368,694,674,522,356,325,165
85173,2872,1431,1441,744,565,778,785
85192,2120,1102,1018,536,378,615,591
85193,4906,2473,2433,1644,1102,1292,868
85194,6721,3344,3377,1446,1032,1789,2454
85201,46092,23005,23087,14018,15491,10441,6142
85202,37275,18547,18728,9655,13533,9114,4973
85203,35541,17623,17918,11606,10210,8722,5003
85204,60885,30837,30048,20490,19565,13631,7199
85205,39858,18763,21095,8930,7601,9986,13341
85206,33154,15227,17927,6712,7846,6638,11958
85207,44744,21919,22825,12571,9506,13549,9118
85208,34762,16697,18065,8599,7431,7824,10908
85209,37377,17927,19450,9613,8733,8208,10823
85210,36464,18751,17713,11722,12346,8851,3545
85212,24492,12236,12256,9564,7341,5620,1967
85213,31797,15627,16170,9371,6934,8495,6997
85215,15963,7613,8350,3069,2408,4414,6072
85224,42796,21001,21795,10725,14191,12280,5600
85225,69810,34409,35401,21753,22542,17857,7658
85226,37376,18327,19049,10411,11112,11913,3940
85233,37564,18439,19125,11254,10506,11455,4349
85234,50014,24518,25496,17362,12615,14590,5447
85248,29821,13931,15890,4794,4011,6543,14473
85249,36908,18012,18896,12609,8018,9973,6308
85250,15906,7286,8620,2450,4097,4271,5088
85251,34390,16980,17410,5931,12531,8110,7818
85253,17047,8347,8700,3923,2201,5483,5440
85254,45801,22432,23369,10954,9673,15437,9737
85255,37270,18148,19122,9214,6089,12342,9625
85256,4974,2367,2607,1880,1141,1164,789
85257,26755,13307,13448,5156,8190,7060,6349
85258,23342,10919,12423,3530,4027,6685,9100
85259,21422,10430,10992,5014,3569,7809,5030
85260,36056,17065,18991,7377,9056,11179,8444
85262,11275,5624,5651,1794,1275,4201,4005
85263,2111,1025,1086,70,68,311,1662
85264,1249,618,631,445,305,339,160
85266,11406,5547,5859,2223,1067,3688,4428
85268,22684,10837,11847,3626,2939,7348,8771
85281,57348,31214,26134,15714,30264,7864,3506
85282,48671,24983,23688,10056,20177,10449,7989
85283,44813,22640,22173,11106,16641,10664,6402
85284,16479,8134,8345,4234,2898,6329,3018
85286,38930,19179,19751,12805,11528,10847,3750
85295,38332,18987,19345,13707,13049,9025,2551
85296,36799,18170,18629,12765,10783,10012,3239
85297,26979,13463,13516,10940,8618,5914,1507
85298,21479,10483,10996,7251,5247,5032,3949
85301,60161,29667,30494,22200,17919,13085,6957
85302,36909,17806,19103,10309,10389,9750,6461
85303,30310,14988,15322,11585,8746,7391,2588
85304,25883,12637,13246,7199,6450,7827,4407
85305,10822,5400,5422,3408,3635,2851,928
85306,24191,11826,12365,6353,6827,6839,4172
85307,9230,4637,4593,3276,3098,2064,792
85308,63876,31263,32613,16438,16743,20427,10268
85309,1485,1230,255,262,1207,12,4
85310,19007,9431,9576,5579,3935,6851,2642
85320,1197,643,554,330,306,260,301
85321,4435,2198,2237,1043,933,969,1490
85322,752,386,366,245,165,230,112
85323,39507,19844,19663,15102,13089,7985,3331
85324,2886,1493,1393,487,421,980,998
85325,1212,615,597,113,83,266,750
85326,51705,28346,23359,17355,17260,12006,5084
85328,259,131,128,46,22,109,82
85331,26960,13180,13780,6966,4400,9951,5643
85332,2146,1084,1062,267,191,488,1200
85333,790,433,357,249,142,228,171
85334,1482,812,670,381,296,472,333
85335,31787,15757,16030,12157,10354,6232,3044
85336,700,349,351,241,168,189,102
85337,2793,1441,1352,968,752,703,370
85338,41115,20549,20566,14015,12292,10542,4266
85339,35586,17324,18262,12996,11966,7852,2772
85340,26262,12927,13335,8923,6681,7124,3534
85341,39,22,17,14,9,12,4
85342,1578,763,815,370,267,435,506
85343,196,108,88,63,39,60,34
85344,9147,4655,4492,2467,1951,2477,2252
85345,56208,26873,29335,16890,14780,15162,9376
85346,4423,2240,2183,324,278,736,3085
85347,716,375,341,196,174,226,120
85348,2786,1449,1337,309,221,477,1779
85349,25517,12635,12882,10558,6836,5973,2150
85350,21214,11521,9693,7646,7012,4543,2013
85351,27789,11541,16248,107,439,3005,24238
85352,461,243,218,139,91,125,106
85353,31011,15096,15915,12469,10498,5932,2112
85354,6645,3390,3255,2231,1494,1928,992
85355,8745,4362,4383,2879,2399,2484,983
85356,4539,2278,2261,993,731,1017,1798
85357,761,417,344,230,158,181,192
85360,222,119,103,42,37,71,72
85361,6700,3345,3355,1988,1485,2034,1193
85362,663,332,331,49,35,227,352
85363,6156,2935,3221,1699,1632,1368,1457
85364,74904,36854,38050,25095,20229,17956,11624
85365,46558,23401,23157,13632,12006,9905,11015
85367,20429,9950,10479,2903,2887,3701,10938
85371,419,231,188,179,120,77,43
85373,17356,7870,9486,2239,2280,2300,10537
85374,47146,22311,24835,9937,9140,8435,19634
85375,27703,12245,15458,444,644,2153,24462
85377,3051,1486,1565,358,185,994,1514
85379,39732,19459,20273,14751,12872,8765,3344
85381,24249,11576,12673,6219,5611,7587,4832
85382,40454,18991,21463,10405,9394,10323,10332
85383,37182,18465,18717,12442,8758,11160,4822
85387,9573,4692,4881,1561,1250,2027,4735
85388,23490,11557,11933,8733,7338,5190,2229
85390,8621,4152,4469,1728,1311,2159,3423
85392,35310,17319,17991,11848,10883,9237,3342
85395,25922,10955,14967,6117,6506,6540,6759
85396,12163,6085,6078,3702,2916,3132,2413
85501,13345,6741,6604,3463,2879,3585,3418
85530,2069,997,1072,884,567,445,173
85531,623,318,305,241,136,145,101
85533,2943,1499,1444,881,684,726,652
85534,2588,1338,1250,721,455,750,662
85535,21,11,10,9,4,5,3
85536,408,214,194,86,90,93,139
85539,4520,2226,2294,1134,826,1308,1252
85540,2874,1545,1329,1072,906,791,105
85541,21877,10695,11182,4271,3221,6007,8378
85542,3196,1536,1660,1413,855,651,277
85543,3822,1924,1898,1356,904,880,682
85544,2949,1479,1470,326,226,954,1443
85545,583,295,288,56,56,167,304
85546,19677,10850,8827,5783,5719,4746,3429
85550,4790,2361,2429,1987,1218,1095,490
85551,405,208,197,116,95,101,93
85552,6218,3041,3177,2271,1655,1278,1014
85553,1501,796,705,137,118,407,839
85554,778,415,363,123,82,247,326
85601,698,356,342,91,89,217,301
85602,9464,4679,4785,1983,1616,2510,3355
85603,7155,3565,3590,1461,1344,2167,2183
85605,597,325,272,122,115,176,184
85606,1184,588,596,202,148,340,494
85607,18925,9217,9708,6677,4456,4391,3401
85608,2305,2298,7,52,1503,717,33
85609,392,190,202,67,51,128,146
85610,1333,692,641,321,195,410,407
85611,965,462,503,188,124,335,318
85613,5601,3537,2064,2050,3197,330,24
85614,21895,9929,11966,1630,1743,2887,15635
85615,9413,4677,4736,2251,1718,2919,2525
85616,5566,2811,2755,1393,1183,1780,1210
85617,1277,653,624,288,183,388,418
85618,1725,870,855,519,349,447,410
85619,50,27,23,8,8,23,11
85620,897,436,461,399,191,174,133
85621,23054,10664,12390,8015,4955,5670,4414
85622,6325,2903,3422,88,85,616,5536
85623,4073,2012,2061,971,722,1188,1192
85624,1426,685,741,272,218,391,545
85625,1983,997,986,270,194,553,966
85626,1021,501,520,373,211,257,180
85627,968,504,464,274,181,245,268
85629,23568,11626,11942,8084,6872,5407,3205
85630,2819,1432,1387,744,440,754,881
85631,3630,1813,1817,1061,776,905,888
85632,835,459,376,150,108,254,323
85633,54,24,30,8,7,19,20
85634,6490,3153,3337,2385,1765,1569,771
85635,34727,17034,17693,8980,10111,8451,7185
85637,1268,613,655,207,101,441,519
85638,1973,999,974,318,293,605,757
85640,441,208,233,80,95,141,125
85641,21753,10908,10845,6846,4988,6831,3088
85643,9810,5431,4379,2607,2515,2697,1991
85645,2231,1095,1136,638,409,672,512
85646,1311,626,685,107,107,352,745
85648,19080,9338,9742,7141,4618,5051,2270
85650,15279,7520,7759,3469,2772,4429,4609
85653,15083,7788,7295,4429,4137,4121,2396
85654,97,42,55,27,19,20,31
85658,7790,3864,3926,1373,1272,2175,2970
85701,4983,2570,2413,962,1869,1259,893
85704,30929,14380,16549,5643,7093,8305,9888
85705,57521,28998,28523,15458,18398,14299,9366
85706,55209,26773,28436,21124,16174,11883,6028
85707,658,543,115,144,514,0,0
85708,2980,1464,1516,1333,1403,199,45
85710,54439,25604,28835,12517,13942,13997,13983
85711,41251,20189,21062,10895,11751,11339,7266
85712,32666,15655,17011,6433,9948,8628,7657
85713,50151,25333,24818,15135,13946,11863,9207
85714,15009,7410,7599,4993,3975,3566,2475
85715,17702,8271,9431,3490,3630,5224,5358
85716,32853,16266,16587,6974,11874,8834,5171
85718,27367,12970,14397,4717,5191,7986,9473
85719,43989,22187,21802,12169,20151,7097,4572
85723,0,0,0,0,0,0,0
85724,0,0,0,0,0,0,0
85726,0,0,0,0,0,0,0
85730,38323,18782,19541,10345,10061,10641,7276
85735,11250,5633,5617,3058,2268,3367,2557
85736,4975,2551,2424,1306,975,1604,1090
85737,20727,9910,10817,4822,3192,6721,5992
85739,17848,8673,9175,2484,1937,3844,9583
85741,32998,16028,16970,8683,9553,9359,5403
85742,25212,12197,13015,7192,6034,7557,4429
85743,29144,14423,14721,7827,6536,8507,6274
85745,37006,17916,19090,9065,10740,9766,7435
85746,43057,20768,22289,14942,11711,10339,6065
85747,23058,11285,11773,7750,6280,6436,2592
85748,18087,8743,9344,4185,3861,5792,4249
85749,19032,9396,9636,4141,2779,6701,5411
85750,24161,11621,12540,4665,3882,7656,7958
85755,15107,7147,7960,2920,1788,3732,6667
85756,35703,20477,15226,10346,11917,8324,5116
85757,16988,8495,8493,6239,4977,3981,1791
85901,17207,8484,8723,4432,3226,4761,4788
85911,1800,893,907,763,519,362,156
85912,178,91,87,31,27,54,66
85920,464,236,228,69,49,134,212
85922,41,23,18,2,5,15,19
85923,621,322,299,215,123,160,123
85924,2683,1383,1300,476,290,968,949
85925,4893,2419,2474,1601,1078,1288,926
85926,265,124,141,95,66,77,27
85927,176,90,86,16,24,55,81
85928,1102,573,529,312,161,318,311
85929,8322,4192,4130,2320,1591,2448,1963
85930,1086,551,535,529,315,191,51
85931,207,107,100,27,18,69,93
85932,364,181,183,48,30,126,160
85933,3033,1533,1500,490,342,849,1352
85934,574,290,284,142,97,156,179
85935,4735,2371,2364,1198,774,1354,1409
85936,4293,2351,1942,1268,1028,1185,812
85937,7638,3847,3791,2586,1569,1807,1676
85938,2366,1190,1176,724,511,613,518
85939,4400,2255,2145,1711,1001,1001,687
85940,1443,713,730,343,211,431,458
85941,9941,4819,5122,4142,2703,2216,880
85942,80,41,39,23,11,19,27
86001,40776,20603,20173,9694,16831,9802,4449
86003,23,10,13,3,3,6,11
86004,37338,18612,18726,11148,10333,10860,4997
86011,6362,2675,3687,3494,2799,60,9
86015,385,197,188,131,147,82,25
86016,62,33,29,12,14,16,20
86017,667,349,318,88,89,242,248
86018,759,393,366,157,125,300,177
86020,1941,956,985,712,484,420,325
86021,6085,2872,3213,4008,1345,563,169
86022,2210,1098,1112,730,511,552,417
86023,2627,1387,1240,457,953,955,262
86024,703,355,348,31,34,240,398
86025,5676,2875,2801,1805,1466,1477,928
86028,47,17,30,9,12,12,14
86029,320,159,161,139,48,77,56
86030,1374,675,699,453,318,345,258
86031,1856,907,949,677,439,446,294
86032,1509,719,790,611,309,370,219
86033,7844,3787,4057,3168,1900,1878,898
86034,2271,1114,1157,827,500,608,336
86035,1802,916,886,602,405,471,324
86036,388,183,205,75,74,131,108
86038,77,40,37,8,12,25,32
86039,1467,726,741,480,371,333,283
86040,10283,5142,5141,3382,2733,2705,1463
86042,1778,861,917,624,453,440,261
86043,1798,857,941,722,449,414,213
86044,3825,1884,1941,1465,924,858,578
86045,11354,5471,5883,4342,3044,2614,1354
86046,6090,3105,2985,1517,1182,1989,1402
86047,14970,7929,7041,4701,4240,3758,2271
86052,28,16,12,2,10,15,1
86053,2311,1141,1170,1003,575,486,247
86054,1935,958,977,675,483,497,280
86301,20626,10158,10468,4082,3901,5095,7548
86303,17082,8365,8717,2534,2624,4899,7025
86305,17356,8440,8916,2736,2396,4796,7428
86313,257,244,13,2,25,125,105
86314,34401,16758,17643,9685,8448,8669,7599
86315,7234,3588,3646,1808,1257,2075,2094
86320,1885,986,899,417,259,608,601
86321,2219,1218,1001,732,625,613,249
86322,11480,5886,5594,2805,2365,3159,3151
86323,15822,7801,8021,3830,2913,4623,4456
86324,4168,1943,2225,881,715,1177,1395
86325,5152,2514,2638,942,825,1665,1720
86326,23344,11065,12279,5751,4801,6002,6790
86327,8858,4260,4598,1512,1188,2266,3892
86329,1179,636,543,314,239,336,290
86331,477,233,244,46,87,209,135
86332,1637,859,778,233,196,497,711
86333,5734,2944,2790,1139,917,1810,1868
86334,4985,2532,2453,1368,994,1492,1131
86335,4806,2376,2430,1193,962,1366,1285
86336,11320,5289,6031,1444,1492,3632,4752
86337,1267,633,634,197,179,428,463
86338,743,384,359,197,104,251,191
86343,177,99,78,19,17,89,52
86351,6349,2858,3491,778,703,1790,3078
86401,24289,12116,12173,6047,5014,6697,6531
86403,15802,7863,7939,3280,3062,4227,5233
86404,16243,8105,8138,2920,2664,4490,6169
86406,23763,11660,12103,4716,3996,6489,8562
86409,26471,12973,13498,6250,5317,7359,7545
86411,224,126,98,38,23,80,83
86413,12103,6960,5143,1903,2347,3922,3931
86426,13863,6862,7001,3126,2492,3878,4367
86429,7162,3570,3592,1253,1220,2091,2598
86431,403,218,185,37,31,110,225
86432,3933,1961,1972,960,658,925,1390
86433,111,63,48,18,8,47,38
86434,1490,709,781,569,387,328,206
86435,487,239,248,174,156,124,33
86436,2104,1073,1031,275,214,596,1019
86437,76,38,38,17,16,21,22
86438,913,484,429,107,92,317,397
86440,6906,3443,3463,1598,1248,1945,2115
86441,2224,1153,1071,307,230,690,997
86442,33382,16444,16938,7693,6272,8915,10502
86443,76,41,35,12,19,27,18
86444,1289,690,599,105,71,345,768
86445,311,170,141,31,43,118,119
86502,1464,756,708,532,309,332,291
86503,10714,5255,5459,4270,2692,2430,1322
86504,5835,2879,2956,2120,1447,1463,805
86505,7682,3838,3844,2809,1778,1891,1204
86506,1321,641,680,479,281,355,206
86507,2340,1123,1217,893,607,541,299
86508,752,397,355,249,173,195,135
86510,5358,2678,2680,2113,1369,1189,687
86511,3694,1853,1841,1247,868,1003,576
86512,2439,1164,1275,930,567,601,341
86514,3011,1484,1527,1092,688,749,482
86515,2894,1414,1480,1026,695,763,410
86520,1793,890,903,706,430,400,257
86535,1199,623,576,454,275,309,161
86538,2338,1144,1194,976,568,545,249
86540,1088,545,543,430,273,217,168
86544,1267,669,598,455,294,318,200
86545,1650,804,846,677,394,354,225
86547,1171,571,600,509,317,222,123
86556,2090,989,1101,804,676,370,240
87328,185,94,91,62,34,52,37
38769,2,2,0,0,0,0,2
65729,36,20,16,3,4,14,15
65733,217,112,105,10,20,55,132
65761,93,51,42,10,5,31,47
71601,17327,8099,9228,5709,4905,4023,2690
71602,17982,8522,9460,4929,4343,5265,3445
71603,34343,16801,17542,8944,8494,9633,7272
71630,405,203,202,94,68,124,119
71631,673,336,337,167,147,197,162
71635,12348,5888,6460,3257,2767,3368,2956
71638,3794,2038,1756,813,1049,1061,871
71639,6579,3102,3477,1957,1501,1771,1350
71640,3227,1512,1715,929,643,919,736
71642,648,317,331,173,116,202,157
71643,1109,507,602,283,210,330,286
71644,4264,3735,529,347,2202,1397,318
71646,6756,3400,3356,1919,1631,1849,1357
71647,2111,1059,1052,635,544,543,389
71651,150,73,77,34,19,51,46
71652,1159,573,586,298,248,320,293
71653,5152,2425,2727,1315,1056,1364,1417
71654,4671,2124,2547,1337,1110,1281,943
71655,15387,7453,7934,4406,4123,3919,2939
71658,728,374,354,182,170,225,151
71659,104,54,50,16,20,34,34
71660,963,468,495,247,218,265,233
71661,450,213,237,126,95,128,101
71662,82,51,31,23,18,32,9
71663,732,354,378,204,148,210,170
71665,6054,2984,3070,1690,1379,1642,1343
71666,79,46,33,24,28,14,13
71667,8267,4001,4266,2350,1891,2201,1825
71670,1403,681,722,339,284,449,331
71671,8665,4170,4495,2179,2018,2330,2138
71674,738,365,373,175,137,223,203
71675,1824,886,938,484,382,541,417
71676,684,305,379,177,128,189,190
71677,185,91,94,52,31,52,50
71701,20286,9533,10753,5363,4472,5783,4668
71711,106,81,25,19,66,19,2
71720,2498,1228,1270,633,554,737,574
71722,87,43,44,11,13,38,25
71724,431,218,213,97,82,126,126
71725,555,258,297,140,115,173,127
71726,1435,710,725,293,215,438,489
71730,32213,15620,16593,8652,7687,9102,6772
71740,1735,865,870,471,381,510,373
71742,5980,2952,3028,1638,1329,1620,1393
71743,4090,1974,2116,1107,898,1149,936
71744,3224,1616,1608,753,668,980,823
71745,264,116,148,72,51,78,63
71747,1097,544,553,256,240,338,263
71749,2115,1060,1055,566,447,638,464
71751,939,482,457,235,181,320,203
71752,1052,499,553,268,240,294,250
71753,16848,7985,8863,4623,4627,4113,3485
71758,450,219,231,104,78,141,127
71759,600,298,302,169,149,160,122
71762,2501,1209,1292,675,587,668,571
71763,1666,825,841,377,322,529,438
71764,1880,894,986,467,397,555,461
71765,2156,1051,1105,515,466,635,540
71766,670,323,347,147,110,235,178
71770,3526,1693,1833,981,831,934,780
71772,34,18,16,10,10,10,4
71801,16745,7954,8791,5040,4131,4310,3264
71820,103,51,52,30,19,36,18
71822,8925,4317,4608,2318,1964,2465,2178
71823,83,43,40,20,20,23,20
71825,645,321,324,206,164,150,125
71826,1315,615,700,394,302,359,260
71827,817,404,413,214,160,243,200
71832,11253,5531,5722,3939,3003,2538,1773
71833,2280,1119,1161,585,520,622,553
71834,1491,746,745,337,290,458,406
71835,1334,674,660,355,301,374,304
71836,2856,1411,1445,763,636,765,692
71837,5227,2651,2576,1656,1332,1381,858
71838,1148,572,576,286,237,334,291
71839,280,141,139,78,45,78,79
71841,913,476,437,239,209,262,203
71842,2241,1113,1128,735,506,606,394
71845,2387,1162,1225,635,469,665,618
71846,2652,1343,1309,664,629,731,628
71847,673,329,344,173,122,207,171
71851,2241,1064,1177,637,498,613,493
71852,10102,4928,5174,2951,2414,2701,2036
71853,365,176,189,92,81,104,88
71854,36438,17855,18583,9622,9890,9798,7128
71855,708,370,338,180,161,218,149
71857,5894,2833,3061,1581,1296,1636,1381
71858,1710,878,832,416,373,475,446
71859,477,230,247,81,78,159,159
71860,2633,1262,1371,704,560,679,690
71861,2258,1104,1154,511,407,662,678
71862,771,377,394,176,162,232,201
71865,194,94,100,51,47,58,38
71866,725,352,373,197,186,178,164
71901,29491,14419,15072,7615,6706,8319,6851
71909,15508,7429,8079,1595,1318,2690,9905
71913,43436,20729,22707,9829,9942,11560,12105
71921,3652,1829,1823,1030,852,958,812
71922,129,52,77,27,28,38,36
71923,15637,7409,8228,4019,4883,3605,3130
71929,4487,2284,2203,1174,992,1345,976
71933,1616,818,798,458,351,498,309
71935,808,426,382,223,157,230,198
71937,2026,1028,998,577,398,587,464
71940,1652,803,849,401,345,495,411
71941,2098,1072,1026,527,513,572,486
71943,4821,2357,2464,1436,1152,1186,1047
71944,773,390,383,235,192,195,151
71945,1437,686,751,393,284,412,348
71949,1989,1007,982,518,395,641,435
71950,875,437,438,234,174,253,214
71952,145,83,62,27,25,45,48
71953,14882,7289,7593,3671,2818,4065,4328
71956,1882,943,939,482,435,554,411
71957,3133,1507,1626,585,471,880,1197
71958,2525,1265,1260,625,568,690,642
71959,754,383,371,181,131,234,208
71960,1383,694,689,303,265,411,404
71961,1003,511,492,262,194,272,275
71962,792,375,417,163,163,245,221
71964,3926,1978,1948,1098,903,1145,780
71965,315,157,158,66,50,95,104
71968,4717,2437,2280,1259,968,1458,1032
71969,376,185,191,99,51,121,105
71970,792,420,372,158,145,248,241
71971,513,249,264,138,128,143,104
71972,309,149,160,89,80,83,57
71973,1424,716,708,490,397,334,203
71998,321,303,18,161,158,1,1
71999,706,197,509,346,359,1,0
72001,566,281,285,149,124,164,129
72002,14134,7131,7003,3938,3786,4121,2289
72003,746,388,358,166,191,232,157
72004,1311,655,656,364,278,374,295
72005,248,134,114,58,60,56,74
72006,2603,1256,1347,633,548,767,655
72007,6708,3415,3293,1956,1878,1900,974
72010,6577,3267,3310,1843,1578,1755,1401
72011,4074,2059,2015,1211,1072,1203,588
72012,11986,5828,6158,3655,3177,3066,2088
72013,2197,1118,1079,575,471,639,512
72014,60,33,27,14,10,21,15
72015,27307,13449,13858,7829,7863,6803,4812
72016,3268,1674,1594,897,706,1064,601
72017,726,359,367,177,144,212,193
72019,23346,11607,11739,6426,5612,6839,4469
72020,4295,2127,2168,1112,900,1265,1018
72021,4348,2092,2256,1125,863,1246,1114
72022,14270,6748,7522,4002,4075,3873,2320
72023,35026,17059,17967,10825,9568,9451,5182
72024,3777,1843,1934,998,846,1049,884
72025,847,443,404,229,178,230,210
72026,393,208,185,80,76,133,104
72027,1417,718,699,392,318,376,331
72029,1912,896,1016,466,425,555,466
72030,705,354,351,188,164,172,181
72031,7683,3865,3818,1821,1633,2127,2102
72032,31436,15508,15928,8817,10196,7807,4616
72034,44723,21785,22938,12238,16931,9667,5887
72035,1083,440,643,119,964,0,0
72036,817,371,446,204,147,235,231
72037,28,16,12,9,6,8,5
72038,74,38,36,12,11,27,24
72039,2131,1083,1048,555,527,592,457
72040,2867,1425,1442,711,544,828,784
72041,1457,724,733,349,304,459,345
72042,5161,2498,2663,1338,1210,1460,1153
72044,881,422,459,173,133,238,337
72045,1151,577,574,270,256,356,269
72046,4470,2157,2313,1171,1025,1240,1034
72047,969,494,475,287,219,296,167
72048,114,59,55,27,16,37,34
72051,622,330,292,158,120,189,155
72055,849,406,443,187,180,261,221
72057,1070,539,531,280,268,321,201
72058,15911,7895,8016,4924,4127,4362,2498
72059,37,19,18,8,8,11,10
72060,666,328,338,165,158,188,155
72061,250,120,130,79,69,62,40
72063,1683,857,826,425,388,484,386
72064,2451,1209,1242,587,507,711,646
72065,5207,2609,2598,1414,1191,1644,958
72067,2726,1379,1347,480,442,794,1010
72068,424,208,216,126,118,105,75
72069,1369,650,719,344,231,406,388
72070,1813,898,915,457,401,521,434
72072,544,274,270,142,130,152,120
72073,1139,557,582,249,242,364,284
72074,167,83,84,32,41,43,51
72076,37979,18497,19482,10976,11163,9657,6183
72079,786,400,386,237,184,235,130
72080,662,344,318,151,142,178,191
72081,7798,3883,3915,2157,1854,2195,1592
72082,1935,950,985,540,503,480,412
72083,237,121,116,66,52,64,55
72084,1229,649,580,331,283,340,275
72085,220,120,100,59,48,60,53
72086,10727,5307,5420,2916,2640,3083,2088
72087,2051,1044,1007,386,360,627,678
72088,2391,1076,1315,272,217,493,1409
72099,616,542,74,193,423,0,0
72101,3378,1599,1779,857,733,929,859
72102,2873,1419,1454,787,624,858,604
72103,13078,6494,6584,3660,3447,3826,2145
72104,23354,11971,11383,6109,5785,6403,5057
72106,5376,2660,2716,1314,1334,1654,1074
72107,339,163,176,106,62,102,69
72108,73,37,36,27,12,15,19
72110,11498,5585,5913,3097,2679,3070,2652
72111,1362,703,659,355,323,427,257
72112,11467,5670,5797,2494,3286,3268,2419
72113,21273,10116,11157,5549,6624,5987,3113
72114,12658,5944,6714,3780,3398,3411,2069
72116,21431,10214,11217,4677,5523,6069,5162
72117,12684,6027,6657,3808,3220,3388,2268
72118,22592,10840,11752,6236,6474,6047,3835
72119,5,4,1,1,2,2,0
72120,31610,15048,16562,8284,8631,8743,5952
72121,2704,1351,1353,676,579,828,621
72122,927,450,477,233,179,310,205
72123,450,227,223,131,98,124,97
72125,905,460,445,230,207,272,196
72126,3674,1756,1918,874,808,978,1014
72127,2149,1065,1084,549,482,682,436
72128,814,414,400,251,210,201,152
72129,1409,703,706,381,339,389,300
72130,560,274,286,163,143,146,108
72131,4631,2312,2319,1147,968,1349,1167
72132,3242,1608,1634,868,812,1032,530
72134,315,154,161,77,55,113,70
72135,2623,1331,1292,651,425,928,619
72136,1772,914,858,454,392,563,363
72137,2555,1294,1261,711,601,698,545
72139,216,97,119,69,40,57,50
72140,305,142,163,52,59,101,93
72141,625,321,304,156,138,171,160
72142,2499,1256,1243,583,513,821,582
72143,35169,17089,18080,9667,10761,8102,6639
72149,0,0,0,0,0,0,0
72150,12006,5931,6075,3117,2876,3477,2536
72152,429,230,199,72,75,151,131
72153,2572,1308,1264,626,494,736,716
72156,639,326,313,168,147,200,124
72157,1607,825,782,435,345,465,362
72160,10736,5159,5577,2859,2610,2889,2378
72165,111,60,51,27,20,35,29
72166,260,128,132,51,44,84,81
72167,1719,858,861,479,417,510,313
72168,1834,1630,204,78,928,687,141
72169,203,109,94,56,45,51,51
72170,202,97,105,42,33,65,62
72173,9078,4492,4586,2954,2369,2437,1318
72175,354,182,172,77,69,107,101
72176,8141,4068,4073,2604,2588,1930,1019
72179,450,215,235,107,81,134,128
72181,62,33,29,21,16,15,10
72201,1024,667,357,53,449,401,121
72202,9978,4990,4988,1794,3468,2725,1991
72204,32505,15836,16669,9627,9897,8498,4483
72205,23000,10797,12203,4389,7984,5864,4763
72206,25624,12978,12646,6178,6396,7712,5338
72207,10344,4739,5605,2340,2858,2997,2149
72209,32376,15445,16931,11476,10118,7532,3250
72210,14258,6763,7495,3905,3967,3948,2438
72211,21288,9807,11481,5131,7528,5372,3257
72212,12705,6106,6599,3099,2517,4044,3045
72223,19890,9554,10336,5407,4859,6351,3273
72227,11462,5361,6101,2535,3185,3033,2709
72301,26069,12032,14037,8540,6666,6594,4269
72311,135,69,66,34,24,36,41
72315,23966,11456,12510,7589,5995,6289,4093
72320,1847,1771,76,45,1093,642,67
72321,154,75,79,42,31,52,29
72322,195,91,104,51,45,61,38
72324,1978,978,1000,515,422,556,485
72325,43,16,27,14,5,20,4
72326,2267,1141,1126,540,506,659,562
72327,1732,894,838,484,387,490,371
72328,64,32,32,9,17,26,12
72329,80,42,38,15,17,31,17
72330,756,385,371,258,195,198,105
72331,3184,1521,1663,1086,704,823,571
72332,104,39,65,53,17,20,14
72333,667,314,353,214,145,164,144
72335,20121,11456,8665,5230,6143,5586,3162
72338,43,27,16,11,11,12,9
72339,204,108,96,63,39,70,32
72340,90,43,47,38,12,20,20
72341,222,113,109,45,29,81,67
72342,5532,2589,2943,1703,1241,1404,1184
72346,697,357,340,177,136,224,160
72347,711,360,351,165,124,202,220
72348,2594,1252,1342,694,531,768,601
72350,1226,562,664,318,257,391,260
72351,835,401,434,245,184,226,180
72353,114,55,59,29,28,34,23
72354,2470,1202,1268,655,588,703,524
72355,2768,1355,1413,732,519,835,682
72358,1690,909,781,526,511,427,226
72359,430,190,240,138,95,100,97
72360,6466,2971,3495,1911,1340,1640,1575
72364,15831,7670,8161,5115,4446,4439,1831
72365,3146,1499,1647,810,705,872,759
72366,2543,1162,1381,687,480,708,668
72367,108,51,57,24,19,37,28
72368,1228,618,610,300,222,376,330
72370,8606,4167,4439,2684,2259,2249,1414
72372,1945,943,1002,499,415,534,497
72373,1329,632,697,352,252,376,349
72374,876,427,449,257,177,249,193
72376,1977,1005,972,481,384,675,437
72377,36,21,15,5,2,19,10
72379,50,32,18,13,11,6,20
72383,53,21,32,14,8,18,13
72384,953,454,499,243,221,270,219
72386,1777,866,911,463,400,524,390
72389,204,102,102,53,41,56,54
72390,9107,4165,4942,3143,2153,2228,1583
72392,481,225,256,120,80,156,125
72394,625,318,307,159,130,180,156
72395,1017,475,542,303,245,267,202
72396,13734,6594,7140,3866,3249,3754,2865
72401,53767,25923,27844,15427,16782,12157,9401
72404,23482,11512,11970,6853,7076,6139,3414
72410,498,253,245,117,116,165,100
72411,2294,1120,1174,639,615,602,438
72412,633,318,315,153,138,183,159
72413,598,298,300,157,138,164,139
72414,443,220,223,142,103,123,75
72415,1346,674,672,361,280,368,337
72416,5783,2872,2911,1710,1609,1512,952
72417,3568,1796,1772,1048,927,958,635
72419,1748,843,905,473,384,513,378
72421,554,300,254,153,137,131,133
72422,4979,2464,2515,1282,1039,1360,1298
72424,94,47,47,25,20,26,23
72425,446,227,219,105,98,132,111
72426,196,100,96,44,47,59,46
72427,174,91,83,50,40,39,45
72428,95,56,39,22,24,32,17
72429,427,224,203,96,86,141,104
72430,411,209,202,88,91,119,113
72431,401,195,206,99,80,118,104
72432,6462,3164,3298,1777,1485,1761,1439
72433,3067,1497,1570,840,777,802,648
72434,2108,1059,1049,567,452,602,487
72435,505,270,235,132,104,148,121
72436,942,459,483,271,183,288,200
72437,3272,1645,1627,917,810,838,707
72438,2574,1272,1302,763,675,613,523
72440,255,119,136,67,60,67,61
72441,94,47,47,21,18,29,26
72442,4886,2389,2497,1429,1203,1307,947
72443,2986,1483,1503,832,650,904,600
72444,1821,915,906,438,350,532,501
72445,91,43,48,30,25,17,19
72447,1964,925,1039,500,471,474,519
72449,213,107,106,59,47,49,58
72450,36033,17615,18418,10101,9279,9518,7135
72453,198,102,96,36,42,61,59
72454,5127,2444,2683,1239,1068,1398,1422
72455,12518,5998,6520,3184,2837,3345,3152
72456,585,305,280,129,109,207,140
72457,132,57,75,23,26,42,41
72458,755,372,383,189,146,213,207
72459,1329,681,648,289,244,423,373
72460,832,437,395,231,169,228,204
72461,3789,1836,1953,984,777,1021,1007
72462,408,208,200,113,96,107,92
72464,98,47,51,28,25,23,22
72466,1481,762,719,391,263,451,376
72467,303,302,1,234,69,0,0
72469,1124,556,568,317,211,323,273
72470,319,155,164,77,68,103,71
72471,1108,530,578,286,255,297,270
72472,9447,4534,4913,2652,2295,2517,1983
72473,2376,1154,1222,606,545,703,522
72476,7155,3403,3752,1843,1746,1758,1808
72478,390,219,171,145,64,70,111
72479,1489,776,713,361,312,461,355
72482,1241,633,608,233,184,391,433
72501,25099,12120,12979,6731,6277,6561,5530
72512,2234,1068,1166,360,284,493,1097
72513,2856,1398,1458,605,519,745,987
72515,63,31,32,20,15,18,10
72517,487,247,240,109,82,138,158
72519,3150,1817,1333,543,770,941,896
72520,309,162,147,64,54,107,84
72521,4814,2381,2433,1347,1064,1311,1092
72522,405,229,176,91,109,125,80
72523,1091,550,541,307,227,313,244
72524,376,195,181,83,85,110,98
72526,154,81,73,37,36,46,35
72527,583,277,306,166,161,150,106
72528,65,39,26,14,10,26,15
72529,4726,2289,2437,906,723,1041,2056
72530,1987,1000,987,448,399,570,570
72531,800,403,397,153,125,230,292
72532,1712,850,862,417,304,518,473
72533,416,213,203,91,75,132,118
72534,1320,660,660,345,321,378,276
72536,429,223,206,82,73,137,137
72537,805,408,397,124,98,258,325
72538,432,215,217,100,85,126,121
72539,253,122,131,55,43,85,70
72540,149,79,70,34,23,45,47
72542,3826,1917,1909,930,628,1090,1178
72543,12535,6069,6466,2880,2506,3277,3872
72544,636,317,319,102,85,216,233
72546,181,92,89,39,36,45,61
72550,985,496,489,247,233,300,205
72553,69,36,33,21,21,13,14
72554,2923,1411,1512,705,469,859,890
72555,182,88,94,41,29,51,61
72556,3375,1619,1756,815,699,904,957
72560,8754,4275,4479,1889,1566,2416,2883
72561,981,504,477,249,191,265,276
72562,2238,1108,1130,599,544,618,477
72564,546,279,267,158,114,143,131
72565,999,506,493,253,195,290,261
72566,624,330,294,149,127,207,141
72567,262,132,130,62,41,74,85
72568,1662,844,818,458,366,486,352
72569,468,242,226,133,97,125,113
72571,369,187,182,115,78,112,64
72572,228,116,112,55,22,74,77
72573,278,142,136,63,47,83,85
72576,3868,1875,1993,891,751,1068,1158
72577,700,368,332,189,146,194,171
72578,212,118,94,49,45,65,53
72579,1287,645,642,375,326,349,237
72581,1030,526,504,171,154,342,363
72583,1679,825,854,473,331,477,398
72584,568,296,272,132,105,183,148
72585,216,111,105,48,43,56,69
72587,134,70,64,24,26,36,48
72601,30163,14680,15483,7863,6953,8153,7194
72611,1696,839,857,466,342,486,402
72616,10441,5107,5334,3009,2488,2706,2238
72617,198,105,93,44,36,54,64
72619,1936,938,998,260,231,507,938
72623,648,349,299,124,99,233,192
72624,594,298,296,128,126,173,167
72626,1243,625,618,214,203,366,460
72628,803,418,385,167,140,255,241
72629,629,322,307,159,115,225,130
72630,197,90,107,37,20,54,86
72631,3709,1785,1924,432,375,1018,1884
72632,4449,2170,2279,716,681,1619,1433
72633,1833,956,877,494,368,584,387
72634,4670,2263,2407,1013,826,1420,1411
72635,3624,1745,1879,929,817,958,920
72636,24,12,12,2,1,7,14
72638,7186,3629,3557,2167,1811,1906,1302
72639,683,348,335,150,139,220,174
72640,385,197,188,105,86,106,88
72641,2585,1279,1306,601,460,700,824
72642,1979,967,1012,173,193,479,1134
72644,2253,1147,1106,490,415,600,748
72645,1867,938,929,389,315,548,615
72648,716,383,333,160,150,226,180
72650,4362,2138,2224,1007,877,1172,1306
72651,1206,604,602,231,196,371,408
72653,28560,13581,14979,5834,5012,7183,10531
72655,457,231,226,90,89,134,144
72658,1685,837,848,358,270,505,552
72660,524,263,261,122,113,160,129
72661,580,308,272,52,62,160,306
72662,2986,1518,1468,743,607,850,786
72663,361,184,177,103,80,94,84
72666,275,141,134,51,56,82,86
72668,521,255,266,90,64,175,192
72669,107,44,63,29,12,36,30
72670,99,45,54,23,16,29,31
72672,279,138,141,75,66,76,62
72675,1399,718,681,312,258,462,367
72677,525,263,262,169,134,138,84
72679,48,23,25,7,9,15,17
72680,807,399,408,199,146,240,222
72682,194,105,89,37,34,75,48
72683,211,99,112,56,54,51,50
72685,1365,697,668,356,328,367,314
72686,182,99,83,45,30,50,57
72687,6461,3231,3230,1373,1170,1984,1934
72701,39782,20118,19664,10952,15910,8139,4781
72703,28261,14064,14197,6530,10989,6500,4242
72704,21336,10798,10538,5647,8642,4758,2289
72712,40933,20144,20789,13475,12956,10049,4453
72714,11880,5779,6101,2867,2728,2966,3319
72715,15051,7172,7879,2265,2383,3211,7192
72717,1071,534,537,292,216,334,229
72718,1465,711,754,470,392,408,195
72719,8975,4383,4592,3265,3646,1583,481
72721,391,211,180,96,72,149,74
72722,3138,1614,1524,969,898,832,439
72727,5658,2823,2835,1618,1433,1612,995
72729,280,136,144,77,56,73,74
72730,7585,3664,3921,2318,2086,1937,1244
72732,4716,2425,2291,1135,919,1516,1146
72734,7322,3621,3701,2292,1829,2009,1192
72736,6208,3084,3124,1959,1377,1807,1065
72738,2419,1265,1154,604,550,729,536
72739,473,247,226,137,109,142,85
72740,9543,4691,4852,2729,2218,2582,2014
72742,545,277,268,139,100,167,139
72744,5343,2645,2698,1584,1277,1410,1072
72745,11376,5664,5712,3444,3421,2976,1535
72747,152,77,75,43,32,45,32
72749,84,60,24,45,13,17,9
72751,6434,3176,3258,2106,1849,1527,952
72752,293,156,137,53,43,88,109
72753,7936,3901,4035,2350,1902,2148,1536
72756,38455,19078,19377,11512,9982,10428,6533
72758,33487,16486,17001,11026,9777,8332,4352
72760,342,175,167,67,57,108,110
72761,21211,10508,10703,6663,6283,5075,3190
72762,35342,17307,18035,11232,9440,9188,5482
72764,50230,25238,24992,18015,16176,10439,5600
72768,1306,664,642,349,300,382,275
72769,1162,598,564,348,280,348,186
72773,953,485,468,256,218,306,173
72774,6121,3055,3066,1748,1349,1884,1140
72776,574,291,283,129,113,182,150
72801,18685,9092,9593,5530,6651,3466,3038
72802,20973,10510,10463,5757,5305,5926,3985
72821,2048,1025,1023,575,468,564,441
72823,6765,3307,3458,1839,1577,1918,1431
72824,1876,910,966,604,458,480,334
72826,47,27,20,15,10,17,5
72827,187,97,90,27,30,75,55
72828,114,63,51,20,27,33,34
72830,14896,7380,7516,4459,3981,3661,2795
72832,923,447,476,239,210,276,198
72833,4384,2199,2185,1386,1056,1100,842
72834,10565,5301,5264,3025,2607,2758,2175
72835,923,458,465,222,166,301,234
72837,7845,3929,3916,2011,1826,2373,1635
72838,115,60,55,23,19,36,37
72839,242,126,116,45,41,75,81
72840,2149,1073,1076,599,517,580,453
72841,227,119,108,61,32,56,78
72842,1478,731,747,376,301,405,396
72843,2274,1163,1111,647,513,680,434
72845,1216,602,614,294,299,349,274
72846,3913,1934,1979,1047,962,1072,832
72847,2850,1421,1429,687,649,903,611
72851,572,293,279,153,113,149,157
72852,315,164,151,67,35,108,105
72853,2217,1081,1136,675,539,574,429
72854,703,350,353,149,127,233,194
72855,6314,3092,3222,1551,1340,1729,1694
72856,464,224,240,108,76,138,142
72857,1430,710,720,326,274,426,404
72858,3178,1598,1580,953,845,889,491
72860,375,190,185,89,73,116,97
72863,1582,803,779,428,348,464,342
72865,1366,769,597,478,254,385,249
72901,21591,11028,10563,5898,6444,5940,3309
72903,26148,12413,13735,6558,7037,6823,5730
72904,21893,10529,11364,7568,5884,5199,3242
72908,13378,6459,6919,3667,3488,3702,2521
72916,7131,3570,3561,1812,1537,2326,1456
72921,13787,6779,7008,4158,3367,3752,2510
72923,4735,2292,2443,1161,1188,1336,1050
72926,545,281,264,118,81,167,179
72927,8701,4320,4381,2408,1905,2436,1952
72928,755,393,362,204,169,205,177
72930,320,156,164,74,60,92,94
72932,1597,817,780,477,372,469,279
72933,4999,2438,2561,1359,1054,1422,1164
72934,1047,550,497,269,209,335,234
72935,577,272,305,170,129,148,130
72936,14527,7117,7410,4332,3623,4104,2468
72937,3858,1970,1888,1042,810,1199,807
72938,1391,703,688,373,278,405,335
72940,2515,1253,1262,654,490,787,584
72941,5251,2628,2623,1482,1259,1515,995
72943,2646,1339,1307,776,563,735,572
72944,2919,1435,1484,846,670,799,604
72945,314,157,157,105,67,64,78
72946,3654,1874,1780,951,774,1104,825
72947,4433,2266,2167,1127,962,1317,1027
72948,518,268,250,141,84,173,120
72949,10177,5051,5126,2818,2397,2687,2275
72950,409,207,202,102,70,105,132
72951,988,501,487,266,221,275,226
72952,2945,1478,1467,795,578,953,619
72955,438,234,204,118,92,145,83
72956,34074,16623,17451,10037,8701,9116,6220
72958,8117,4085,4032,2381,1858,2102,1776
72959,2786,1413,1373,704,555,838,689
75556,26,8,18,9,4,7,6
89010,31,18,13,14,11,5,1
89019,69,39,30,20,16,22,11
89060,30,15,15,7,7,9,7
89061,51,23,28,13,8,14,16
89439,80,41,39,7,12,26,35
90001,57110,28468,28642,22125,18143,12045,4797
90002,51223,24876,26347,20574,15474,10922,4253
90003,66266,32631,33635,25975,20986,14179,5126
90004,62180,31302,30878,14910,21828,17284,8158
90005,37681,19299,18382,8646,14166,9756,5113
90006,59185,30254,28931,16531,20367,15065,7222
90007,40920,20915,20005,10030,20444,6795,3651
90008,32327,14477,17850,8138,8153,9262,6774
90010,3800,1874,1926,433,1636,992,739
90011,103892,52794,51098,40489,34568,21504,7331
90012,31103,19493,11610,3987,13553,7947,5616
90013,11772,7629,4143,509,4407,4686,2170
90014,7005,4471,2534,262,2733,2377,1633
90015,18986,9833,9153,5006,7545,4279,2156
90016,47596,22778,24818,13827,14296,12645,6828
90017,23768,12818,10950,6436,10120,4800,2412
90018,49310,23770,25540,14418,14955,12791,7146
90019,64458,31442,33016,15632,20952,17784,10090
90020,38967,19381,19586,8411,15405,10549,4602
90021,3951,2790,1161,454,1177,1702,618
90022,67179,33216,33963,23032,20626,15129,8392
90023,45903,23037,22866,16536,14652,9778,4937
90024,47452,22248,25204,10275,23856,6248,7073
90025,42147,20859,21288,5449,19967,9866,6865
90026,67869,34515,33354,15649,25573,17878,8769
90027,45151,22362,22789,6275,17707,12672,8497
90028,28714,16056,12658,3846,13736,7041,4091
90029,38617,19575,19042,8925,13645,10308,5739
90031,39316,19546,19770,11536,11933,9927,5920
90032,45786,22564,23222,13892,14185,10945,6764
90033,48852,24425,24427,17341,14681,10756,6074
90034,57964,28828,29136,10960,26140,14010,6854
90035,28418,13326,15092,5770,9539,7465,5644
90036,36865,17914,18951,6311,17023,8787,4744
90037,62276,31187,31089,21367,20409,14769,5731
90038,28917,15383,13534,6442,11704,7448,3323
90039,28514,14383,14131,5589,9317,8376,5232
90040,12520,6129,6391,4179,3626,2855,1860
90041,27425,13212,14213,6284,7919,7745,5477
90042,62430,30836,31594,17460,20425,15996,8549
90043,44789,20561,24228,12266,10913,12988,8622
90044,89779,43128,46651,32236,26961,21113,9469
90045,39480,18958,20522,9584,12522,11068,6306
90046,48581,25854,22727,4173,21652,13714,9042
90047,48606,22129,26477,14204,12415,13190,8797
90048,21397,10132,11265,2305,8714,5713,4665
90049,35482,16359,19123,6241,10792,9623,8826
90056,7827,3436,4391,1541,1436,2472,2378
90057,44998,24300,20698,11813,17812,9906,5467
90058,3223,1555,1668,1287,900,764,272
90059,40952,19623,21329,16433,11995,9015,3509
90061,26872,13049,13823,9763,8013,6225,2871
90062,32821,15720,17101,10380,9684,8525,4232
90063,55758,27843,27915,19713,17257,11997,6791
90064,25403,12297,13106,5219,7465,7241,5478
90065,45527,22873,22654,12134,13667,12358,7368
90066,55277,27714,27563,10854,19485,15252,9686
90067,2424,1074,1350,133,395,469,1427
90068,22286,12018,10268,2459,8991,7140,3696
90069,20483,12153,8330,1090,8435,7094,3864
90071,15,13,2,0,5,9,1
90073,539,506,33,4,62,258,215
90077,9377,4594,4783,2090,1484,3003,2800
90079,0,0,0,0,0,0,0
90089,3217,1436,1781,2627,575,14,1
90090,0,0,0,0,0,0,0
90094,5464,2559,2905,749,2995,1143,577
90095,3,2,1,1,0,2,0
90201,101279,50658,50621,37787,32028,22623,8841
90210,21741,10292,11449,4722,3897,6449,6673
90211,8434,3849,4585,1860,2267,2537,1770
90212,11555,5211,6344,2457,3102,3460,2536
90220,49328,23773,25555,17421,13935,11962,6010
90221,53704,26346,27358,20629,16484,11741,4850
90222,31869,15375,16494,12037,9424,6995,3413
90230,31766,14932,16834,7428,8910,9083,6345
90232,15149,7333,7816,3058,4894,4448,2749
90240,25876,12501,13375,7497,7215,6768,4396
90241,42399,20466,21933,12404,12675,10955,6365
90242,43497,21207,22290,13695,13549,10668,5585
90245,16654,8304,8350,4071,4470,5604,2509
90247,47487,23217,24270,12969,13944,12371,8203
90248,9947,4823,5124,2314,2495,2814,2324
90249,26669,12897,13772,7197,7226,7489,4757
90250,93193,45113,48080,28298,29934,24123,10838
90254,19506,10273,9233,3272,7685,5837,2712
90255,75066,37525,37541,26365,23751,17234,7716
90260,34924,17509,17415,10471,11131,9323,3999
90262,69745,33919,35826,25509,22535,15892,5809
90263,1612,665,947,992,620,0,0
90265,18116,9159,8957,3821,3500,6169,4626
90266,35135,17605,17530,9224,7776,11505,6630
90270,27372,13992,13380,9970,8993,5899,2510
90272,22986,10952,12034,5950,2932,7666,6438
90274,25209,12199,13010,6281,2658,8335,7935
90275,41804,20283,21521,10159,5578,13638,12429
90277,35293,17521,17772,6153,10190,11930,7020
90278,40071,19848,20223,9483,11981,12750,5857
90280,94396,46321,48075,32833,29329,22258,9976
90290,6368,3180,3188,1429,1192,2502,1245
90291,28341,14757,13584,4067,11717,8611,3946
90292,21576,10729,10847,1921,8341,6273,5041
90293,12132,5890,6242,1251,4721,3758,2402
90301,36568,17633,18935,11029,11087,9665,4787
90302,29415,13803,15612,8592,9269,7980,3574
90303,26176,12733,13443,8764,7693,6480,3239
90304,28210,14503,13707,10226,8931,6642,2411
90305,14853,6552,8301,3363,3344,4674,3472
90401,6722,3524,3198,540,3075,1815,1292
90402,12250,5809,6441,2845,1954,3985,3466
90403,24525,11426,13099,3320,8580,7316,5309
90404,21360,10292,11068,3616,8004,5865,3875
90405,27186,13364,13822,4262,8916,8609,5399
90501,43180,21483,21697,12165,12765,12167,6083
90502,18010,8811,9199,3962,4996,5210,3842
90503,44383,21481,22902,10791,10828,14053,8711
90504,32102,15886,16216,7978,7909,9976,6239
90505,36678,17684,18994,9071,7579,11978,8050
90506,0,0,0,0,0,0,0
90601,31974,15312,16662,8641,9028,8709,5596
90602,25777,12720,13057,8109,8173,6256,3239
90603,20063,9694,10369,5395,4793,5860,4015
90604,39407,19270,20137,11783,11296,10544,5784
90605,40331,20033,20298,12992,11392,10573,5374
90606,32396,15936,16460,9894,9332,8188,4982
90620,45113,22241,22872,12161,11666,13437,7849
90621,35153,17377,17776,10731,11084,9075,4263
90623,15554,7516,8038,3862,3638,4593,3461
90630,47993,23204,24789,12980,11008,15302,8703
90631,67619,33320,34299,19563,18895,18141,11020
90638,49012,23520,25492,12676,13186,13288,9862
90640,62549,30189,32360,18124,17806,15238,11381
90650,105549,52364,53185,32836,31195,26711,14807
90660,62928,30738,32190,18957,17596,15925,10450
90670,14866,7163,7703,4303,3919,3806,2838
90680,29945,14811,15134,9043,8956,7515,4431
90701,16591,8227,8364,4242,4483,4772,3094
90703,49399,23785,25614,11363,10770,14664,12602
90704,4090,2101,1989,1111,1095,1235,649
90706,76615,37203,39412,24348,22875,19572,9820
90710,25457,12291,13166,6997,6989,6824,4647
90712,31499,15277,16222,8470,8073,9597,5359
90713,27925,13574,14351,7510,6875,8789,4751
90715,20388,9935,10453,5909,6070,5646,2763
90716,14184,7078,7106,5132,4328,3114,1610
90717,21318,10317,11001,5130,5678,6681,3829
90720,21751,10423,11328,5921,4431,6876,4523
90723,54099,26315,27784,19646,16815,12415,5223
90731,59662,29951,29711,16467,17196,16832,9167
90732,21115,9843,11272,4538,4509,6333,5735
90740,23729,10423,13306,3369,3596,5710,11054
90742,831,454,377,111,225,287,208
90743,456,238,218,96,86,163,111
90744,53815,27298,26517,19263,16603,12291,5658
90745,57251,27754,29497,15842,14942,15886,10581
90746,25990,11944,14046,6618,6130,7306,5936
90747,0,0,0,0,0,0,0
90755,11074,5462,5612,2915,3332,3286,1541
90802,39347,20387,18960,7231,16143,10856,5117
90803,32031,15609,16422,4161,10411,10012,7447
90804,40311,19686,20625,11270,15727,9610,3704
90805,93524,45229,48295,32856,28489,22626,9553
90806,42399,20717,21682,14280,12696,10563,4860
90807,31481,15153,16328,7356,8548,9666,5911
90808,38232,18408,19824,9473,8662,12485,7612
90810,36735,18067,18668,11938,10303,9188,5306
90813,58911,29425,29486,21621,19277,13057,4956
90814,19131,9356,9775,3312,7203,5766,2850
90815,39733,19124,20609,9722,11311,11205,7495
90822,117,109,8,5,0,37,75
90831,0,0,0,0,0,0,0
91001,36126,17421,18705,9114,8005,11665,7342
91006,31715,15283,16432,7893,6604,10512,6706
91007,34095,16039,18056,7646,7413,10679,8357
91008,1391,614,777,212,207,385,587
91010,26074,12461,13613,6899,6838,7141,5196
91011,20280,9863,10417,5824,2680,7237,4539
91016,40598,19434,21164,10572,11051,12067,6908
91020,8415,3966,4449,2035,2146,2707,1527
91024,10917,5165,5752,2240,2106,3772,2799
91030,25616,12160,13456,6489,6282,8345,4500
91040,20372,10120,10252,4417,4882,6851,4222
91042,27585,13734,13851,6100,7380,9008,5097
91046,156,51,105,13,10,18,115
91101,20460,9926,10534,3153,9698,4419,3190
91103,27480,13481,13999,7781,7791,7123,4785
91104,36751,17874,18877,9069,10302,10992,6388
91105,11254,5432,5822,1754,2444,3342,3714
91106,24229,11993,12236,4602,9662,6004,3961
91107,32940,15940,17000,6978,8849,9855,7258
91108,13361,6410,6951,3697,1879,4546,3239
91201,22781,11123,11658,4695,6541,6901,4644
91202,22830,10805,12025,4469,6381,6850,5130
91203,13220,6279,6941,2614,4219,3846,2541
91204,16032,7699,8333,3515,4995,4460,3062
91205,37810,18084,19726,8127,11295,10837,7551
91206,33065,15544,17521,6230,9090,9878,7867
91207,10506,4924,5582,2031,2351,3308,2816
91208,16245,7756,8489,3721,3538,5309,3677
91210,328,162,166,41,170,84,33
91214,30356,14642,15714,8115,5937,10749,5555
91301,25488,12511,12977,6853,4909,9136,4590
91302,25709,12487,13222,7173,4776,8785,4975
91303,26855,13907,12948,7799,9924,6592,2540
91304,50231,24827,25404,13863,14076,14101,8191
91306,45061,22679,22382,12163,13554,12673,6671
91307,24474,11939,12535,6215,4790,8051,5418
91311,36557,17838,18719,8066,8769,11616,8106
91316,26898,12717,14181,4988,7530,7642,6738
91320,44274,21952,22322,12789,9443,14290,7752
91321,34882,17402,17480,10289,10339,8621,5633
91324,27669,13545,14124,6991,8133,7492,5053
91325,32417,15819,16598,7600,10476,8535,5806
91326,33708,16394,17314,8009,7538,10501,7660
91330,2702,1103,1599,1675,989,34,4
91331,103689,52358,51331,35408,32546,24380,11355
91335,74363,36596,37767,19864,22281,20632,11586
91340,34188,17130,17058,11343,10704,8186,3955
91342,91725,45786,45939,29204,27339,23513,11669
91343,60254,30145,30109,18749,18299,15386,7820
91344,51747,25212,26535,12688,12437,15994,10628
91345,18496,9110,9386,5115,5172,4857,3352
91350,33348,16270,17078,9959,8580,10300,4509
91351,32362,16086,16276,10039,8956,9635,3732
91352,47807,23980,23827,14754,14507,12176,6370
91354,28722,14046,14676,9409,6785,9349,3179
91355,32605,15773,16832,8297,8643,10117,5548
91356,29458,14216,15242,6720,7244,8634,6860
91360,42402,20755,21647,10717,9581,12566,9538
91361,20438,9854,10584,4599,3384,6542,5913
91362,36045,17562,18483,9484,7063,12154,7344
91364,25851,12739,13112,5641,5608,8277,6325
91367,39499,19171,20328,8011,11186,11507,8795
91371,1,0,1,0,0,0,1
91377,13811,6641,7170,3992,2570,5330,1919
91381,20158,9852,10306,6870,4568,6828,1892
91384,29855,18503,11352,8354,10055,9143,2303
91387,40328,20106,20222,13008,11428,11775,4117
91390,19786,9911,9875,6047,3803,7347,2589
91401,39285,19613,19672,9815,12295,11317,5858
91402,69817,35095,34722,22840,22662,16812,7503
91403,23484,11277,12207,4023,8008,6784,4669
91405,51145,25498,25647,14786,16725,13354,6280
91406,51558,25956,25602,14525,16655,13936,6442
91411,24628,12495,12133,6211,8782,6448,3187
91423,30991,14789,16202,5659,10314,9349,5669
91436,14372,6890,7482,3408,2364,4417,4183
91501,20849,10040,10809,4587,6418,6068,3776
91502,11371,5402,5969,2415,3893,2834,2229
91504,24939,12006,12933,5953,7028,7311,4647
91505,30778,15121,15657,6560,9520,9499,5199
91506,18904,9115,9789,4176,4929,6102,3697
91601,37180,18932,18248,7610,15937,9542,4091
91602,17473,8722,8751,2355,7127,5396,2595
91604,29034,14271,14763,5001,9379,9066,5588
91605,56343,28417,27926,16821,17973,14486,7063
91606,44958,22376,22582,11998,14340,12085,6535
91607,27927,13635,14292,5411,9461,8120,4935
91608,0,0,0,0,0,0,0
91701,38976,18966,20010,10576,9128,12628,6644
91702,59705,29486,30219,19563,19069,14298,6775
91706,76571,37969,38602,25686,22798,18771,9316
91708,3369,685,2684,469,1561,1176,163
91709,74796,36954,37842,22601,18681,24845,8669
91710,80358,42283,38075,23547,25101,22088,9622
91711,35705,16777,18928,9092,9334,9325,7954
91722,34409,16859,17550,10222,9899,9364,4924
91723,18275,8783,9492,5182,5271,4978,2844
91724,26184,12780,13404,7259,6520,7752,4653
91730,66925,33393,33532,18870,23142,17593,7320
91731,29591,14888,14703,8941,8704,7216,4730
91732,61386,30755,30631,19657,18559,15331,7839
91733,43896,22191,21705,14706,13568,10471,5151
91737,24740,12089,12651,7074,5796,8289,3581
91739,34794,17254,17540,11350,10033,10340,3071
91740,25356,12269,13087,6788,6355,7451,4762
91741,25824,12498,13326,6706,5511,8245,5362
91744,85040,42564,42476,28095,25268,21073,10604
91745,54013,26287,27726,13445,13495,15467,11606
91746,30485,15116,15369,9640,8783,7613,4449
91748,45406,22368,23038,10632,12214,13835,8725
91750,33249,15881,17368,8370,7187,9938,7754
91752,30047,14981,15066,9794,8646,7689,3918
91754,32742,15620,17122,6857,8197,9216,8472
91755,27496,13271,14225,5504,6877,8464,6651
91759,476,239,237,88,99,171,118
91761,56913,28360,28553,18981,17176,14952,5804
91762,55857,27686,28171,18732,17034,13596,6495
91763,36375,18099,18276,11905,11114,8862,4494
91764,54086,27027,27059,18587,18137,12330,5032
91765,46457,22702,23755,11287,11378,15357,8435
91766,71599,36111,35488,24824,22329,17180,7266
91767,48068,23685,24383,15401,14626,11999,6042
91768,34537,17509,17028,11766,11266,7848,3657
91770,62097,30521,31576,15628,16928,17876,11665
91773,33119,15737,17382,7901,7600,10262,7356
91775,23988,11448,12540,5755,5666,7448,5119
91776,38475,18751,19724,8506,11339,11573,7057
91780,34332,16438,17894,8287,8278,10948,6819
91784,25938,12729,13209,6376,5052,8509,6001
91786,51165,24516,26649,14631,15864,13077,7593
91789,43079,20988,22091,10195,9784,14467,8633
91790,44907,21721,23186,13035,12377,12255,7240
91791,32414,15512,16902,8762,8313,8960,6379
91792,30854,14950,15904,8148,9280,8520,4906
91801,52735,24833,27902,10911,16162,15469,10193
91803,30322,14486,15836,6835,8492,8744,6251
91901,17403,8750,8653,4690,3551,5722,3440
91902,17653,8603,9050,4217,3924,5202,4310
91905,1700,965,735,365,372,539,424
91906,3627,1959,1668,1121,815,1044,647
91910,75802,36862,38940,21310,21105,20394,12993
91911,82999,39938,43061,25590,22814,21412,13183
91913,40971,19793,21178,13776,12524,10730,3941
91914,15448,7521,7927,5477,3989,4593,1389
91915,24659,12044,12615,8664,7537,6536,1922
91916,1622,828,794,349,295,576,402
91917,992,513,479,273,227,297,195
91931,592,305,287,156,109,222,105
91932,25718,12874,12844,7390,8423,6523,3382
91934,737,378,359,173,142,218,204
91935,8624,4392,4232,2048,1451,3129,1996
91941,31779,15341,16438,7560,8035,9257,6927
91942,38069,18064,20005,7811,12481,10238,7539
91945,25460,12426,13034,7300,7090,7040,4030
91948,78,36,42,5,6,25,42
91950,60322,31009,29313,17839,20017,13838,8628
91962,1646,827,819,345,300,593,408
91963,1118,576,542,334,250,314,220
91977,58368,28506,29862,17911,16120,15566,8771
91978,8896,4347,4549,2384,2382,2621,1509
91980,165,79,86,54,41,37,33
92003,4746,2335,2411,1073,1011,1411,1251
92004,3881,1943,1938,769,512,979,1621
92007,10429,5239,5190,2068,3174,3279,1908
92008,27649,14098,13551,5792,8304,7746,5807
92009,40747,19672,21075,11757,8458,13275,7257
92010,14382,6950,7432,3856,3385,4368,2773
92011,22405,10700,11705,5960,4345,7170,4930
92014,13154,6509,6645,2440,2466,4234,4014
92019,42598,20799,21799,11220,10536,12725,8117
92020,57767,28375,29392,16068,16714,15208,9777
92021,65068,31821,33247,18501,17773,18346,10448
92024,49121,24214,24907,11283,11799,16133,9906
92025,49978,25149,24829,16228,14860,12226,6664
92026,48922,24017,24905,13186,12993,13319,9424
92027,53881,26927,26954,16966,15431,14079,7405
92028,46239,23098,23141,12422,10681,12580,10556
92029,19021,9292,9729,4341,4353,5882,4445
92036,3440,1755,1685,609,496,1202,1133
92037,46781,22678,24103,12005,13799,9828,11149
92040,41281,20565,20716,11119,10307,12555,7300
92054,40375,20529,19846,10720,13659,10321,5675
92055,15655,14267,1388,3633,12006,13,3
92056,51835,25146,26689,12816,14086,13780,11153
92057,54096,26405,27691,15805,15015,14157,9119
92058,42436,22025,20411,14552,17838,6445,3601
92059,1618,796,822,551,418,415,234
92060,218,119,99,22,24,89,83
92061,2499,1290,1209,663,538,683,615
92064,47904,23604,24300,13226,9833,16015,8830
92065,35414,17837,17577,9976,7878,11554,6006
92066,378,195,183,68,61,139,110
92067,9535,4691,4844,2466,912,3279,2878
92069,46369,23166,23203,15110,13736,11828,5695
92070,1245,626,619,308,264,355,318
92071,53422,25826,27596,14193,14593,16002,8634
92075,12056,5953,6103,2432,3010,3521,3093
92078,42906,20311,22595,11873,12004,10122,8907
92081,27404,13663,13741,6542,8740,7654,4468
92082,19037,9626,9411,5309,3880,5999,3849
92083,36975,18844,18131,11987,12467,8766,3755
92084,47654,23840,23814,13987,13379,12554,7734
92086,1573,737,836,211,298,425,639
92091,1048,476,572,132,99,314,503
92101,37095,22255,14840,2244,18101,10478,6272
92102,43267,21915,21352,13083,15388,10211,4585
92103,31066,16155,14911,2824,12425,8865,6952
92104,44414,22811,21603,8321,18782,12226,5085
92105,69813,34661,35152,24687,21912,16065,7149
92106,19330,9871,9459,3907,5936,5066,4421
92107,28651,14778,13873,4475,12770,7221,4185
92108,18858,9446,9412,1842,11505,3616,1895
92109,45787,24648,21139,4546,26591,8384,6266
92110,25341,12715,12626,5433,9467,5783,4658
92111,45096,22275,22821,10974,14353,11766,8003
92113,56066,30009,26057,19698,20967,10860,4541
92114,65433,32091,33342,20095,17464,17505,10369
92115,58560,29075,29485,15901,23226,12322,7111
92116,31680,15980,15700,5055,13198,9361,4066
92117,51332,25877,25455,10284,16309,14626,10113
92118,23575,13532,10043,4517,9278,5138,4642
92119,23057,11041,12016,4991,5581,6503,5982
92120,26317,12686,13631,5209,6936,7280,6892
92121,4179,2182,1997,708,2116,987,368
92122,43728,21619,22109,5942,22530,7964,7292
92123,26823,13237,13586,6641,9809,6257,4116
92124,30443,14945,15498,9500,10537,6346,4060
92126,73343,38728,34615,17370,26713,19057,10203
92127,39337,19303,20034,12663,10625,11579,4470
92128,47490,22379,25111,10706,11388,13378,12018
92129,51536,25509,26027,15023,12340,17370,6803
92130,48940,23932,25008,15784,10952,17402,4802
92131,32787,16089,16698,9647,7501,11112,4527
92132,0,0,0,0,0,0,0
92134,198,161,37,23,160,2,13
92135,571,502,69,99,447,25,0
92139,35125,16905,18220,10388,10368,9057,5312
92140,3435,3407,28,1757,1666,8,4
92145,1449,713,736,554,364,438,93
92147,559,455,104,124,394,41,0
92154,79708,41254,38454,23697,24072,20710,11229
92155,550,508,42,68,435,47,0
92173,29429,13906,15523,10531,8020,7137,3741
92201,61827,30567,31260,21370,17105,14035,9317
92203,25605,12597,13008,7096,6914,5801,5794
92210,4677,2132,2545,306,196,982,3193
92211,24294,11257,13037,2836,2944,4727,13787
92220,31638,15295,16343,8202,6994,6709,9733
92222,45,26,19,14,11,5,15
92223,43605,21206,22399,13395,11756,10278,8176
92225,24310,16065,8245,5706,7397,7821,3386
92227,26234,12808,13426,9347,6690,6380,3817
92230,2550,1279,1271,888,647,686,329
92231,39073,18512,20561,13565,9736,9640,6132
92233,8099,6116,1983,1512,3837,2129,621
92234,51151,26308,24843,15376,12795,13138,9842
92236,41083,20488,20595,17543,12765,7994,2781
92239,223,117,106,48,38,59,78
92240,34722,17428,17294,11708,9240,8560,5214
92241,8803,4457,4346,1741,1515,2103,3444
92242,1539,779,760,226,187,413,713
92243,48030,23812,24218,15673,12900,12121,7336
92249,7334,3512,3822,2846,2145,1548,795
92250,8285,4078,4207,2731,1907,2166,1481
92251,21583,12891,8692,6185,8046,5516,1836
92252,9647,4836,4811,2253,2501,2712,2181
92253,37262,18000,19262,9039,6767,10548,10908
92254,12768,6702,6066,5501,3818,2639,810
92256,3588,1846,1742,725,759,1248,856
92257,2326,1183,1143,429,371,601,925
92258,861,471,390,285,253,217,106
92259,390,213,177,65,39,133,153
92260,31753,14920,16833,5674,5950,7365,12764
92262,26179,14506,11673,4960,5120,8558,7541
92264,19383,11143,8240,2126,2853,6005,8399
92266,234,134,100,39,35,75,85
92267,126,63,63,14,16,33,63
92268,574,294,280,67,59,220,228
92270,17220,8510,8710,1991,1489,4358,9382
92273,1823,887,936,666,468,456,233
92274,19801,10482,9319,8062,6022,3827,1890
92275,1506,749,757,456,321,392,337
92276,7585,3799,3786,1963,1608,1701,2313
92277,23911,12070,11841,7367,9349,4324,2871
92278,3846,3494,352,921,2878,44,3
92280,14,2,12,1,0,5,8
92281,2432,1138,1294,920,574,566,372
92282,1239,664,575,313,289,407,230
92283,3158,1531,1627,1065,700,714,679
92284,25095,12324,12771,6511,5672,6795,6117
92285,2632,1388,1244,484,419,842,887
92301,32725,16857,15868,13313,10061,6895,2456
92304,17,13,4,0,5,9,3
92305,535,264,271,111,104,191,129
92307,37630,18650,18980,11589,8347,10385,7309
92308,39837,19416,20421,12185,8579,10138,8935
92309,763,410,353,316,239,157,51
92310,8845,5034,3811,3190,5021,599,35
92311,31894,16007,15887,10369,8373,8117,5035
92313,12025,5793,6232,3097,3460,3329,2139
92314,10162,5138,5024,2625,2027,3283,2227
92315,5094,2615,2479,1140,1050,1466,1438
92316,30830,15538,15292,11339,8887,7535,3069
92320,7788,3734,4054,1569,1513,2123,2583
92321,1522,803,719,427,368,447,280
92322,1257,636,621,311,239,443,264
92324,56505,27716,28789,19815,17433,13185,6072
92325,9391,4772,4619,2329,1979,3220,1863
92327,632,336,296,153,112,229,138
92328,445,261,184,30,152,163,100
92332,65,47,18,13,11,24,17
92333,472,235,237,68,59,159,186
92335,95397,47699,47698,36537,28966,21306,8588
92336,88419,43786,44633,31602,26018,23240,7559
92337,37849,18966,18883,13832,11450,9672,2895
92338,12,5,7,3,1,5,3
92339,885,445,440,185,204,324,172
92341,410,225,185,78,68,154,110
92342,6379,3189,3190,1568,1196,1735,1880
92344,20769,10329,10440,7635,5386,5525,2223
92345,78715,39118,39597,27555,20388,19608,11164
92346,54923,26943,27980,17286,13979,15424,8234
92347,1692,857,835,512,353,496,331
92352,8004,4036,3968,2051,1377,2638,1938
92354,21559,10100,11459,5024,7378,4901,4256
92356,6455,3356,3099,1695,1279,2001,1480
92358,707,366,341,111,95,283,218
92359,8103,4017,4086,2378,2245,2335,1145
92363,5321,2683,2638,1535,1124,1436,1226
92364,90,47,43,23,21,24,22
92365,2637,1339,1298,666,497,814,660
92368,1113,592,521,393,225,303,192
92371,16763,8565,8198,5174,3637,5258,2694
92372,6220,3136,3084,1733,1234,2049,1204
92373,33423,15762,17661,7797,9079,9217,7330
92374,40267,19353,20914,12255,11396,10513,6103
92376,81516,39551,41965,30726,23610,18638,8542
92377,19989,9894,10095,6562,5379,5538,2510
92378,183,89,94,50,44,50,39
92382,5268,2710,2558,1347,1156,1815,950
92384,36,18,18,3,10,14,9
92385,313,150,163,71,51,94,97
92386,2270,1163,1107,590,492,741,447
92389,156,89,67,22,16,52,66
92391,2534,1317,1217,816,567,784,367
92392,54858,26839,28019,20381,15167,13188,6122
92394,33237,18149,15088,11571,11138,7796,2732
92395,42400,20290,22110,14141,11110,9864,7285
92397,4894,2522,2372,1247,936,1665,1046
92398,1379,707,672,381,304,409,285
92399,52606,25954,26652,15157,12500,15153,9796
92401,1932,953,979,717,575,391,249
92404,58271,28141,30130,20928,16113,13396,7834
92405,28873,14249,14624,10596,8283,7022,2972
92407,56689,28105,28584,19748,18393,13400,5148
92408,15271,8413,6858,4851,5168,3754,1498
92410,49410,24251,25159,20066,14355,10465,4524
92411,26214,12803,13411,10391,7109,5625,3089
92501,20970,10789,10181,6131,7089,5339,2411
92503,84519,42058,42461,28524,24397,21447,10151
92504,53778,26232,27546,16449,15299,13442,8588
92505,47672,23563,24109,15620,14970,11566,5516
92506,44001,21413,22588,11504,10260,13483,8754
92507,58002,28739,29263,19271,22813,10597,5321
92508,35000,17320,17680,12141,9003,10458,3398
92509,75196,37947,37249,26261,21171,19100,8664
92518,1162,599,563,170,129,255,608
92530,50216,25354,24862,17450,14464,13202,5100
92532,18644,9289,9355,6529,5669,4702,1744
92536,3810,1964,1846,835,610,1296,1069
92539,4734,2393,2341,1140,849,1573,1172
92543,33555,15679,17876,9969,7939,7314,8333
92544,44734,21850,22884,13543,10333,11957,8901
92545,39457,18762,20695,10579,8314,8068,12496
92548,6643,3363,3280,2030,1543,1560,1510
92549,3926,1955,1971,873,644,1248,1161
92551,30815,14916,15899,11768,9059,7357,2631
92553,73722,36130,37592,28263,22411,16570,6478
92555,39076,19025,20051,13328,11516,10005,4227
92557,50320,24491,25829,16679,14284,13544,5813
92561,1661,866,795,282,197,619,563
92562,62079,30267,31812,20121,14384,18100,9474
92563,53892,26874,27018,18551,15114,13618,6609
92567,9459,4730,4729,3172,2342,2560,1385
92570,53697,27501,26196,19706,14567,13127,6297
92571,52516,25943,26573,21544,15821,11441,3710
92582,15649,7666,7983,6053,4493,3427,1676
92583,30236,14702,15534,10275,7721,7009,5231
92584,43400,21401,21999,14560,12101,10674,6065
92585,17797,8845,8952,5835,4840,4332,2790
92586,19815,8751,11064,3064,2692,3949,10110
92587,16675,8356,8319,4846,3912,4968,2949
92590,3660,1804,1856,997,716,1168,779
92591,38272,18675,19597,12212,10371,10641,5048
92592,72492,35736,36756,24684,17341,22057,8410
92595,29851,14712,15139,9202,7700,8445,4504
92596,23172,11520,11652,8504,6712,5717,2239
92602,22871,11143,11728,6678,7923,6417,1853
92603,20184,10024,10160,5312,4965,6528,3379
92604,26853,12997,13856,6739,6651,8072,5391
92606,21495,10466,11029,5921,6756,6376,2442
92610,11248,5623,5625,3700,2756,4036,756
92612,27522,13425,14097,4879,12194,6076,4373
92614,24748,11975,12773,6054,8135,7335,3224
92617,14044,6721,7323,6061,6454,1088,441
92618,16366,8252,8114,3491,7033,4223,1619
92620,38486,18533,19953,10614,10595,11940,5337
92624,7248,3652,3596,1628,1657,2301,1662
92625,12478,5817,6661,1955,2530,3754,4239
92626,49341,24786,24555,11045,17738,13100,7458
92627,61510,31607,29903,16084,22079,16148,7199
92629,25756,12693,13063,4997,5979,8257,6523
92630,59182,29398,29784,15424,16133,17817,9808
92637,16012,5716,10296,58,223,1574,14157
92646,55224,27076,28148,12632,12398,17336,12858
92647,57245,28566,28679,15357,16955,15883,9050
92648,45317,22719,22598,9161,13582,13795,8779
92649,32463,16037,16426,6575,7838,10171,7879
92651,23881,11977,11904,4323,4411,8490,6657
92653,29291,14371,14920,7430,6981,9321,5559
92655,8337,4111,4226,2323,2238,2317,1459
92656,49046,23506,25540,13629,15163,15592,4662
92657,9741,4709,5032,2532,1705,3638,1866
92660,34797,16839,17958,7748,7594,10376,9079
92661,3744,1981,1763,478,1186,1005,1075
92662,2756,1230,1526,305,499,739,1213
92663,21649,11377,10272,3141,8261,5695,4552
92672,34464,17412,17052,7805,9328,10140,7191
92673,29309,14613,14696,9306,5853,9300,4850
92675,34731,17225,17506,9552,7698,9761,7720
92676,1945,989,956,395,335,841,374
92677,63297,30676,32621,15770,13217,21928,12382
92678,494,247,247,122,111,195,66
92679,32611,16169,16442,10679,5386,12852,3694
92683,89747,44391,45356,23375,23333,25526,17513
92688,43792,21311,22481,14023,11409,14316,4044
92691,47582,23526,24056,12210,10981,14934,9457
92692,47222,22763,24459,12206,9053,15837,10126
92694,21944,10833,11111,8817,6488,5622,1017
92701,53908,27732,26176,20412,18275,11206,4015
92703,65445,34003,31442,22541,21413,14928,6563
92704,88123,44951,43172,29223,28630,21139,9131
92705,44706,22017,22689,12719,10902,12347,8738
92706,36457,18347,18110,12283,10971,8836,4367
92707,59492,30423,29069,19948,20056,14022,5466
92708,56004,27295,28709,13391,12743,16544,13326
92780,57741,28156,29585,17048,18291,14588,7814
92782,23032,11090,11942,6497,6781,7175,2579
92801,62068,30793,31275,20060,19330,14947,7731
92802,42709,21360,21349,13944,13541,10101,5123
92804,85914,42316,43598,25560,26168,22223,11963
92805,70401,35868,34533,24108,23606,16132,6555
92806,37173,18685,18488,10262,12554,9185,5172
92807,36171,17695,18476,8871,8195,11263,7842
92808,20039,9761,10278,5515,4589,7106,2829
92821,35533,17338,18195,8989,9409,10629,6506
92823,3613,1757,1856,1079,846,1163,525
92831,34204,16728,17476,8987,12695,7984,4538
92832,24752,12419,12333,7062,8370,6081,3239
92833,51767,25643,26124,15087,13954,15018,7708
92835,24010,11414,12596,5674,5189,7055,6092
92840,54083,26955,27128,15698,16059,14536,7790
92841,32845,16368,16477,8880,9001,9464,5500
92843,45214,22754,22460,13915,12971,12173,6155
92844,24307,12148,12159,6716,7058,7068,3465
92845,16333,7965,8368,4248,3409,5203,3473
92860,27198,15702,11496,6370,7464,9346,4018
92861,5781,2854,2927,1338,808,1799,1836
92865,19704,9788,9916,5270,5948,5484,3002
92866,14885,7139,7746,3648,5000,3918,2319
92867,44515,22134,22381,13537,12069,12214,6695
92868,25404,13933,11471,6411,10094,6033,2866
92869,37184,18433,18751,9980,9484,10975,6745
92870,52033,25617,26416,14224,14541,13949,9319
92879,46745,23130,23615,15208,14185,12034,5318
92880,58763,29140,29623,20633,17837,15060,5233
92881,30991,15202,15789,10448,7262,9564,3717
92882,67917,33742,34175,22958,19103,18388,7468
92883,29301,14411,14890,9413,7258,8387,4243
92886,46564,22582,23982,12719,9405,15142,9298
92887,20006,9803,10203,5490,4107,7315,3094
93001,32990,16773,16217,8144,9632,9818,5396
93003,50474,24818,25656,12306,13177,14801,10190
93004,29149,14170,14979,7999,6764,8785,5601
93010,42901,21109,21792,10838,10177,12078,9808
93012,34617,16481,18136,9080,7562,9977,7998
93013,16091,7949,8142,3847,4045,4737,3462
93015,17334,8681,8653,5808,4749,4214,2563
93021,36422,18098,18324,11148,9311,11553,4410
93022,6106,3062,3044,1502,1348,2060,1196
93023,20589,9805,10784,4674,3752,6776,5387
93030,59372,30038,29334,20281,18664,13714,6713
93033,82728,42604,40124,29551,26904,17562,8711
93035,27732,14006,13726,6700,7539,8123,5370
93036,41691,20812,20879,13690,13065,10021,4915
93040,2031,1052,979,737,581,487,226
93041,23641,12046,11595,7326,8025,4923,3367
93042,56,52,4,2,51,3,0
93043,333,274,59,32,203,92,6
93060,32811,16540,16271,10784,9411,7669,4947
93063,54366,26592,27774,14719,13254,17145,9248
93064,40,21,19,12,9,13,6
93065,72508,35772,36736,20476,18838,22298,10896
93066,3102,1586,1516,772,611,955,764
93067,895,424,471,144,264,289,198
93101,31683,15998,15685,7396,12727,7328,4232
93103,20249,10442,9807,4660,6541,5362,3686
93105,24815,11815,13000,4659,5785,7197,7174
93108,11112,5184,5928,2357,1699,3059,3997
93109,10858,5459,5399,2113,3047,3045,2653
93110,16829,8391,8438,3692,4200,4834,4103
93111,17370,8350,9020,3980,3471,5290,4629
93117,53217,26703,26514,15748,23023,8942,5504
93201,1348,690,658,583,354,281,130
93202,4143,1992,2151,1596,1142,948,457
93203,20938,10875,10063,8863,6381,4108,1586
93204,15529,11241,4288,3711,5743,4982,1093
93205,2113,1070,1043,444,339,640,690
93206,2300,1227,1073,915,679,490,216
93207,263,132,131,43,21,73,126
93208,104,55,49,13,12,34,45
93210,19504,12838,6666,4755,6680,5977,2092
93212,26079,19186,6893,5403,10245,8161,2270
93215,55659,33133,22526,18140,19974,12479,5066
93218,994,516,478,362,253,240,139
93219,10194,5225,4969,4419,2977,1888,910
93220,211,108,103,83,54,48,26
93221,14945,7374,7571,4867,3612,3772,2694
93222,2099,1065,1034,416,245,756,682
93223,10604,5343,5261,4294,3151,2122,1037
93224,451,226,225,113,107,139,92
93225,5077,2585,2492,1294,995,1761,1027
93226,282,135,147,49,37,92,104
93230,65264,32209,33055,22007,18063,15592,9602
93234,6987,3693,3294,2870,2223,1384,510
93235,4559,2341,2218,1736,1254,1082,487
93238,1490,738,752,223,202,455,610
93239,1688,886,802,680,495,380,133
93240,6056,2971,3085,1231,1038,1742,2045
93241,17489,9258,8231,7050,5635,3410,1394
93242,3468,1817,1651,1174,970,865,459
93243,1699,884,815,497,334,520,348
93244,534,272,262,141,95,173,125
93245,37412,19344,18068,12753,13477,7496,3686
93247,17423,8818,8605,6953,4733,3660,2077
93249,2739,1559,1180,1225,935,451,128
93250,13522,7572,5950,5199,4718,2642,963
93251,270,143,127,80,60,81,49
93252,4176,3301,875,561,1719,1441,455
93254,811,420,391,268,187,230,126
93255,614,297,317,101,68,197,248
93256,5753,2959,2794,2475,1701,1109,468
93257,75004,37366,37638,27636,20429,16796,10143
93258,2046,1044,1002,909,532,406,199
93260,200,105,95,27,18,77,78
93261,3099,1637,1462,1393,895,608,203
93262,63,41,22,1,43,14,5
93263,19582,10046,9536,7759,5780,4116,1927
93265,3699,1859,1840,738,567,1134,1260
93266,1587,804,783,588,446,356,197
93267,6237,3150,3087,2420,1650,1364,803
93268,16897,8877,8020,5631,4978,3995,2293
93270,5837,3027,2810,2178,1550,1315,794
93271,2276,1129,1147,417,300,781,778
93272,3583,1877,1706,1532,1089,686,276
93274,69721,34546,35175,25614,19552,15583,8972
93276,161,83,78,51,33,51,26
93277,50607,24308,26299,15454,13213,12552,9388
93280,27152,16585,10567,8941,9962,6103,2146
93283,2040,1002,1038,425,323,612,680
93285,2536,1266,1270,359,252,736,1189
93286,9548,4826,4722,3576,2467,2243,1262
93287,119,66,53,20,22,43,34
93291,52849,26896,25953,18784,15846,12083,6136
93292,39032,19207,19825,12864,10819,9802,5547
93301,12248,5825,6423,3659,3892,2643,2054
93304,48731,23995,24736,17796,13874,10935,6126
93305,37601,19042,18559,14523,11078,8079,3921
93306,64587,31613,32974,22402,17214,15176,9795
93307,82658,41331,41327,33824,23754,17707,7373
93308,52447,26239,26208,15518,14909,13779,8241
93309,58409,27921,30488,17788,17277,13581,9763
93311,40829,19997,20832,13364,11234,11161,5070
93312,56741,27941,28800,19273,15735,15175,6558
93313,43553,21687,21866,16076,12439,10862,4176
93314,22393,11175,11218,7243,5179,7218,2753
93401,28033,14149,13884,4937,10640,6929,5527
93402,14318,6995,7323,2894,3112,4435,3877
93405,35440,22290,13150,8932,16189,6699,3620
93410,0,0,0,0,0,0,0
93420,28413,13809,14604,6419,5345,8620,8029
93422,31375,15869,15506,7369,7627,10040,6339
93424,1261,591,670,127,180,339,615
93426,1401,770,631,274,336,422,369
93427,5505,2708,2797,1520,1247,1678,1060
93428,6314,3019,3295,994,869,1744,2707
93429,154,79,75,36,32,57,29
93430,2972,1436,1536,455,564,949,1004
93432,1384,707,677,300,262,476,346
93433,13162,6439,6723,3290,3825,3807,2240
93434,7110,3580,3530,2679,2045,1568,818
93436,54017,28423,25594,15526,14616,15139,8736
93437,3338,1807,1531,1419,1650,256,13
93440,2058,1040,1018,591,466,654,347
93441,1530,773,757,504,221,491,314
93442,10789,5270,5519,1849,2410,3070,3460
93444,19244,9518,9726,5318,4372,5445,4109
93445,7173,3632,3541,1981,2056,1904,1232
93446,43714,21423,22291,11933,10558,12421,8802
93449,7657,3700,3957,1130,1487,2350,2690
93450,740,394,346,288,220,151,81
93451,3779,1926,1853,1153,989,1074,563
93452,524,271,253,126,120,135,143
93453,2899,1487,1412,611,630,1025,633
93454,36448,18056,18392,11429,10541,8351,6127
93455,41684,20391,21293,11587,9095,11921,9081
93458,55431,28604,26827,21313,18686,10307,5125
93460,5255,2602,2653,1127,868,1788,1472
93461,1623,832,791,552,459,417,195
93463,7646,3682,3964,1730,1389,2352,2175
93465,9153,4428,4725,2574,1806,2916,1857
93501,5467,2781,2686,1746,1279,1543,899
93505,14038,8292,5746,3786,4474,4024,1754
93510,7993,4086,3907,1972,1404,3189,1428
93512,277,138,139,60,51,114,52
93513,1763,879,884,394,383,505,481
93514,13857,6918,6939,3277,2809,4222,3549
93516,2299,1186,1113,682,482,664,471
93517,670,346,324,153,124,211,182
93518,1146,576,570,214,144,384,404
93519,101,54,47,13,11,36,41
93522,48,31,17,0,3,18,27
93523,3074,1531,1543,1157,1160,512,245
93524,229,168,61,28,201,0,0
93526,719,372,347,119,133,245,222
93527,2387,1206,1181,511,371,814,691
93528,172,90,82,25,13,69,65
93529,633,344,289,128,172,201,132
93530,47,28,19,9,0,20,18
93531,509,248,261,91,64,223,131
93532,2932,1642,1290,796,602,1099,435
93534,39341,18601,20740,12441,11299,9388,6213
93535,72046,34879,37167,27014,19732,17486,7814
93536,70918,37804,33114,21360,19314,21099,9145
93541,449,228,221,113,126,152,58
93543,13033,6695,6338,4441,3113,3666,1813
93544,1259,689,570,210,194,429,426
93545,2082,1035,1047,532,440,560,550
93546,9567,5199,4368,2248,3313,2894,1112
93549,344,188,156,83,56,106,99
93550,74929,36414,38515,28831,20949,18219,6930
93551,50798,25056,25742,16006,11337,16333,7122
93552,38158,18711,19447,14788,10216,9739,3415
93553,2138,1121,1017,536,439,712,451
93554,72,30,42,4,3,33,32
93555,32560,16372,16188,9509,8229,8693,6129
93558,125,74,51,9,12,51,53
93560,18910,9491,9419,6091,5052,5395,2372
93561,34630,20193,14437,8108,9382,10372,6768
93562,1818,924,894,503,393,506,416
93563,388,263,125,62,97,158,71
93591,7285,3653,3632,2660,1719,2005,901
93592,64,35,29,14,7,22,21
93601,1909,956,953,389,304,572,644
93602,3862,1943,1919,924,688,1204,1046
93603,222,114,108,32,39,75,76
93604,674,326,348,91,99,140,344
93605,175,81,94,60,32,50,33
93606,1217,624,593,507,359,231,120
93608,1114,608,506,436,324,254,100
93609,5640,2889,2751,1988,1536,1346,770
93610,23833,8280,15553,5804,8503,6990,2536
93611,45614,22114,23500,14131,10850,13206,7427
93612,35351,16956,18395,10429,11112,8099,5711
93614,11661,5722,5939,2547,1861,3421,3832
93615,6042,3206,2836,2411,1883,1197,551
93616,2627,1340,1287,972,676,604,375
93618,28262,14523,13739,10712,8184,6077,3289
93619,28965,14230,14735,8980,6280,8800,4905
93620,9591,4841,4750,3406,2389,2346,1450
93621,464,223,241,107,107,136,114
93622,9581,4989,4592,3754,2549,2298,980
93623,69,34,35,9,9,29,22
93624,1134,605,529,502,355,233,44
93625,7313,3681,3632,2373,2015,1804,1121
93626,1359,711,648,298,208,454,399
93627,123,60,63,43,40,27,13
93628,327,159,168,122,114,72,19
93630,19162,9707,9455,7089,5533,4268,2272
93631,15941,7822,8119,5119,3935,4118,2769
93633,25,14,11,3,4,13,5
93634,33,21,12,11,5,14,3
93635,38776,19413,19363,14126,10388,9383,4879
93636,11908,5983,5925,3261,2313,3808,2526
93637,37743,18871,18872,13443,10721,8440,5139
93638,49068,25624,23444,19313,15059,9843,4853
93640,11880,6560,5320,4487,4123,2393,877
93641,595,352,243,92,136,224,143
93643,3171,1576,1595,668,535,940,1028
93644,8637,4196,4441,1729,1490,2394,3024
93645,318,156,162,67,61,90,100
93646,10557,5315,5242,4573,3084,1981,919
93647,11874,6164,5710,4625,3554,2411,1284
93648,15719,8082,7637,6323,4836,3154,1406
93650,4055,1930,2125,1444,1120,790,701
93651,1674,833,841,410,274,614,376
93652,415,232,183,164,131,73,47
93653,1229,627,602,267,173,421,368
93654,29776,15189,14587,10486,8145,6895,4250
93656,6313,3221,3092,2381,1727,1475,730
93657,34999,17474,17525,11888,9152,8391,5568
93660,4675,2378,2297,2062,1332,923,358
93662,30237,15281,14956,10569,8528,6772,4368
93664,585,307,278,108,88,175,214
93665,472,231,241,180,131,98,63
93666,692,352,340,302,184,140,66
93667,2604,1341,1263,770,478,807,549
93668,1118,583,535,401,281,247,189
93669,295,145,150,56,52,94,93
93673,713,368,345,252,203,155,103
93675,3721,1898,1823,917,618,1192,994
93701,12529,6404,6125,5280,3942,2465,842
93702,48607,24493,24114,20288,14036,9493,4790
93703,31868,15812,16056,11764,9163,6989,3952
93704,27156,13125,14031,7250,7240,7336,5330
93705,36703,17566,19137,12819,10505,8050,5329
93706,41087,21022,20065,15878,11200,8921,5088
93710,30202,14350,15852,8748,10575,5807,5072
93711,36731,17551,19180,8107,9218,9647,9759
93720,45191,21362,23829,12311,11872,12941,8067
93721,6959,4620,2339,1268,3117,1536,1038
93722,76448,37520,38928,27066,23022,18378,7982
93723,9547,4824,4723,2962,2723,2400,1462
93725,24979,12649,12330,9344,7055,5440,3140
93726,40705,19761,20944,12962,13430,8609,5704
93727,71820,35265,36555,24883,22093,15085,9759
93728,15743,7932,7811,4564,4815,4139,2225
93730,9941,4864,5077,2908,2136,3114,1783
93901,26863,13056,13807,7508,7248,7314,4793
93905,61087,31768,29319,24099,21464,11345,4179
93906,59461,29675,29786,19814,18350,14143,7154
93907,21726,10897,10829,6147,5355,6560,3664
93908,13043,6479,6564,3501,2090,4411,3041
93920,1369,732,637,242,352,457,318
93921,3281,1428,1853,359,378,948,1596
93923,12073,5521,6552,1825,1203,3295,5750
93924,6279,3088,3191,1196,895,2175,2013
93925,1671,851,820,638,487,383,163
93926,8726,4473,4253,3329,2685,1892,820
93927,17547,9165,8382,6875,5798,3539,1335
93928,506,368,138,100,229,157,20
93930,15866,8438,7428,5798,5165,3300,1603
93932,592,294,298,159,88,224,121
93933,22406,10711,11695,5963,7307,5753,3383
93940,31615,15852,15763,6059,10314,8108,7134
93943,6,3,3,0,3,2,1
93950,15046,6924,8122,2733,3273,4505,4535
93953,4509,2167,2342,874,432,1149,2054
93954,302,155,147,107,88,72,35
93955,33359,16738,16621,10679,10857,7740,4083
93960,27080,18747,8333,6715,9507,8640,2218
93962,673,326,347,189,152,220,112
94002,25992,12694,13298,5955,6599,8103,5335
94005,4282,2148,2134,877,1128,1552,725
94010,40737,19498,21239,9976,8776,13098,8887
94014,47014,23329,23685,10930,14205,13341,8538
94015,60927,29916,31011,12855,18394,17041,12637
94019,18424,9079,9345,4663,3933,6031,3797
94020,1559,822,737,250,279,698,332
94021,192,94,98,36,68,61,27
94022,18500,8937,9563,4670,2282,6075,5473
94024,22385,10940,11445,6231,2639,7782,5733
94025,40526,19730,20796,10544,10447,11694,7841
94027,7089,3472,3617,1802,946,2163,2178
94028,6534,3234,3300,1624,615,2171,2124
94030,21536,10202,11334,4813,4505,6695,5523
94037,2913,1401,1512,674,507,1084,648
94038,3040,1515,1525,766,618,1041,615
94040,32996,16752,16244,7667,11279,8889,5161
94041,13292,6853,6439,2608,5246,3693,1745
94043,28358,14373,13985,5854,10392,7889,4223
94044,37296,18231,19065,8520,9193,12479,7104
94060,1554,843,711,420,396,465,273
94061,36245,17727,18518,9351,10548,10304,6042
94062,25876,12710,13166,6116,4827,9072,5861
94063,30949,16512,14437,9141,11154,7497,3157
94065,11359,5423,5936,2766,2882,3911,1800
94066,41130,20267,20863,9580,11665,12332,7553
94070,29166,14087,15079,7247,5848,10062,6009
94074,214,121,93,41,53,73,47
94080,63975,31577,32398,15483,18230,18298,11964
94085,21247,11157,10090,5153,9025,5062,2007
94086,45697,23409,22288,10196,18296,11163,6042
94087,54293,26705,27588,14546,13837,15834,10076
94089,19245,9497,9748,3998,6414,5178,3655
94102,31176,18681,12495,3251,11791,9905,6229
94103,27170,16322,10848,2796,11193,8492,4689
94104,406,218,188,53,89,158,106
94105,5846,3287,2559,367,3313,1619,547
94107,26599,14337,12262,2904,13052,7219,3424
94108,13768,6648,7120,1296,4937,3576,3959
94109,55984,28503,27481,4347,25855,13747,12035
94110,69333,36429,32904,10757,29843,19395,9338
94111,3713,1980,1733,241,1013,1163,1296
94112,79407,39385,40022,16578,23323,23592,15914
94114,31124,18396,12728,3225,12006,11203,4690
94115,33021,15503,17518,4040,14293,7820,6868
94116,43698,21178,22520,7859,11850,13447,10542
94117,39169,19906,19263,4988,20266,9442,4473
94118,38319,18071,20248,5828,14314,10185,7992
94121,41203,19801,21402,6556,12496,12310,9841
94122,56023,27152,28871,8666,20161,15820,11376
94123,23088,10648,12440,2216,11851,5101,3920
94124,33996,16591,17405,9506,9971,9334,5185
94127,19289,9682,9607,4005,3881,6446,4957
94128,69,50,19,2,17,39,11
94129,3183,1665,1518,712,1700,651,120
94130,2880,1561,1319,819,1486,494,81
94131,26881,14061,12820,3791,8408,8805,5877
94132,28129,12994,15135,6885,9448,6477,5319
94133,26237,12907,13330,2965,8857,6938,7477
94134,40798,19930,20868,9577,11119,12069,8033
94158,4792,2623,2169,341,3035,974,442
94301,16995,8443,8552,3683,4045,4990,4277
94303,45467,22629,22838,14791,12770,11626,6280
94304,3627,1745,1882,591,1243,708,1085
94305,13862,7512,6350,3378,8859,806,819
94306,26469,12933,13536,6713,5973,8335,5448
94401,34429,17254,17175,8029,11463,9009,5928
94402,23981,11638,12343,5809,5272,7475,5425
94403,39642,19142,20500,8896,11204,11593,7949
94404,33749,16234,17515,7781,9426,9799,6743
94501,60212,28814,31398,13396,16736,18491,11589
94502,13600,6501,7099,3393,2403,4721,3083
94503,19681,9641,10040,6191,4883,5808,2799
94505,13403,6735,6668,3907,2886,4241,2369
94506,22452,10896,11556,6853,3093,8618,3888
94507,14889,7386,7503,4081,1560,5294,3954
94508,3661,1847,1814,991,1244,828,598
94509,62439,30455,31984,18692,17465,16854,9428
94510,27088,13036,14052,6988,5471,9184,5445
94511,2137,1143,994,304,294,781,758
94512,108,60,48,18,28,32,30
94513,54605,26575,28030,18379,12424,15281,8521
94514,1360,722,638,485,301,368,206
94515,7050,3551,3499,1583,1637,1904,1926
94516,211,116,95,48,45,74,44
94517,12385,6079,6306,3226,1939,4451,2769
94518,26778,13226,13552,6217,6935,8184,5442
94519,18453,9199,9254,4511,5092,5504,3346
94520,37208,19255,17953,10550,13664,8762,4232
94521,41249,19781,21468,10142,9816,13108,8183
94523,33569,16276,17293,7632,8778,10352,6807
94525,3127,1530,1597,544,758,1116,709
94526,31102,15092,16010,8439,4476,10754,7433
94528,964,472,492,244,69,342,309
94530,23877,11472,12405,4404,6174,7282,6017
94531,40290,19547,20743,13541,9964,12531,4254
94533,69277,33947,35330,20992,19966,17816,10503
94534,36416,17857,18559,10091,8512,11602,6211
94535,3793,2129,1664,1428,2058,286,21
94536,68790,34019,34771,18049,20213,19650,10878
94538,61148,30703,30445,15180,21300,16370,8298
94539,50031,24807,25224,14568,9730,17858,7875
94541,61635,30594,31041,16954,19445,16351,8885
94542,12717,6196,6521,3075,4130,3467,2045
94544,73026,36245,36781,21380,23531,18314,9801
94545,29707,14590,15117,7652,8474,8168,5413
94546,42209,20219,21990,10526,9841,13122,8720
94547,24092,11416,12676,6152,6232,7521,4187
94548,412,229,183,100,88,139,85
94549,26864,13046,13818,7019,3997,9149,6699
94550,46896,23071,23825,12881,9984,15450,8581
94551,36867,18559,18308,10352,10386,11648,4481
94552,14454,7026,7428,3868,2579,5400,2607
94553,47065,23215,23850,10808,11380,16019,8858
94555,34143,16923,17220,9986,9790,9592,4775
94556,15229,7259,7970,3986,2154,4957,4132
94558,66830,33449,33381,17022,15391,19337,15080
94559,27184,13640,13544,7132,8069,7578,4405
94560,42573,21217,21356,11882,12326,11854,6511
94561,36515,18183,18332,12196,10017,10315,3987
94563,17672,8583,9089,4791,1936,5956,4989
94564,18287,8690,9597,4268,4286,5628,4105
94565,84641,41479,43162,26584,25538,22070,10449
94566,40884,19896,20988,11671,7318,14497,7398
94567,623,302,321,152,161,186,124
94568,46016,23972,22044,11352,16113,13342,5209
94569,198,97,101,23,34,83,58
94571,7911,3841,4070,1388,1080,1991,3452
94572,8684,4239,4445,2388,2136,2581,1579
94573,94,50,44,25,17,31,21
94574,8742,4188,4554,1936,1853,2485,2468
94575,974,391,583,590,357,6,21
94576,164,70,94,27,29,63,45
94577,45560,21851,23709,11298,11844,13584,8834
94578,38558,18756,19802,10577,12043,10322,5616
94579,20571,9929,10642,5176,4857,6166,4372
94580,27152,13261,13891,7453,7160,7971,4568
94582,38537,18934,19603,13177,9854,11859,3647
94583,34859,17136,17723,9751,8289,11426,5393
94585,28263,13974,14289,8582,8206,7898,3577
94586,925,466,459,172,161,354,238
94587,69516,34318,35198,18688,19877,19415,11536
94588,30842,15271,15571,9183,6859,10545,4255
94589,29876,14542,15334,8295,7785,8194,5602
94590,35420,17214,18206,9414,10014,9968,6024
94591,53042,25772,27270,13366,13659,16144,9873
94592,742,364,378,161,273,222,86
94595,16425,6703,9722,1940,1534,3047,9904
94596,20037,9902,10135,3913,6165,5863,4096
94597,20277,9750,10527,3816,6599,5950,3912
94598,25818,12335,13483,5939,4261,8233,7385
94599,3021,1735,1286,259,394,642,1726
94601,50294,25820,24474,15131,17540,11701,5922
94602,28329,13180,15149,6240,7294,9130,5665
94603,31403,15430,15973,10758,9912,7320,3413
94605,39016,18297,20719,10150,10521,11119,7226
94606,36672,18044,18628,7977,13095,9991,5609
94607,24978,12585,12393,5238,8827,6679,4234
94608,28019,13883,14136,4798,11575,7511,4135
94609,20596,9799,10797,3351,9161,5310,2774
94610,29287,13633,15654,4590,10359,8934,5404
94611,36565,17345,19220,7201,8544,11953,8867
94612,14389,7476,6913,1689,5464,3756,3480
94613,715,74,641,274,415,22,4
94618,16046,7464,8582,3138,4407,4909,3592
94619,23299,10841,12458,5405,6019,7208,4667
94621,29870,14789,15081,10490,9643,6605,3132
94702,15979,7520,8459,2988,5135,4604,3252
94703,19846,9743,10103,3660,7561,5324,3301
94704,25592,12851,12741,6252,15774,2113,1453
94705,12762,6081,6681,2107,3814,3616,3225
94706,19615,9322,10293,5122,5646,5687,3160
94707,11710,5482,6228,2323,1796,3698,3893
94708,10985,5334,5651,1936,1911,3422,3716
94709,11806,6083,5723,2004,6211,1956,1635
94710,6948,3469,3479,1550,2330,2066,1002
94720,2964,1398,1566,1623,1293,38,10
94801,29395,14759,14636,9493,9248,7040,3614
94803,24904,12127,12777,5743,5863,8074,5224
94804,38559,18513,20046,10918,11640,10119,5882
94805,13648,6583,7065,3306,3524,4266,2552
94806,59861,29365,30496,17326,18388,15519,8628
94850,0,0,0,0,0,0,0
94901,41157,21229,19928,9226,12639,11507,7785
94903,29040,13566,15474,6106,5465,9073,8396
94904,11995,5502,6493,2710,1680,3891,3714
94920,12474,5798,6676,3040,1461,3997,3976
94922,425,215,210,90,106,121,108
94923,1411,721,690,167,203,425,616
94924,1638,878,760,260,316,555,507
94925,9253,4316,4937,2467,1468,3219,2099
94928,43170,20731,22439,11548,14405,11380,5837
94929,264,129,135,24,26,96,118
94930,8500,4144,4356,1771,1560,3264,1905
94931,8470,4056,4414,2011,2489,2636,1334
94933,865,422,443,188,125,370,182
94937,837,385,452,119,130,250,338
94938,812,399,413,161,144,290,217
94939,6859,3182,3677,1463,1192,2447,1757
94940,268,138,130,40,46,98,84
94941,30496,14417,16079,7441,4823,10713,7519
94945,17167,8447,8720,3987,3407,5693,4080
94946,699,365,334,153,122,250,174
94947,24283,11659,12624,5772,4965,7748,5798
94949,17202,8291,8911,4428,3705,5182,3887
94950,89,46,43,16,16,31,26
94951,4124,2072,2052,854,877,1443,950
94952,32858,16353,16505,7639,7775,10567,6877
94954,37365,18336,19029,10119,8861,11539,6846
94956,1756,801,955,325,310,519,602
94957,1332,639,693,408,127,453,344
94960,15740,7399,8341,4091,2354,5807,3488
94963,569,275,294,106,73,215,175
94964,5094,4970,124,113,2307,2406,268
94965,10847,5113,5734,1463,2528,3767,3089
94970,683,336,347,82,91,247,263
94971,337,156,181,56,61,126,94
94972,52,30,22,11,20,14,7
94973,1429,690,739,266,217,535,411
95002,2077,1060,1017,595,586,626,270
95003,23974,11609,12365,5178,4776,8024,5996
95004,3918,1963,1955,964,801,1404,749
95005,6311,3202,3109,1422,1336,2403,1150
95006,8979,4662,4317,1731,1909,3733,1606
95007,676,350,326,185,148,248,95
95008,45260,22235,23025,10396,13337,14195,7332
95010,9137,4319,4818,1722,2582,2721,2112
95012,10320,5264,5056,3766,3104,2354,1096
95013,80,46,34,19,24,23,14
95014,60717,30006,30711,17932,12996,19883,9906
95017,834,459,375,164,208,303,159
95018,7778,3907,3871,1639,1806,2951,1382
95019,7727,3842,3885,2801,2329,1678,919
95020,57349,28607,28742,18797,15308,15519,7725
95023,48841,24428,24413,16047,12640,13491,6663
95030,12791,6189,6602,2955,1701,4679,3456
95032,25089,12107,12982,6433,4551,8431,5674
95033,9372,4843,4529,2055,1574,3718,2025
95035,66943,34220,32723,17032,20897,19415,9599
95037,45579,22688,22891,13695,10458,14232,7194
95039,1377,708,669,374,382,411,210
95041,160,74,86,38,53,44,25
95043,639,321,318,124,130,217,168
95045,4046,2005,2041,1050,923,1290,783
95046,6417,3258,3159,1808,1508,1968,1133
95050,35923,18083,17840,7957,13419,9214,5333
95051,54327,27294,27033,13125,17871,14803,8528
95053,2206,1027,1179,1392,800,12,2
95054,23364,12068,11296,5755,10202,5030,2377
95060,46377,23805,22572,8607,17516,12543,7711
95062,36079,17816,18263,7409,11448,10840,6382
95064,7331,3409,3922,4570,2512,199,50
95065,8113,3975,4138,1830,1880,2580,1823
95066,14749,7251,7498,3983,2852,4986,2928
95070,30617,14984,15633,7806,3474,11149,8188
95073,10154,4982,5172,2218,2217,3443,2276
95075,331,177,154,94,58,128,51
95076,82474,41745,40729,27223,23754,20246,11251
95110,18730,10739,7991,4492,7899,4685,1654
95111,58466,29503,28963,18582,18007,14844,7033
95112,55927,30066,25861,13159,23324,13091,6353
95113,893,474,419,51,421,164,257
95116,51496,26326,25170,16503,17010,11641,6342
95117,30067,15205,14862,7840,10555,7760,3912
95118,31932,15675,16257,8643,8696,9400,5193
95119,9970,5024,4946,2854,2632,2999,1485
95120,37457,18609,18848,10737,5116,13399,8205
95121,37469,18692,18777,10800,10581,10611,5477
95122,56545,29089,27456,18380,18592,13076,6497
95123,62228,30603,31625,16977,18238,17975,9038
95124,47082,23336,23746,12963,10853,15226,8040
95125,51939,25128,26811,12484,13614,15797,10044
95126,31049,15733,15316,7112,12044,8059,3834
95127,61325,31309,30016,18507,18477,15807,8534
95128,34836,17398,17438,8254,11992,9433,5157
95129,38720,19031,19689,10603,9185,12631,6301
95130,13911,6935,6976,3637,3732,4418,2124
95131,28565,14352,14213,6935,9711,8067,3852
95132,40299,20147,20152,10619,10567,12073,7040
95133,25401,12512,12889,6733,7503,7028,4137
95134,15268,7940,7328,2963,8133,3149,1023
95135,20120,9630,10490,5407,3348,5842,5523
95136,42989,21069,21920,11261,14052,11423,6253
95138,18889,9223,9666,5955,4715,6209,2010
95139,6748,3394,3354,1909,1745,2072,1022
95140,191,110,81,36,28,75,52
95148,45528,22756,22772,13188,11980,13838,6522
95202,6521,3279,3242,1801,1755,1690,1275
95203,15696,8150,7546,4858,4589,4102,2147
95204,27786,13269,14517,7285,7373,7122,6006
95205,38069,19648,18421,14179,11427,8111,4352
95206,65004,32466,32538,25048,18449,14718,6789
95207,47965,22686,25279,14538,13864,10796,8767
95209,39488,19105,20383,12521,9641,10463,6863
95210,39009,18906,20103,13828,10869,8705,5607
95211,1545,694,851,1029,464,13,39
95212,25239,12493,12746,8539,6667,6407,3626
95215,23224,12143,11081,7822,5996,5718,3688
95219,27884,13417,14467,8056,7509,7680,4639
95220,7273,3693,3580,1954,1482,2200,1637
95222,5292,2583,2709,1184,965,1500,1643
95223,4612,2376,2236,785,569,1461,1797
95224,429,227,202,88,89,143,109
95225,672,340,332,163,102,234,173
95226,84,42,42,24,10,33,17
95227,941,477,464,211,155,315,260
95228,3976,2009,1967,938,680,1282,1076
95230,718,362,356,193,162,216,147
95231,4374,2720,1654,1227,1612,1026,509
95232,304,146,158,42,42,118,102
95233,436,220,216,93,75,135,133
95234,70,40,30,29,22,15,4
95236,4223,2112,2111,1295,934,1228,766
95237,3167,1644,1523,874,717,867,709
95240,47172,23396,23776,15032,12946,11395,7799
95242,25393,12279,13114,6712,5517,7230,5934
95245,2277,1149,1128,372,345,816,744
95246,1615,837,778,229,207,540,639
95247,4368,2131,2237,755,633,1291,1689
95248,301,138,163,62,46,95,98
95249,4042,2006,2036,979,770,1092,1201
95250,78,41,37,5,13,25,35
95251,767,367,400,179,144,252,192
95252,13460,6807,6653,3459,2383,4471,3147
95254,480,228,252,109,81,144,146
95255,2042,1016,1026,366,298,649,729
95257,413,202,211,69,66,134,144
95258,4018,1978,2040,1076,791,1289,862
95301,37073,19002,18071,12366,10284,8916,5507
95303,912,472,440,314,243,224,131
95304,15706,9805,5901,3842,4805,5032,2027
95305,245,124,121,45,52,99,49
95306,970,507,463,229,164,320,257
95307,42753,21163,21590,15074,11942,10476,5261
95310,1882,944,938,335,300,594,653
95311,2197,1117,1080,393,306,724,774
95312,268,134,134,86,68,61,53
95313,1386,732,654,422,357,367,240
95314,0,0,0,0,0,0,0
95315,13018,6617,6401,4989,3733,3007,1289
95316,6573,3263,3310,2003,1647,1783,1140
95317,817,435,382,301,241,184,91
95318,541,268,273,96,180,199,66
95319,1749,878,871,596,456,451,246
95320,12819,6427,6392,3830,3060,3653,2276
95321,3736,1863,1873,578,493,1010,1655
95322,8942,4585,4357,2944,2244,2241,1513
95323,1260,629,631,412,288,376,184
95324,7324,3664,3660,2181,1839,1990,1314
95325,81,43,38,16,15,25,25
95326,9581,4728,4853,3093,2419,2476,1593
95327,9806,6657,3149,1400,3332,3222,1852
95328,3993,2016,1977,1589,1158,934,312
95329,2460,1265,1195,533,368,831,728
95330,17853,8928,8925,6371,5077,4606,1799
95333,2942,1491,1451,1019,696,761,466
95334,15457,7811,7646,5618,4626,3434,1779
95335,541,289,252,89,64,188,200
95336,42675,21023,21652,13107,10755,11472,7341
95337,31557,15564,15993,10453,8645,8726,3733
95338,11062,5477,5585,2280,1752,3444,3586
95340,33931,16730,17201,10986,8682,8342,5921
95341,32967,16878,16089,13299,10162,6479,3027
95345,708,374,334,162,165,202,179
95346,1272,666,606,246,246,406,374
95348,30805,14928,15877,10641,9610,6565,3989
95350,51046,24435,26611,13523,13929,12899,10695
95351,46458,23441,23017,17160,13450,10662,5186
95354,25394,12779,12615,7541,7385,6765,3703
95355,58311,27916,30395,16971,15025,15718,10597
95356,30918,15060,15858,8678,7893,8810,5537
95357,11559,5778,5781,3564,2804,3351,1840
95358,31668,16380,15288,10896,9161,7842,3769
95360,11712,5834,5878,4132,3182,2926,1472
95361,31610,15547,16063,9129,7367,8874,6240
95363,25237,12824,12413,9146,6999,6354,2738
95364,53,27,26,16,9,13,15
95365,4985,2565,2420,1918,1456,1053,558
95366,16575,8145,8430,5160,3662,4878,2875
95367,23173,11560,11613,7869,6664,5714,2926
95368,13614,6899,6715,4824,3795,3728,1267
95369,1099,571,528,355,242,298,204
95370,26803,13084,13719,5768,5230,7805,8000
95372,1963,996,967,508,420,577,458
95374,2030,1074,956,668,557,495,310
95375,106,58,48,12,10,37,47
95376,49859,24754,25105,16577,13591,13716,5975
95377,30902,15340,15562,11673,7796,8802,2631
95379,3898,1913,1985,983,798,1231,886
95380,41201,20592,20609,13392,11895,9792,6122
95382,36176,17428,18748,10583,10222,9104,6267
95383,3937,2052,1885,750,687,1164,1336
95385,429,240,189,105,92,161,71
95386,9877,5026,4851,3476,2589,2577,1235
95387,636,331,305,252,155,156,73
95388,13074,6605,6469,5144,3563,2869,1498
95389,1272,750,522,136,535,482,119
95391,9959,4953,5006,3602,3300,2328,729
95401,36981,18394,18587,10034,11341,9818,5788
95403,45164,22483,22681,11806,12836,12675,7847
95404,39761,19264,20497,9297,10282,11582,8600
95405,21399,10067,11332,4827,5037,6338,5197
95407,39352,20247,19105,12644,12872,9954,3882
95409,27187,12624,14563,5785,4878,6965,9559
95410,950,459,491,130,179,304,337
95412,401,208,193,83,94,118,106
95415,1592,854,738,457,417,395,323
95417,297,154,143,59,63,95,80
95420,374,176,198,42,76,115,141
95421,1592,841,751,251,280,577,484
95422,15585,7794,7791,4159,3568,4441,3417
95423,3747,1893,1854,597,536,1148,1466
95425,10841,5456,5385,2661,2495,3137,2548
95426,2147,1099,1048,417,363,836,531
95427,459,246,213,92,82,161,124
95428,2516,1277,1239,723,621,622,550
95429,70,39,31,5,12,27,26
95430,44,18,26,6,3,19,16
95431,631,367,264,0,94,401,136
95432,426,219,207,79,85,133,129
95435,82,37,45,35,18,17,12
95436,5418,2769,2649,1033,1108,1985,1292
95437,14799,7396,7403,3247,3410,4332,3810
95439,675,339,336,164,147,213,151
95441,2014,1100,914,464,481,643,426
95442,3178,1583,1595,556,624,1140,858
95443,233,123,110,22,31,90,90
95444,748,355,393,188,156,259,145
95445,2093,1049,1044,362,379,653,699
95446,4750,2588,2162,737,1002,1793,1218
95448,16852,8462,8390,3961,3713,5010,4168
95449,1507,821,686,388,381,478,260
95450,387,209,178,59,49,136,143
95451,11213,5602,5611,2732,2303,3277,2901
95452,1393,691,702,239,164,471,519
95453,11256,5637,5619,2615,2294,3242,3105
95454,2556,1362,1194,557,548,877,574
95456,795,356,439,77,108,221,389
95457,2893,1506,1387,537,544,963,849
95458,3104,1557,1547,630,618,927,929
95459,504,259,245,98,111,145,150
95460,2285,1098,1187,324,354,666,941
95461,3413,1774,1639,786,667,1182,778
95462,1417,753,664,173,240,610,394
95463,169,88,81,24,35,49,61
95464,2673,1326,1347,611,543,841,678
95465,2083,1064,1019,312,456,722,593
95466,946,497,449,264,176,288,218
95467,5498,2709,2789,1487,1143,1711,1157
95468,1258,641,617,299,252,380,327
95469,1767,918,849,408,364,547,448
95470,6032,3063,2969,1515,1366,1881,1270
95471,522,279,243,82,124,209,107
95472,28255,13626,14629,5745,5076,9613,7821
95476,35394,17027,18367,8147,7451,10059,9737
95482,31808,15667,16141,8911,8185,8330,6382
95485,2557,1269,1288,609,556,798,594
95486,62,25,37,2,8,29,23
95488,280,149,131,45,57,95,83
95490,13264,6620,6644,3288,3152,3814,3010
95492,28532,14084,14448,8774,6600,8703,4455
95493,198,107,91,38,24,63,73
95494,139,71,68,23,32,49,35
95497,1305,624,681,114,67,311,813
95501,23976,12335,11641,5346,8014,6448,4168
95503,24152,11876,12276,5672,5945,6783,5752
95511,360,195,165,69,91,138,62
95514,254,142,112,54,62,76,62
95519,17432,8575,8857,4285,4980,4871,3296
95521,20199,10105,10094,4609,8916,3912,2762
95524,1787,888,899,360,376,578,473
95525,1733,869,864,358,478,537,360
95526,378,213,165,59,95,135,89
95527,627,345,282,96,113,216,202
95528,1139,584,555,273,235,375,256
95531,24528,13793,10735,5885,7022,7067,4554
95536,2849,1397,1452,656,584,842,767
95537,276,158,118,52,98,70,56
95540,13657,6640,7017,3718,3331,3470,3138
95542,2533,1379,1154,458,705,808,562
95543,765,406,359,150,107,272,236
95545,153,85,68,34,30,52,37
95546,3494,1729,1765,1339,924,796,435
95547,1222,619,603,287,248,409,278
95548,1373,749,624,316,330,422,305
95549,805,426,379,161,179,276,189
95550,128,64,64,41,33,36,18
95551,1739,860,879,447,453,518,321
95552,697,366,331,126,116,255,200
95553,1062,551,511,209,233,351,269
95554,533,277,256,100,110,202,121
95555,410,219,191,73,87,147,103
95556,605,322,283,142,155,170,138
95558,425,234,191,68,116,112,129
95559,182,90,92,26,44,70,42
95560,1648,868,780,350,443,539,316
95562,3450,1697,1753,908,877,987,678
95563,652,340,312,131,115,232,174
95564,462,252,210,103,183,123,53
95565,1071,559,512,388,306,285,92
95567,1930,951,979,503,356,552,519
95568,136,68,68,35,19,48,34
95569,361,213,148,59,102,127,73
95570,2579,1318,1261,486,578,765,750
95571,271,138,133,59,63,100,49
95573,1744,878,866,311,368,565,500
95585,508,267,241,117,140,151,100
95587,201,109,92,35,41,58,67
95589,1612,873,739,284,431,511,386
95595,262,134,128,56,54,96,56
95601,198,98,100,30,46,64,58
95602,17509,8502,9007,4036,2953,5214,5306
95603,27844,13482,14362,6129,5707,8591,7417
95604,75,44,31,8,20,23,24
95605,14179,7115,7064,4294,4126,3506,2253
95606,196,103,93,55,38,69,34
95607,431,223,208,87,65,163,116
95608,59418,28017,31401,13661,13120,17564,15073
95610,44147,21584,22563,11490,13271,11699,7687
95612,1239,631,608,328,242,368,301
95614,3833,1856,1977,886,556,1381,1010
95615,834,442,392,234,202,229,169
95616,47032,21934,25098,12141,21540,7547,5804
95618,27281,13274,14007,7206,9882,6828,3365
95619,4842,2276,2566,1196,1077,1352,1217
95620,20553,10233,10320,6534,5502,5728,2789
95621,39819,19125,20694,10212,11015,10542,8050
95623,3806,1890,1916,818,639,1306,1043
95624,61989,30318,31671,20122,14760,18296,8811
95625,155,86,69,32,40,59,24
95626,5975,2994,2981,1656,1401,1888,1030
95627,3513,1758,1755,1078,952,921,562
95628,40196,19572,20624,9138,8536,12319,10203
95629,832,410,422,151,107,289,285
95630,72180,38466,33714,18982,20488,22588,10122
95631,6076,3040,3036,1356,984,2188,1548
95632,29269,14550,14719,9679,7219,7929,4442
95633,3349,1705,1644,704,585,1163,897
95634,3232,1691,1541,669,605,1068,890
95635,1262,670,592,285,245,445,287
95636,1101,573,528,264,194,377,266
95637,370,185,185,62,60,124,124
95638,2255,1164,1091,658,403,752,442
95639,283,141,142,72,54,92,65
95640,11353,7740,3613,2131,3089,4129,2004
95641,1986,1055,931,394,334,606,652
95642,7164,3330,3834,1467,1334,1992,2371
95645,2037,1082,955,609,529,584,315
95646,158,95,63,28,42,56,32
95648,47354,22904,24450,12211,10715,10043,14385
95650,12447,6215,6232,3263,2130,4239,2815
95651,637,336,301,125,134,232,146
95652,739,341,398,298,293,116,32
95653,527,280,247,187,146,130,64
95655,4314,2183,2131,1512,1373,1088,341
95658,6285,3142,3143,1453,896,2187,1749
95659,702,372,330,163,134,215,190
95660,30714,15149,15565,9900,8469,7643,4702
95661,29791,14092,15699,7745,7017,8717,6312
95662,31558,15585,15973,8007,7445,9870,6236
95663,2377,1170,1207,574,367,848,588
95664,1380,715,665,316,204,524,336
95665,4426,2242,2184,903,682,1361,1480
95666,5336,2695,2641,889,712,1684,2051
95667,36726,17909,18817,8147,6758,11623,10198
95668,815,440,375,218,172,248,177
95669,2443,1184,1259,548,434,750,711
95670,52973,25694,27279,14661,14620,14296,9396
95672,4773,2413,2360,1283,741,1707,1042
95673,15455,7781,7674,4677,3846,4464,2468
95674,935,479,456,240,197,308,190
95675,381,174,207,93,69,148,71
95677,23333,11364,11969,6229,5700,6917,4487
95678,41192,20063,21129,11711,12735,10943,5803
95679,55,28,27,8,12,23,12
95680,146,77,69,54,38,30,24
95681,1226,617,609,347,259,402,218
95682,29114,14249,14865,7746,5613,9470,6285
95683,6180,3047,3133,1439,850,1865,2026
95684,3422,1743,1679,636,496,1318,972
95685,4680,2236,2444,914,734,1371,1661
95686,1405,699,706,489,318,369,229
95687,65096,35533,29563,16066,18571,20293,10166
95688,34379,16980,17399,9573,8604,10206,5996
95689,1244,617,627,135,115,451,543
95690,2533,1353,1180,703,595,699,536
95691,34737,17068,17669,10033,10937,9017,4750
95692,4769,2324,2445,1478,1186,1347,758
95693,6758,3371,3387,1776,1168,2276,1538
95694,9156,4650,4506,2631,2194,2885,1446
95695,37946,18579,19367,10489,9826,10359,7272
95697,425,202,223,141,92,134,58
95698,236,120,116,54,46,79,57
95699,154,81,73,32,24,47,51
95701,983,524,459,208,144,405,226
95703,897,473,424,205,155,301,236
95709,4772,2394,2378,1080,822,1505,1365
95713,9495,4778,4717,2259,1732,3254,2250
95714,382,209,173,69,44,142,127
95715,115,65,50,22,23,56,14
95717,231,120,111,32,28,91,80
95720,157,77,80,24,22,63,48
95721,37,22,15,1,7,15,14
95722,4585,2304,2281,995,615,1675,1300
95724,27,22,5,4,16,5,2
95726,8842,4473,4369,1999,1695,2973,2175
95728,386,231,155,48,94,152,92
95735,68,40,28,10,10,25,23
95736,240,129,111,61,90,65,24
95742,7749,3903,3846,2451,3036,1654,608
95746,21460,10625,10835,6287,2636,8126,4411
95747,51870,24765,27105,15705,12123,13918,10124
95757,40222,20292,19930,14063,11942,10349,3868
95758,60435,28882,31553,19197,15792,17971,7475
95762,38797,19120,19677,12481,6638,13434,6244
95765,33974,16403,17571,11303,8268,10002,4401
95776,21902,10995,10907,7454,6590,5626,2232
95811,7595,4265,3330,857,3532,2386,820
95814,9922,6209,3713,695,4733,2570,1924
95815,24680,12454,12226,7559,7624,6332,3165
95816,15579,7617,7962,1624,7444,4039,2472
95817,13534,6326,7208,3203,4907,3365,2059
95818,19811,9274,10537,4257,5681,6007,3866
95819,17141,7978,9163,4090,4629,4837,3585
95820,34480,16751,17729,10475,10013,8920,5072
95821,33550,15986,17564,8070,8847,9589,7044
95822,42347,20298,22049,11986,10576,10841,8944
95823,73985,35609,38376,25933,21645,16980,9427
95824,30221,15263,14958,10502,9080,6922,3717
95825,31084,14675,16409,6495,11893,6836,5860
95826,36628,17816,18812,8722,12670,8841,6395
95827,20269,10031,10238,5691,5807,5542,3229
95828,57862,28518,29344,18728,15970,14386,8778
95829,24755,12174,12581,8311,6302,7349,2793
95830,934,491,443,252,181,307,194
95831,41321,19420,21901,8876,9621,12331,10493
95832,11924,5763,6161,4757,3573,2356,1238
95833,37293,18190,19103,10778,13120,9448,3947
95834,25899,12538,13361,8074,9830,5698,2297
95835,35936,17389,18547,10804,12558,8485,4089
95837,315,160,155,58,42,116,99
95838,36764,18185,18579,13339,10718,8666,4041
95841,19448,9347,10101,5260,6173,4822,3193
95842,31806,15457,16349,9925,10007,7995,3879
95843,45048,21869,23179,15597,12481,12475,4495
95864,22447,10613,11834,5297,4256,6809,6085
95901,31314,15660,15654,9719,8742,7974,4879
95903,1732,988,744,660,952,113,7
95910,86,48,38,14,8,41,23
95912,4685,2413,2272,1605,1233,1188,659
95914,578,290,288,125,90,203,160
95915,44,26,18,4,4,26,10
95916,1441,767,674,213,193,554,481
95917,3155,1576,1579,964,728,903,560
95918,2339,1191,1148,530,372,791,646
95919,1378,692,686,297,232,414,435
95920,274,155,119,86,63,79,46
95922,687,372,315,121,130,230,206
95923,58,37,21,14,6,21,17
95925,295,154,141,87,55,98,55
95926,37725,18823,18902,10005,14458,7538,5724
95928,36511,18308,18203,8850,13755,8064,5842
95930,69,37,32,9,16,17,27
95932,7718,3879,3839,2405,1890,1989,1434
95934,274,138,136,54,46,88,86
95935,631,344,287,141,109,212,169
95936,352,186,166,48,46,110,148
95937,1491,713,778,407,292,386,406
95938,3787,1891,1896,1018,753,1235,781
95939,604,356,248,120,170,185,129
95941,563,293,270,84,79,196,204
95942,1301,657,644,237,195,503,366
95943,879,463,416,269,201,230,179
95944,46,27,19,3,6,22,15
95945,25199,11806,13393,5449,5127,7169,7454
95946,9790,4772,5018,1976,1376,2710,3728
95947,1899,943,956,448,323,588,540
95948,10810,5361,5449,3343,2710,2601,2156
95949,19741,9774,9967,4061,3032,6294,6354
95950,569,296,273,186,146,146,91
95951,2601,1330,1271,902,792,586,321
95953,10718,5159,5559,3389,2826,2721,1782
95954,12251,6094,6157,2630,2214,3492,3915
95955,1517,796,721,487,331,413,286
95956,401,206,195,63,62,152,124
95957,761,398,363,189,148,249,175
95959,17838,9051,8787,3423,3143,5874,5398
95960,796,422,374,145,160,291,200
95961,26510,13356,13154,9549,8005,6051,2905
95962,1567,799,768,310,255,590,412
95963,15493,7740,7753,4797,3643,4139,2914
95965,20384,10303,10081,6054,5245,5323,3762
95966,30643,15085,15558,7797,6394,8241,8211
95968,1412,719,693,425,357,368,262
95969,27549,13122,14427,5339,4942,8082,9186
95970,530,277,253,134,102,169,125
95971,5970,2949,3021,1371,1245,1823,1531
95973,31957,15688,16269,8484,8849,8759,5865
95974,8,4,4,2,4,0,2
95975,1769,890,879,331,309,605,524
95977,1678,839,839,426,351,553,348
95978,143,72,71,42,34,31,36
95979,597,329,268,138,51,198,210
95981,97,48,49,24,12,29,32
95982,3221,1654,1567,949,655,1048,569
95983,428,217,211,70,63,156,139
95984,120,60,60,11,10,50,49
95986,162,96,66,26,26,66,44
95987,5992,3130,2862,2129,1688,1378,797
95988,8857,4443,4414,2683,2168,2314,1692
95991,40593,20052,20541,13020,11677,9470,6426
95993,36067,17959,18108,10538,8799,9717,7013
96001,33865,16735,17130,8450,7641,10019,7755
96002,33298,16228,17070,9194,8377,8421,7306
96003,44461,21557,22904,10817,11052,12022,10570
96006,557,272,285,125,107,152,173
96007,22841,11196,11645,6027,5224,6506,5084
96008,1231,622,609,298,208,451,274
96009,569,295,274,139,112,183,135
96010,239,133,106,46,38,87,68
96011,218,118,100,48,37,75,58
96013,4212,2064,2148,1067,843,1215,1087
96014,211,112,99,35,38,67,71
96015,465,223,242,126,98,113,128
96016,366,191,175,61,57,75,173
96017,171,102,69,36,30,48,57
96019,10082,5029,5053,2723,2485,2833,2041
96020,2416,1223,1193,533,430,749,704
96021,16097,8012,8085,5125,3752,4125,3095
96022,15768,7830,7938,4247,3193,4789,3539
96023,1240,636,604,316,268,340,316
96024,1145,591,554,230,189,397,329
96025,2310,1188,1122,491,442,718,659
96027,2227,1144,1083,511,339,694,683
96028,1464,744,720,358,240,381,485
96029,124,61,63,20,25,44,35
96031,158,92,66,20,31,53,54
96032,2407,1250,1157,542,490,710,665
96033,432,224,208,84,60,158,130
96034,294,156,138,60,43,95,96
96035,3324,1701,1623,1007,750,933,634
96037,308,152,156,50,51,113,94
96038,589,301,288,135,106,164,184
96039,1251,642,609,277,238,395,341
96040,341,171,170,72,70,85,114
96041,2747,1430,1317,562,536,893,756
96044,1022,515,507,185,155,320,362
96046,304,173,131,39,76,99,90
96047,1004,511,493,203,169,357,275
96048,736,374,362,126,120,244,246
96049,95,50,45,16,18,29,32
96050,414,214,200,55,54,145,160
96051,1139,594,545,131,124,437,447
96052,1460,796,664,227,273,469,491
96054,366,181,185,81,47,127,111
96055,3935,1942,1993,992,750,1146,1047
96056,1642,845,797,355,262,526,499
96057,1355,681,674,242,203,408,502
96058,798,431,367,223,159,251,165
96059,688,352,336,116,108,205,259
96061,36,20,16,2,0,10,24
96062,1105,535,570,275,198,346,286
96063,125,64,61,19,20,42,44
96064,4574,2288,2286,1045,874,1370,1285
96065,357,196,161,81,53,112,111
96067,7165,3420,3745,1454,1238,2276,2197
96068,183,142,41,26,74,56,27
96069,982,512,470,200,148,347,287
96071,125,63,62,5,11,32,77
96073,4082,2035,2047,963,517,1366,1236
96074,260,181,79,31,97,77,55
96075,369,226,143,57,85,136,91
96076,166,88,78,20,14,76,56
96080,28764,14102,14662,7891,6664,7616,6593
96084,625,315,310,110,93,228,194
96085,85,44,41,21,15,27,22
96086,338,168,170,56,58,119,105
96087,600,296,304,114,106,219,161
96088,4506,2306,2200,738,601,1515,1652
96090,421,212,209,104,89,122,106
96091,699,363,336,87,75,232,305
96092,496,269,227,126,116,151,103
96093,4133,2025,2108,1058,762,1191,1122
96094,6630,3376,3254,1656,1400,1885,1689
96096,695,350,345,131,80,268,216
96097,10031,4826,5205,2493,2015,2800,2723
96101,5490,2777,2713,1338,1076,1620,1456
96103,1725,848,877,206,160,550,809
96104,748,368,380,151,132,215,250
96105,527,285,242,119,99,184,125
96106,479,238,241,30,31,150,268
96107,1269,628,641,330,341,308,290
96108,122,64,58,17,19,33,53
96109,2197,1664,533,241,1030,648,278
96110,166,87,79,31,27,53,55
96111,160,83,77,18,36,61,45
96112,214,98,116,55,49,54,56
96113,1000,497,503,270,246,281,203
96114,3220,1639,1581,887,575,1103,655
96115,145,72,73,16,14,47,68
96116,233,129,104,55,52,53,73
96117,405,199,206,106,71,143,85
96118,1627,807,820,395,285,497,450
96119,90,52,38,16,14,31,29
96120,957,481,476,240,153,339,225
96121,368,200,168,78,68,112,110
96122,3883,1918,1965,938,802,1201,942
96123,48,25,23,9,11,15,13
96124,326,157,169,63,47,115,101
96125,258,134,124,23,39,96,100
96126,215,115,100,27,36,93,59
96128,752,410,342,208,182,233,129
96129,261,146,115,70,48,99,44
96130,23150,15788,7362,4503,9034,6688,2925
96132,119,61,58,19,16,33,51
96133,110,55,55,25,25,22,38
96134,2512,1283,1229,820,583,645,464
96135,128,68,60,32,23,41,32
96136,104,56,48,23,21,35,25
96137,3297,1681,1616,698,542,993,1064
96140,1170,633,537,188,301,390,291
96141,744,401,343,126,144,282,192
96142,1037,574,463,194,272,373,198
96143,4414,2433,1981,1101,1626,1207,480
96145,3161,1689,1472,469,954,1045,693
96146,1366,802,564,274,415,399,278
96148,788,425,363,194,212,246,136
96150,29792,15802,13990,6776,8904,9313,4799
96155,8,5,3,2,1,2,3
96161,18451,9669,8782,4540,5219,6040,2652
97635,165,89,76,17,16,53,79
80002,18020,8886,9134,4500,5445,5238,2837
80003,35384,17575,17809,9432,10096,9958,5898
80004,35892,17321,18571,8945,8085,10553,8309
80005,25553,12388,13165,6504,5121,8557,5371
80007,7262,3583,3679,2117,1019,2798,1328
80010,39728,21035,18693,13388,13122,9092,4126
80011,47461,23857,23604,15516,14706,11249,5990
80012,46665,23038,23627,13601,14696,11433,6935
80013,69588,34426,35162,21351,20781,20000,7456
80014,36710,16961,19749,7661,10466,9295,9288
80015,62432,30728,31704,20435,15916,20094,5987
80016,41219,20190,21029,13088,9957,12730,5444
80017,34270,16827,17443,10513,11810,8674,3273
80018,9206,4605,4601,3011,3077,2396,722
80019,1690,840,850,500,599,466,125
80020,46871,23370,23501,13373,12364,14477,6657
80021,30051,15019,15032,7466,10112,8908,3565
80022,42699,21689,21010,14843,13185,9972,4699
80023,15415,7529,7886,4675,3338,4836,2566
80024,228,119,109,65,64,69,30
80025,253,133,120,41,64,105,43
80026,26378,12944,13434,7173,6752,8654,3799
80027,31034,15408,15626,9053,7729,10677,3575
80030,15329,7622,7707,4163,4574,3867,2725
80031,33932,16765,17167,8639,9746,9577,5970
80033,23969,11577,12392,4914,5762,7210,6083
80045,277,140,137,18,202,45,12
80101,392,196,196,82,60,142,108
80102,5514,2814,2700,1677,1052,1970,815
80103,2458,1246,1212,731,490,834,403
80104,27588,13562,14026,8907,7152,8099,3430
80105,1171,612,559,310,221,394,246
80106,4232,2126,2106,1166,612,1673,781
80107,12042,5979,6063,3440,1995,4801,1806
80108,22612,11313,11299,7318,4217,7606,3471
80109,17219,8610,8609,6242,4441,4926,1610
80110,20867,10723,10144,5163,6793,5741,3170
80111,28948,14256,14692,7876,6773,9433,4866
80112,29217,14649,14568,7322,9174,8351,4370
80113,20562,10082,10480,4398,5765,6288,4111
80116,3942,1975,1967,896,457,1562,1027
80117,2587,1295,1292,690,418,1006,473
80118,5308,2703,2605,1190,569,2308,1241
80120,28435,13710,14725,6435,6995,8521,6484
80121,17853,8719,9134,4372,3132,5566,4783
80122,29783,14264,15519,7519,5737,9737,6790
80123,44795,22209,22586,10581,11702,13675,8837
80124,18020,9061,8959,5189,4761,5884,2186
80125,10190,5205,4985,3138,2519,3367,1166
80126,39698,19484,20214,13484,8679,13398,4137
80127,42597,21088,21509,12329,8571,15800,5897
80128,34988,17226,17762,9184,8528,11531,5745
80129,27007,13255,13752,9192,6211,8708,2896
80130,27054,13255,13799,8879,7160,8083,2932
80131,243,132,111,60,48,83,52
80132,19637,9888,9749,6112,2913,7225,3387
80133,2042,1022,1020,572,445,717,308
80134,55075,27195,27880,18289,14557,16789,5440
80135,3833,1960,1873,789,496,1529,1019
80136,4834,2462,2372,1496,1030,1597,711
80137,1323,812,511,522,161,442,198
80138,29786,14691,15095,9589,6230,10210,3757
80202,10148,5614,4534,747,5621,2271,1509
80203,18839,10601,8238,798,12003,3949,2089
80204,31493,15885,15608,9826,11536,6515,3616
80205,29221,15616,13605,6610,12114,7102,3395
80206,21521,10671,10850,2629,8947,5863,4082
80207,21216,10106,11110,5760,6044,5632,3780
80209,21526,10533,10993,2752,8700,5780,4294
80210,33946,16793,17153,6875,13757,8140,5174
80211,31583,15946,15637,6511,12852,7682,4538
80212,18051,8570,9481,3423,6323,4984,3321
80214,24821,12382,12439,6069,7730,6889,4133
80215,17843,8656,9187,3894,4029,5444,4476
80216,10924,5722,5202,3959,3597,2317,1051
80218,17928,9242,8686,1544,9270,4386,2728
80219,61296,31108,30188,20917,18513,14005,7861
80220,33529,16504,17025,8014,10814,9651,5050
80221,37779,19312,18467,11402,11575,9214,5588
80222,20073,9883,10190,3844,6516,5561,4152
80223,17987,9244,8743,5318,6105,4322,2242
80224,17256,8175,9081,3561,4723,4458,4514
80226,30930,15083,15847,7473,9466,7959,6032
80227,33667,16234,17433,8079,9405,9419,6764
80228,30138,14995,15143,6960,8035,9503,5640
80229,49598,24867,24731,16295,16641,11495,5167
80230,7559,3456,4103,1985,2717,1885,972
80231,32127,15287,16840,6753,11815,8044,5515
80232,21411,10454,10957,5136,5555,5956,4764
80233,45386,22516,22870,12946,14628,11782,6030
80234,25937,12885,13052,7073,8177,7076,3611
80235,7571,3671,3900,1875,2338,2020,1338
80236,16123,7986,8137,4443,4674,4137,2869
80237,17569,8541,9028,3293,5837,4487,3952
80238,10058,4876,5182,3471,3710,2380,497
80239,40512,20677,19835,14671,13791,8793,3257
80241,31746,15607,16139,9857,8966,9486,3437
80246,12875,6594,6281,2410,5818,2902,1745
80247,25449,11413,14036,4981,9536,5438,5494
80249,23404,11184,12220,8639,7651,5630,1484
80260,31412,15520,15892,9860,9929,7261,4362
80264,0,0,0,0,0,0,0
80290,0,0,0,0,0,0,0
80293,0,0,0,0,0,0,0
80294,0,0,0,0,0,0,0
80301,22555,11287,11268,4614,7268,6844,3829
80302,26941,14181,12760,4481,14001,5011,3448
80303,22361,11713,10648,3807,9250,4971,4333
80304,25623,12649,12974,5749,7669,7989,4216
80305,16874,8797,8077,3289,6294,4644,2647
80310,6578,3299,3279,4939,1633,4,2
80401,39378,21045,18333,9110,10404,12149,7715
80403,18211,9390,8821,4358,3844,6692,3317
80419,0,0,0,0,0,0,0
80420,933,539,394,193,289,365,86
80421,8042,4135,3907,1921,1478,3210,1433
80422,4326,2291,2035,853,962,1780,731
80423,169,98,71,30,33,73,33
80424,9627,5358,4269,1631,4044,2807,1145
80425,184,95,89,25,21,71,67
80426,104,58,46,22,28,40,14
80427,822,437,385,135,169,331,187
80428,706,369,337,158,124,291,133
80432,439,244,195,61,44,203,131
80433,8354,4312,4042,1917,1238,3700,1499
80434,43,23,20,2,5,17,19
80435,7278,3997,3281,1572,2776,2127,803
80436,565,283,282,132,127,177,129
80438,486,264,222,85,108,197,96
80439,23778,11767,12011,5890,3292,9207,5389
80440,2422,1341,1081,539,579,918,386
80442,2309,1284,1025,457,854,698,300
80443,3676,2049,1627,549,1268,1163,696
80444,1080,568,512,168,291,385,236
80446,3715,1918,1797,928,858,1349,580
80447,1964,1040,924,310,283,776,595
80448,193,98,95,42,32,78,41
80449,909,481,428,154,130,380,245
80451,753,383,370,208,199,259,87
80452,3097,1634,1463,575,642,1228,652
80453,197,106,91,18,50,79,50
80454,1224,610,614,231,195,551,247
80455,497,266,231,72,109,213,103
80456,620,329,291,61,63,285,211
80457,612,302,310,169,144,238,61
80459,2450,1273,1177,704,605,803,338
80461,7090,3795,3295,1981,2190,1959,960
80463,136,67,69,25,22,51,38
80465,15147,7659,7488,3824,3216,5385,2722
80466,3338,1765,1573,666,864,1328,480
80467,2224,1177,1047,536,652,730,306
80468,391,226,165,82,115,133,61
80469,337,175,162,83,80,121,53
80470,3287,1678,1609,679,475,1453,680
80471,23,12,11,2,5,8,8
80473,51,27,24,3,4,11,33
80475,57,28,29,10,4,28,15
80476,194,110,84,32,54,75,33
80477,155,81,74,23,73,38,21
80478,1606,867,739,335,394,557,320
80479,48,26,22,3,14,21,10
80480,1300,686,614,285,267,447,301
80481,572,327,245,108,124,247,93
80482,1630,925,705,282,503,564,281
80483,585,310,275,158,122,193,112
80487,16745,8930,7815,3767,4936,5599,2443
80488,157,102,55,26,100,29,2
80497,411,230,181,99,171,114,27
80498,7002,3744,3258,1487,2152,2270,1093
80501,39521,19436,20085,10759,11324,10734,6704
80503,31064,15233,15831,8341,6143,10675,5905
80504,46876,23444,23432,14724,12076,13758,6318
80510,420,212,208,47,64,151,158
80511,76,29,47,11,56,4,5
80512,2185,1107,1078,396,368,828,593
80513,10296,5094,5202,2652,1750,3868,2026
80514,4106,2025,2081,1274,1133,1114,585
80515,1010,517,493,197,183,341,289
80516,20254,10086,10168,6432,5065,6458,2299
80517,9313,4467,4846,1628,1536,2740,3409
80520,1498,715,783,448,387,435,228
80521,33409,16890,16519,9444,16252,4906,2807
80524,31668,16008,15660,7471,9968,8212,6017
80525,48419,23879,24540,11348,15795,12919,8357
80526,44183,22124,22059,10720,16414,11291,5758
80528,17946,8961,8985,6092,4498,5339,2017
80530,3790,1915,1875,1193,1103,1015,479
80532,165,88,77,17,17,59,72
80534,11301,5744,5557,3598,3059,2978,1666
80535,2636,1338,1298,579,645,893,519
80536,1759,891,868,265,230,683,581
80537,38821,19116,19705,9884,9303,11635,7999
80538,43930,21128,22802,11281,10350,12728,9571
80540,4461,2245,2216,928,772,1745,1016
80542,3631,1824,1807,1151,801,1229,450
80543,5887,2933,2954,2020,1810,1423,634
80544,111,50,61,21,19,40,31
80545,851,438,413,81,89,291,390
80546,149,88,61,35,42,48,24
80547,624,313,311,212,149,181,82
80549,8642,4386,4256,2708,2702,2280,952
80550,20675,10349,10326,6373,4974,6334,2994
80601,33833,17141,16692,10943,10028,8413,4449
80602,27665,13713,13952,9408,8214,7535,2508
80603,11973,6149,5824,3690,3422,3310,1551
80610,2791,1406,1385,849,680,804,458
80611,659,337,322,200,122,219,118
80612,430,207,223,96,89,162,83
80615,7482,3712,3770,2294,1636,2175,1377
80620,17775,8829,8946,6139,6242,3737,1657
80621,12079,6070,6009,3776,2920,3595,1788
80622,268,136,132,81,43,110,34
80623,1028,537,491,340,268,286,134
80624,946,488,458,295,220,293,138
80631,48603,24438,24165,16622,16977,9384,5620
80634,52861,25569,27292,14794,14118,13971,9978
80640,11054,5580,5474,3957,3713,2550,834
80642,4309,2644,1665,1048,1141,1577,543
80643,3011,1523,1488,900,598,1012,501
80644,2989,1498,1491,973,649,936,431
80645,3905,1953,1952,1183,882,1140,700
80648,1001,506,495,266,217,355,163
80649,299,162,137,76,63,106,54
80650,1432,720,712,417,312,453,250
80651,4176,2127,2049,1271,997,1251,657
80652,574,300,274,184,116,166,108
80653,791,409,382,204,134,276,177
80654,2359,1210,1149,739,507,729,384
80701,16042,8023,8019,5106,4130,4091,2715
80705,884,457,427,294,223,212,155
80720,2558,1299,1259,608,536,745,669
80721,154,76,78,49,36,39,30
80722,349,186,163,86,44,132,87
80723,7179,3336,3843,2011,1656,1819,1693
80726,381,213,168,68,63,144,106
80727,425,209,216,116,86,131,92
80728,878,458,420,238,159,279,202
80729,540,281,259,120,106,152,162
80731,1494,737,757,385,244,425,440
80733,529,270,259,152,94,186,97
80734,3045,1497,1548,842,625,826,752
80735,405,211,194,126,97,100,82
80736,648,334,314,177,136,189,146
80737,1537,731,806,333,292,420,492
80740,108,60,48,21,19,37,31
80741,935,462,473,259,196,290,190
80742,225,115,110,48,37,65,75
80743,1074,546,528,274,197,321,282
80744,488,254,234,107,89,146,146
80745,156,91,65,34,26,55,41
80746,29,11,18,6,4,9,10
80747,462,235,227,121,84,163,94
80749,341,181,160,68,51,114,108
80750,412,208,204,110,92,126,84
80751,18857,10918,7939,4426,5711,5080,3640
80754,164,86,78,48,16,58,42
80755,163,84,79,48,35,49,31
80757,255,125,130,88,30,88,49
80758,3791,1857,1934,1054,893,990,854
80759,4698,2325,2373,1417,1120,1165,996
80801,154,80,74,36,31,54,33
80802,238,121,117,73,55,69,41
80804,327,170,157,77,53,103,94
80805,453,236,217,144,97,115,97
80807,5304,3110,2194,1203,1560,1515,1026
80808,6351,3220,3131,1927,1280,2073,1071
80809,1519,750,769,311,250,595,363
80810,1127,547,580,289,229,331,278
80812,275,146,129,82,51,84,58
80813,2055,1113,942,420,385,755,495
80814,4023,2075,1948,900,685,1606,832
80815,911,476,435,215,164,270,262
80816,5180,2657,2523,948,767,2065,1400
80817,27311,13458,13853,9860,8826,6342,2283
80818,343,175,168,95,60,100,88
80819,921,459,462,234,143,348,196
80820,806,392,414,115,86,331,274
80821,1093,525,568,248,204,305,336
80822,260,141,119,63,49,85,63
80823,203,100,103,52,32,61,58
80824,207,106,101,40,34,76,57
80825,422,220,202,119,83,119,101
80827,549,289,260,84,63,208,194
80828,3341,2107,1234,687,1068,1018,568
80829,5476,2703,2773,1020,1250,1986,1220
80830,254,137,117,54,41,68,91
80831,21993,11145,10848,7526,4925,7047,2495
80832,666,335,331,169,111,232,154
80833,754,406,348,206,131,237,180
80834,318,162,156,71,35,130,82
80835,911,462,449,272,194,265,180
80836,1157,588,569,360,254,294,249
80840,6682,4751,1931,2437,3935,278,32
80860,594,314,280,96,111,253,134
80861,255,133,122,54,51,80,70
80862,31,15,16,2,4,12,13
80863,11754,5866,5888,2927,2040,4357,2430
80864,1325,687,638,379,284,456,206
80902,12289,7082,5207,5259,6375,625,30
80903,15057,7526,7531,3162,5819,4006,2070
80904,19867,9456,10411,3503,5080,6045,5239
80905,16254,8157,8097,3844,4717,4727,2966
80906,37719,19029,18690,9079,10574,10506,7560
80907,26758,13200,13558,5526,7637,7962,5633
80908,13827,6911,6916,3999,1968,5381,2479
80909,35739,17441,18298,8934,9911,9422,7472
80910,28794,13936,14858,8663,9521,6055,4555
80911,30596,14871,15725,9575,7657,8653,4711
80913,2988,2678,310,460,2485,43,0
80914,386,312,74,74,312,0,0
80915,19519,9611,9908,5523,5944,4941,3111
80916,34640,16835,17805,11939,12278,7417,3006
80917,29273,14120,15153,7636,8475,7727,5435
80918,45467,22294,23173,12385,12939,12470,7673
80919,27398,13403,13995,7068,5560,9541,5229
80920,38569,18925,19644,12856,8523,12926,4264
80921,18999,9334,9665,6386,3622,6263,2728
80922,26549,13009,13540,9108,8352,6773,2316
80923,26105,12892,13213,8809,8585,6622,2089
80924,4534,2220,2314,1778,1297,1237,222
80925,5906,2925,2981,2105,1894,1450,457
80926,1403,694,709,359,251,497,296
80927,604,293,311,190,202,148,64
80928,1202,597,605,349,279,394,180
80929,231,116,115,45,27,106,53
80930,821,427,394,216,178,286,141
80938,17,10,7,2,5,8,2
80939,0,0,0,0,0,0,0
80951,4202,2121,2081,1588,1805,683,126
81001,30498,14878,15620,9104,8011,7361,6022
81003,14939,7665,7274,3833,4565,3907,2634
81004,25540,12507,13033,6950,6571,6716,5303
81005,29975,14367,15608,7824,6155,8254,7742
81006,11513,5751,5762,2986,2200,3560,2767
81007,29709,14815,14894,8982,6977,8284,5466
81008,9641,4606,5035,2383,2645,2490,2123
81019,1690,804,886,428,279,511,472
81020,954,463,491,193,137,284,340
81021,14,8,6,1,0,9,4
81022,1560,771,789,442,342,473,303
81023,1236,624,612,240,152,418,426
81024,134,66,68,12,23,47,52
81025,1071,551,520,248,218,321,284
81027,125,62,63,37,24,31,33
81029,326,164,162,66,47,116,97
81030,193,99,94,56,43,61,33
81033,155,74,81,34,24,49,48
81036,962,472,490,211,173,272,306
81038,486,486,0,2,219,199,66
81039,1856,908,948,488,340,497,531
81040,536,275,261,76,74,190,196
81041,760,404,356,268,184,179,129
81043,61,34,27,15,10,13,23
81044,224,106,118,56,35,69,64
81045,88,42,46,17,18,27,26
81047,1559,789,770,422,310,437,390
81049,289,149,140,61,32,85,111
81050,9894,4819,5075,2847,2178,2587,2282
81052,9534,4658,4876,2916,2284,2417,1917
81054,5134,3344,1790,926,1709,1488,1011
81055,1339,636,703,238,171,425,505
81057,418,206,212,134,86,121,77
81058,990,496,494,300,183,252,255
81059,651,576,75,43,367,189,52
81062,2439,2031,408,236,1196,795,212
81063,2726,1838,888,504,857,877,488
81064,282,148,134,72,50,92,68
81067,5670,2799,2871,1490,1157,1550,1473
81069,1888,957,931,428,250,648,562
81071,334,165,169,112,63,104,55
81073,1932,938,994,459,340,521,612
81076,418,210,208,85,67,136,130
81077,532,256,276,146,117,141,128
81081,70,40,30,14,12,24,20
81082,12480,6177,6303,3216,2666,3582,3016
81084,137,76,61,27,29,35,46
81087,145,71,74,44,29,36,36
81089,4602,2312,2290,978,698,1351,1575
81090,981,486,495,237,175,251,318
81091,812,420,392,135,103,282,292
81092,865,439,426,253,179,268,165
81101,14675,7356,7319,4348,4189,3716,2422
81120,2267,1143,1124,601,402,700,564
81121,270,143,127,52,33,89,96
81122,8228,4155,4073,2189,1891,2650,1498
81123,805,417,388,218,144,240,203
81124,303,158,145,99,64,83,57
81125,3447,1758,1689,1162,868,926,491
81126,276,134,142,63,45,82,86
81128,115,62,53,14,8,48,45
81129,156,77,79,44,33,41,38
81130,671,339,332,103,107,222,239
81131,1189,610,579,192,186,389,422
81132,3231,1668,1563,809,657,997,768
81133,840,426,414,180,115,248,297
81136,261,132,129,95,52,69,45
81137,5069,2574,2495,1439,1133,1547,950
81138,56,32,24,15,10,19,12
81140,2341,1142,1199,754,471,648,468
81141,1318,641,677,432,285,315,286
81143,672,350,322,153,125,225,169
81144,7344,3560,3784,2175,1627,2015,1527
81146,531,266,265,136,91,173,131
81147,11446,5781,5665,2509,2077,3707,3153
81148,404,208,196,142,102,98,62
81149,838,429,409,161,152,278,247
81151,1470,731,739,498,340,339,293
81152,1434,753,681,321,237,405,471
81154,1148,590,558,197,188,352,411
81155,225,119,106,30,18,100,77
81201,8645,4274,4371,1654,1649,2800,2542
81210,275,147,128,39,71,103,62
81211,7623,4425,3198,1361,2000,2313,1949
81212,29742,16901,12841,5956,7648,8731,7407
81220,141,69,72,13,7,49,72
81221,310,167,143,81,64,84,81
81222,263,137,126,37,29,102,95
81223,1639,851,788,259,161,610,609
81224,3446,1856,1590,743,1265,1076,362
81225,952,550,402,156,357,301,138
81226,9066,6063,3003,1532,3084,2772,1678
81227,10,5,5,0,3,5,2
81230,9075,4849,4226,1960,3331,2381,1403
81231,715,439,276,447,267,1,0
81232,23,14,9,6,2,7,8
81233,823,428,395,93,85,295,350
81235,802,420,382,171,164,247,220
81236,1017,508,509,135,96,321,465
81237,82,46,36,14,8,23,37
81239,79,42,37,15,13,26,25
81240,4323,2155,2168,992,766,1494,1071
81241,78,37,41,8,7,38,25
81242,606,290,316,160,171,175,100
81243,93,51,42,17,11,33,32
81244,398,192,206,96,89,101,112
81248,48,24,24,7,8,17,16
81251,220,118,102,34,31,81,74
81252,3830,1982,1848,708,518,1275,1329
81253,410,208,202,64,50,154,142
81301,28308,14390,13918,6352,9022,7876,5058
81303,7743,4025,3718,1866,1945,2510,1422
81320,388,193,195,69,55,116,148
81321,14459,7065,7394,3848,3204,3919,3488
81323,4409,2241,2168,946,716,1516,1231
81324,1340,686,654,346,271,375,348
81325,121,62,59,17,21,48,35
81326,2193,1093,1100,579,436,756,422
81327,639,332,307,154,109,222,154
81328,4069,2016,2053,865,775,1310,1119
81330,26,14,12,0,13,11,2
81331,476,253,223,122,90,170,94
81332,282,154,128,61,79,103,39
81334,1493,700,793,582,414,389,108
81335,131,72,59,25,26,50,30
81401,22437,10903,11534,5919,5123,5782,5613
81403,10534,5303,5231,2631,1832,3332,2739
81410,1655,837,818,340,276,482,557
81411,55,28,27,11,6,18,20
81413,5243,2564,2679,1022,759,1433,2029
81415,1612,823,789,373,297,485,457
81416,13874,7065,6809,3807,3236,3742,3089
81418,1714,833,881,383,281,427,623
81419,3883,1962,1921,909,711,1218,1045
81422,692,347,345,176,127,236,153
81423,1480,744,736,350,312,519,299
81424,1239,601,638,324,218,379,318
81425,5424,2701,2723,1679,1153,1531,1061
81426,181,100,81,53,51,66,11
81427,1124,569,555,255,210,356,303
81428,3701,1870,1831,836,635,1186,1044
81429,181,83,98,34,31,59,57
81430,727,384,343,151,153,306,117
81431,460,235,225,105,101,150,104
81432,2682,1330,1352,525,410,983,764
81433,659,368,291,122,176,217,144
81434,158,90,68,33,41,56,28
81435,4965,2758,2207,984,1750,1667,564
81501,23465,12017,11448,5962,8400,5279,3824
81503,15250,7606,7644,4214,3999,4229,2808
81504,28481,14088,14393,8327,8133,7082,4939
81505,9779,4855,4924,2428,2468,2832,2051
81506,10961,5045,5916,2063,1836,3058,4004
81507,15081,7480,7601,3489,2276,4966,4350
81520,13447,6596,6851,4254,3916,3213,2064
81521,15397,7570,7827,4604,3890,3949,2954
81522,139,75,64,25,26,52,36
81523,763,399,364,131,100,332,200
81524,2300,1189,1111,673,418,775,434
81525,871,451,420,226,177,302,166
81526,5321,2674,2647,1176,1023,1725,1397
81527,2073,1056,1017,536,355,760,422
81601,15442,7867,7575,4193,4620,4547,2082
81610,446,238,208,131,101,133,81
81611,9921,5202,4719,1827,2836,3314,1944
81612,20,12,8,1,2,8,9
81615,2839,1569,1270,510,884,917,528
81620,10450,5829,4621,2321,4645,2599,885
81621,5914,3025,2889,1520,1704,1943,747
81623,15235,7950,7285,4017,4319,4698,2201
81624,1537,804,733,475,303,411,348
81625,12921,6561,6360,3852,3329,3769,1971
81630,979,517,462,245,217,335,182
81631,8215,4226,3989,2571,2249,2596,799
81632,10276,5327,4949,2810,3300,2947,1219
81633,19,17,2,8,4,5,2
81635,5957,3092,2865,1825,1493,1582,1057
81637,7721,4050,3671,2719,2304,2174,524
81638,112,63,49,17,16,48,31
81639,2463,1282,1181,661,646,813,343
81640,249,142,107,60,37,84,68
81641,3834,1970,1864,1033,849,1127,825
81642,61,38,23,11,8,26,16
81643,793,408,385,152,106,296,239
81645,1121,600,521,228,399,351,143
81646,184,93,91,33,29,51,71
81647,7104,3643,3461,2231,2115,2052,706
81648,2808,1448,1360,807,811,799,391
81649,277,152,125,46,103,88,40
81650,13006,6793,6213,4200,3790,3518,1498
81652,4904,2532,2372,1489,1207,1598,610
81653,31,11,20,5,7,10,9
81654,1391,744,647,298,308,549,236
81655,65,31,34,17,18,24,6
81656,242,140,102,41,40,106,55
81657,5581,3199,2382,647,2578,1474,882
82063,29,14,15,3,5,15,6
6001,18385,8832,9553,5061,2623,6323,4378
6002,20486,9199,11287,4090,4103,5960,6333
6010,60448,29131,31317,14191,15710,18122,12425
6013,9326,4713,4613,2703,1512,3547,1564
6016,6226,3005,3221,1543,1482,2036,1165
6018,2865,1357,1508,613,602,828,822
6019,10129,4888,5241,2608,1807,3491,2223
6020,0,0,0,0,0,0,0
6021,314,157,157,74,59,112,69
6022,163,87,76,44,20,51,48
6023,1296,635,661,315,249,448,284
6024,647,317,330,162,144,199,142
6026,5117,2538,2579,1331,1034,1717,1035
6027,1492,756,736,371,250,564,307
6029,15547,7655,7892,4032,3496,5279,2740
6031,1287,648,639,277,227,462,321
6032,17675,8340,9335,4030,3589,5598,4458
6033,28762,13643,15119,7924,5067,9685,6086
6035,7513,3665,3848,1976,1162,2692,1683
6037,18565,9001,9564,4301,3409,6304,4551
6039,1942,932,1010,411,280,627,624
6040,35306,17001,18305,8642,10068,10012,6584
6042,22942,10983,11959,4835,7901,5915,4291
6043,4986,2463,2523,1226,881,1806,1073
6051,30519,14789,15730,9452,9435,7311,4321
6052,7858,3766,4092,1899,2128,2242,1589
6053,34863,16990,17873,8892,11582,8296,6093
6057,6707,3335,3372,1717,1186,2464,1340
6058,1787,881,906,410,275,653,449
6059,0,0,0,0,0,0,0
6060,2581,1301,1280,799,372,1034,376
6061,169,88,81,41,30,58,40
6062,17715,8576,9139,3854,4507,5495,3859
6063,3285,1673,1612,838,504,1267,676
6065,882,430,452,221,148,335,178
6066,29219,13973,15246,6272,8268,8382,6297
6067,19709,9617,10092,4074,4723,6031,4881
6068,1612,745,867,228,237,460,687
6069,2535,1234,1301,447,344,894,850
6070,15104,7325,7779,4394,2255,5134,3321
6071,11645,6923,4722,2400,2877,4127,2241
6073,5651,2746,2905,1737,739,2135,1040
6074,25705,12403,13302,6723,4860,8661,5461
6076,12659,6289,6370,3093,2880,4311,2375
6078,12413,7126,5287,2849,3207,4013,2344
6081,1381,671,710,355,345,426,255
6082,44654,23359,21295,9743,12336,13596,8979
6084,15067,7482,7585,4313,2768,5360,2626
6085,7276,3561,3715,1930,1460,2537,1349
6088,4936,2414,2522,840,1251,1587,1258
6089,2813,1381,1432,776,523,1018,496
6090,1232,633,599,328,165,501,238
6091,140,71,69,29,20,53,38
6092,4203,2080,2123,1380,502,1610,711
6093,3322,1626,1696,796,588,1179,759
6095,29079,13849,15230,6898,6456,9306,6419
6096,12498,6052,6446,2843,2866,4012,2777
6098,12426,6143,6283,2839,2668,4153,2766
6103,1410,821,589,77,861,318,154
6105,19392,9564,9828,4082,7112,5171,3027
6106,39902,19708,20194,12507,13038,9269,5088
6107,18786,8886,9900,4868,3514,5914,4490
6108,24307,11842,12465,6844,6914,6789,3760
6109,26668,12474,14194,6011,5345,8131,7181
6110,12650,5880,6770,3210,3355,3666,2419
6111,30562,14468,16094,6677,7006,9224,7655
6112,22879,10244,12635,7598,6335,5452,3494
6114,27449,13086,14363,8953,8365,6826,3305
6117,17267,7893,9374,5089,3097,4456,4625
6118,26956,12719,14237,6452,6969,7575,5960
6119,15474,7121,8353,3734,4600,4236,2904
6120,12887,6444,6443,4435,3998,2980,1474
6160,0,0,0,0,0,0,0
6226,20114,9850,10264,6391,7120,4107,2496
6231,4083,2037,2046,1155,795,1523,610
6232,3297,1675,1622,905,578,1274,540
6234,8244,4214,4030,1983,2038,2607,1616
6235,2257,1158,1099,494,528,811,424
6237,5492,2670,2822,1287,982,1978,1245
6238,12428,6293,6135,3150,2769,4406,2103
6239,11183,5500,5683,2736,2900,3364,2183
6241,6650,3298,3352,1699,1686,1998,1267
6242,1408,732,676,320,290,471,327
6243,60,31,29,12,25,15,8
6247,2841,1462,1379,671,567,1030,573
6248,5603,2796,2807,1744,837,2079,943
6249,7308,3696,3612,1918,1413,2664,1313
6250,4821,2340,2481,1219,1040,1522,1040
6254,1922,984,938,459,383,668,412
6255,4744,2383,2361,1178,1060,1537,969
6256,2154,1040,1114,387,410,685,672
6259,4498,2227,2271,1222,900,1585,791
6260,9510,4643,4867,2338,2433,2748,1991
6262,586,280,306,106,94,196,190
6263,345,171,174,107,101,100,37
6264,166,88,78,38,33,58,37
6266,495,232,263,102,128,138,127
6268,11481,6360,5121,2225,5304,2231,1721
6269,9844,4879,4965,4575,5256,11,2
6277,4140,2076,2064,1010,903,1462,765
6278,4454,2196,2258,1091,1016,1581,766
6279,6041,3084,2957,1231,1915,1906,989
6280,3162,1527,1635,596,722,943,901
6281,6930,3427,3503,1747,1243,2554,1386
6282,1096,549,547,274,211,397,214
6320,27617,13640,13977,7457,9642,6523,3995
6330,3282,1617,1665,870,812,1054,546
6331,5137,2586,2551,1253,1086,1827,971
6332,258,130,128,73,50,92,43
6333,6607,3253,3354,1876,1062,2399,1270
6334,2592,1309,1283,595,534,915,548
6335,6729,3318,3411,1822,1379,2209,1319
6336,84,44,40,19,20,31,14
6339,8302,4175,4127,2183,1996,2618,1505
6340,31242,16857,14385,7650,11950,6593,5049
6350,67,31,36,14,13,26,14
6351,16301,8134,8167,4124,3824,5509,2844
6353,162,86,76,22,34,62,44
6354,6141,3064,3077,1683,1628,1844,986
6355,12985,6209,6776,2684,2273,4228,3800
6357,12552,5776,6776,2172,3225,3872,3283
6359,5313,2693,2620,1214,925,2001,1173
6360,37541,18179,19362,9269,10401,10812,7059
6365,4720,2352,2368,1045,872,1673,1130
6370,7429,3721,3708,1974,1595,2570,1290
6371,9952,4902,5050,2195,1332,3397,3028
6373,345,183,162,98,100,107,40
6374,8373,4030,4343,2120,2043,2599,1611
6375,3660,1833,1827,972,675,1196,817
6376,57,24,33,9,6,12,30
6377,2962,1543,1419,820,724,1034,384
6378,5399,2646,2753,1127,732,1938,1602
6379,9038,4455,4583,2272,1855,2922,1989
6380,2862,1367,1495,827,803,764,468
6382,11947,6677,5270,2441,3484,3612,2410
6384,2672,1354,1318,668,537,1021,446
6385,15893,7650,8243,3505,2748,5256,4384
6387,213,106,107,65,72,54,22
6389,41,25,16,9,16,15,1
6401,19237,9259,9978,5048,4993,5605,3591
6403,6033,3010,3023,1499,1343,2020,1171
6405,27860,13101,14759,5389,5783,9204,7484
6409,693,322,371,150,125,208,210
6410,29161,15149,14012,7931,5625,9694,5911
6412,3994,1870,2124,834,600,1415,1145
6413,13235,6435,6800,3146,2639,4463,2987
6414,214,99,115,28,37,70,79
6415,16857,8299,8558,4777,3382,5943,2755
6416,14005,6798,7207,3140,3169,4502,3194
6417,4629,2301,2328,1061,945,1588,1035
6418,12914,6198,6716,2973,3434,3762,2745
6419,6525,3216,3309,1694,802,2413,1616
6420,4182,2112,2070,1155,823,1536,668
6422,7388,3684,3704,2086,1227,2676,1399
6423,5097,2585,2512,1290,893,1926,988
6424,12808,6344,6464,3217,2640,4612,2339
6426,3245,1530,1715,568,328,1026,1323
6437,22375,10772,11603,5625,3252,7745,5753
6438,2550,1284,1266,623,481,896,550
6441,5438,2752,2686,1415,958,1969,1096
6442,2745,1322,1423,760,437,1058,490
6443,18269,8868,9401,5096,2056,6433,4684
6444,370,195,175,109,77,119,65
6447,6404,3152,3252,1754,1117,2265,1268
6450,36493,17639,18854,9428,9876,10389,6800
6451,24419,11833,12586,6595,6428,7044,4352
6455,3148,1595,1553,783,497,1189,679
6456,295,141,154,54,40,108,93
6457,47648,23140,24508,10955,14748,13245,8700
6460,38207,18323,19884,8029,9132,12384,8662
6461,14552,7082,7470,3459,2950,4726,3417
6467,157,77,80,42,26,60,29
6468,19479,9579,9900,5553,3357,6827,3742
6469,3209,1568,1641,789,654,1112,654
6470,16003,8177,7826,4478,2543,5915,3067
6471,7720,3699,4021,1808,1455,2468,1989
6472,6853,3398,3455,1722,1248,2354,1529
6473,24388,11731,12657,5513,4696,7737,6442
6475,10242,4852,5390,2194,1342,3274,3432
6477,13956,6750,7206,3490,2239,4639,3588
6478,12683,6307,6376,3333,2289,4461,2600
6479,10431,5004,5427,2549,2180,3392,2310
6480,9508,4614,4894,2335,1938,3152,2083
6481,1277,633,644,297,260,418,302
6482,11557,5730,5827,3621,1763,4239,1934
6483,16540,8041,8499,3992,3846,5366,3336
6484,39559,19184,20375,9077,8132,12799,9551
6488,19904,9300,10604,4359,2631,6244,6670
6489,32067,15430,16637,7892,6460,9770,7945
6492,45241,21807,23434,10411,10299,14267,10264
6498,6963,3424,3539,1487,1291,2256,1929
6510,2737,1398,1339,297,1874,364,202
6511,53600,26281,27319,13312,23492,10858,5938
6512,29861,14263,15598,6429,7698,8715,7019
6513,38978,18638,20340,11526,11756,9668,6028
6514,26265,12293,13972,6317,7922,7255,4771
6515,17141,7775,9366,5000,5750,3753,2638
6516,55564,26897,28667,14142,16004,15448,9970
6517,14853,6840,8013,3446,3417,4281,3709
6518,19848,8911,10937,5088,6268,4493,3999
6519,16428,7942,8486,5642,5021,3639,2126
6524,5563,2808,2755,1466,869,2092,1136
6525,8990,4393,4597,2293,1210,3121,2366
6604,30313,15266,15047,8300,10968,7020,4025
6605,23397,11692,11705,6629,8089,5637,3042
6606,46236,22210,24026,12535,14198,12511,6992
6607,7843,3637,4206,2665,2317,1866,995
6608,13671,6511,7160,4700,4171,3309,1491
6610,22735,10660,12075,6174,6306,6245,4010
6611,36091,17356,18735,9853,6042,11639,8557
6612,7453,3698,3755,2236,892,2736,1589
6614,32929,15574,17355,7633,7008,9789,8499
6615,18453,8617,9836,4819,4617,5444,3573
6702,3654,1759,1895,794,818,949,1093
6704,25139,11873,13266,8029,6989,6389,3732
6705,27122,12787,14335,7125,7912,7155,4930
6706,14324,6991,7333,4198,3871,3835,2420
6708,29418,13941,15477,7659,7994,8053,5712
6710,10715,5158,5557,3800,2973,2666,1276
6712,9376,4516,4860,2316,1795,3250,2015
6716,16680,8074,8606,4340,3240,5662,3438
6750,1446,711,735,307,272,516,351
6751,3577,1763,1814,825,565,1338,849
6752,1735,865,870,360,186,599,590
6754,1699,874,825,417,261,631,390
6755,1133,565,568,304,210,413,206
6756,2853,1410,1443,642,392,1051,768
6757,2258,1097,1161,438,359,776,685
6758,354,176,178,94,47,138,75
6759,5720,2780,2940,1369,742,1908,1701
6762,7561,3658,3903,2002,1332,2426,1801
6763,2033,1013,1020,450,379,730,474
6770,31975,15678,16297,8153,8653,9609,5560
6776,26889,13256,13633,7094,5693,9242,4860
6777,1733,875,858,348,285,575,525
6778,1378,702,676,334,250,476,318
6779,8324,4072,4252,1976,1938,2585,1825
6782,2376,1210,1166,554,484,865,473
6783,2228,1120,1108,468,286,816,658
6784,3689,1849,1840,927,474,1409,879
6785,686,352,334,168,112,219,187
6786,9867,4857,5010,2419,2295,3321,1832
6787,7975,3866,4109,2004,1618,2821,1532
6790,36482,17873,18609,8459,8515,11520,7988
6791,5666,2861,2805,1400,928,1991,1347
6793,1140,565,575,224,165,398,353
6794,1065,514,551,233,158,328,346
6795,14144,6828,7316,3339,2668,4814,3323
6796,1009,498,511,194,116,371,328
6798,9984,4841,5143,2264,1661,3541,2518
6801,18581,9055,9526,4776,4057,6285,3463
6804,16466,7968,8498,4426,2936,5770,3334
6807,7150,3412,3738,2079,1352,2320,1399
6810,49482,25152,24330,12331,17209,13008,6934
6811,31400,14547,16853,7185,8350,9946,5919
6812,13881,6888,6993,4070,2286,5057,2468
6820,20732,10220,10512,7696,3005,6754,3277
6824,33900,16123,17777,10376,7091,10183,6250
6825,21123,10000,11123,6107,4257,6154,4605
6830,24027,11263,12764,6194,5003,7433,5397
6831,14792,7076,7716,3869,2165,4821,3937
6840,19738,9490,10248,6656,2339,6830,3913
6850,18078,8831,9247,4116,4983,5538,3441
6851,26703,12755,13948,6018,7006,8124,5555
6853,3646,1787,1859,1022,621,1183,820
6854,29100,14632,14468,7558,9864,7556,4122
6855,7892,3892,4000,1752,2353,2295,1492
6856,3,2,1,0,1,2,0
6870,7316,3503,3813,2465,1050,2508,1293
6877,24677,11945,12732,7775,3150,8923,4829
6878,8043,3942,4101,2773,1049,2644,1577
6880,26647,12827,13820,8272,2949,9530,5896
6883,10179,5035,5144,3481,1025,3949,1724
6890,4306,2074,2232,1279,563,1412,1052
6896,9110,4374,4736,2505,1021,3399,2185
6897,18071,8798,9273,5975,2154,6448,3494
6901,6828,3408,3420,808,3328,1442,1250
6902,63406,31676,31730,15007,21860,16231,10308
6903,14499,7141,7358,3911,2046,5114,3428
6905,19649,9377,10272,4696,5256,5551,4146
6906,9088,4352,4736,2059,2954,2559,1516
6907,9016,4371,4645,2193,2565,2710,1548
19701,39194,19161,20033,10897,10384,12668,5245
19702,51899,25219,26680,15138,16493,14710,5558
19703,14471,6905,7566,3759,4108,4101,2503
19706,1822,909,913,423,424,562,413
19707,16483,8029,8454,4365,2485,5708,3925
19709,35107,17125,17982,11591,8205,10541,4770
19710,41,21,20,13,5,17,6
19711,51322,24793,26529,11193,18242,13057,8830
19713,30408,14521,15887,7566,8981,8149,5712
19716,1568,699,869,941,627,0,0
19717,3770,1531,2239,3124,646,0,0
19720,59250,28259,30991,16483,15880,17081,9806
19730,451,230,221,117,96,117,121
19731,252,122,130,56,63,78,55
19732,25,12,13,4,2,7,12
19733,110,54,56,26,35,33,16
19734,11651,5801,5850,3591,2722,3596,1742
19735,12,6,6,1,5,6,0
19736,32,18,14,8,4,11,9
19801,16286,8330,7956,4661,5312,4331,1982
19802,24621,11231,13390,6983,6499,6979,4160
19803,21364,10236,11128,4826,3767,6606,6165
19804,17944,8813,9131,4278,4828,5235,3603
19805,40937,19775,21162,12119,12507,10487,5824
19806,9560,4355,5205,1045,3276,2311,2928
19807,7405,3571,3834,1705,989,2291,2420
19808,38442,18453,19989,8942,8970,11547,8983
19809,14049,6726,7323,3242,3777,4289,2741
19810,25011,11983,13028,5636,5058,7904,6413
19901,35055,16534,18521,10415,10407,7809,6424
19902,283,244,39,78,205,0,0
19904,34132,16206,17926,9333,9376,8796,6627
19930,2768,1303,1465,203,185,674,1706
19931,211,104,107,43,40,58,70
19933,8535,4206,4329,2414,1968,2304,1849
19934,12805,6305,6500,3417,2761,3862,2765
19936,302,140,162,103,85,71,43
19938,8357,4161,4196,2497,2077,2448,1335
19939,5979,2863,3116,1217,1070,1696,1996
19940,5574,2689,2885,1549,1237,1569,1219
19941,2522,1241,1281,726,660,729,407
19943,11425,5550,5875,2961,2689,3580,2195
19944,620,317,303,43,48,165,364
19945,6862,3432,3430,1503,1524,2062,1773
19946,4420,2134,2286,1232,989,1284,915
19947,18799,10094,8705,4945,5712,4754,3388
19950,6951,3443,3508,1802,1534,2073,1542
19951,1733,855,878,373,338,576,446
19952,10220,4862,5358,2802,2412,2870,2136
19953,4386,2178,2208,1208,1008,1333,837
19954,1464,726,738,370,301,468,325
19955,72,38,34,16,18,29,9
19956,15500,7451,8049,4409,3586,4362,3143
19958,19650,9266,10384,3158,3088,5445,7959
19960,6295,3099,3196,1900,1497,1763,1135
19962,10206,4982,5224,3248,2503,2981,1474
19963,19206,9209,9997,4909,4384,5068,4845
19964,1340,679,661,366,271,457,246
19966,24601,11713,12888,5001,4801,6673,8126
19967,354,178,176,60,79,104,111
19968,9549,4632,4917,2195,1992,2771,2591
19970,6170,2950,3220,857,804,1618,2891
19971,12385,6198,6187,1621,1985,3860,4919
19973,23838,11386,12452,6533,5383,6515,5407
19975,8253,4015,4238,1507,1433,2217,3096
19977,22984,12352,10632,5897,6637,6455,3995
19979,632,312,320,155,134,205,138
21912,9,4,5,4,2,2,1
20001,38551,18912,19639,6711,19472,8104,4264
20002,52370,24896,27474,10378,19953,14304,7735
20003,26454,14054,12400,3593,12661,6695,3505
20004,1622,834,788,62,830,481,249
20005,12775,7000,5775,781,7849,2818,1327
20006,3227,1603,1624,1498,1513,136,80
20007,26866,12259,14607,3482,13178,5498,4708
20008,27525,11991,15534,2683,12615,6468,5759
20009,47992,24279,23713,5230,27138,10589,5035
20010,30138,15548,14590,4920,14989,6683,3546
20011,58536,27683,30853,12739,17630,16607,11560
20012,13414,6088,7326,2581,3374,4048,3411
20015,15332,7076,8256,3470,3063,4624,4175
20016,32519,14385,18134,7487,9872,8006,7154
20017,17735,8066,9669,3615,5105,4763,4252
20018,16894,7548,9346,3657,4098,4788,4351
20019,54358,24004,30354,16588,13682,14814,9274
20020,49864,22125,27739,15636,13577,13042,7609
20024,11510,5330,6180,1702,4096,3280,2432
20032,35653,16373,19280,11582,10787,8841,4443
20036,5435,2716,2719,115,3506,1193,621
20037,14642,6699,7943,1730,9053,1782,2077
20045,0,0,0,0,0,0,0
20052,470,239,231,379,84,2,5
20053,0,0,0,0,0,0,0
20057,3888,1783,2105,2182,1664,11,31
20064,1890,854,1036,702,1139,23,26
20202,0,0,0,0,0,0,0
20204,0,0,0,0,0,0,0
20228,0,0,0,0,0,0,0
20230,0,0,0,0,0,0,0
20240,0,0,0,0,0,0,0
20245,0,0,0,0,0,0,0
20260,0,0,0,0,0,0,0
20307,353,315,38,9,265,78,1
20317,903,797,106,6,7,8,882
20319,84,79,5,11,72,1,0
20373,131,113,18,10,105,16,0
20390,584,568,16,180,402,2,0
20405,0,0,0,0,0,0,0
20418,0,0,0,0,0,0,0
20427,0,0,0,0,0,0,0
20506,0,0,0,0,0,0,0
20510,0,0,0,0,0,0,0
20520,0,0,0,0,0,0,0
20535,8,5,3,1,1,6,0
20540,0,0,0,0,0,0,0
20551,0,0,0,0,0,0,0
20553,0,0,0,0,0,0,0
20560,0,0,0,0,0,0,0
20565,0,0,0,0,0,0,0
20566,0,0,0,0,0,0,0
20593,0,0,0,0,0,0,0
32003,27126,13290,13836,8153,5243,9021,4709
32008,5309,2724,2585,1252,1052,1560,1445
32009,3325,1676,1649,941,720,1086,578
32011,13854,6901,6953,3847,3190,4289,2528
32024,18733,9258,9475,5061,4165,5363,4144
32025,22380,12495,9885,5219,6726,5798,4637
32026,1959,1953,6,11,1164,740,44
32033,4118,2051,2067,841,745,1117,1415
32034,31008,14973,16035,6149,5654,9375,9830
32038,9228,4644,4584,2186,1819,3018,2205
32040,7604,3827,3777,2354,1820,2168,1262
32043,24632,12257,12375,6903,5593,7292,4844
32044,2060,1033,1027,538,441,627,454
32046,9410,4651,4759,2630,2196,2716,1868
32052,9223,5947,3276,1858,3242,2565,1558
32053,3869,1925,1944,1075,814,1093,887
32054,12307,7444,4863,2918,3876,3644,1869
32055,16570,8222,8348,4523,3938,4615,3494
32058,4416,2578,1838,952,1315,1398,751
32059,2377,1172,1205,592,479,658,648
32060,21363,10886,10477,5145,4801,5708,5709
32061,283,149,134,72,62,80,69
32062,2449,1252,1197,608,461,680,700
32063,13429,6587,6842,3902,3477,3634,2416
32064,6860,3365,3495,2071,1820,1545,1424
32065,32770,15841,16929,10601,8936,8912,4321
32066,7312,4660,2652,1623,2627,1936,1126
32068,50815,25176,25639,15406,12718,15370,7321
32071,3671,1853,1818,841,741,1069,1020
32072,324,159,165,83,59,96,86
32073,38920,18738,20182,10189,9861,10909,7961
32079,433,160,273,10,8,11,404
32080,20165,9721,10444,3036,4125,5527,7477
32081,4524,2174,2350,1591,1026,1368,539
32082,28996,13812,15184,6388,4478,9823,8307
32083,4690,4016,674,448,1637,1797,808
32084,29729,14189,15540,6980,8219,8062,6468
32086,24546,11539,13007,5102,4947,7392,7105
32087,5518,3470,2048,1349,1873,1687,609
32091,15472,7463,8009,4106,3692,4177,3497
32092,28242,14004,14238,8951,6911,8018,4362
32094,2724,1334,1390,663,554,756,751
32095,7302,3849,3453,1866,1817,2339,1280
32096,2635,1333,1302,646,551,781,657
32097,15616,7895,7721,4161,4307,4595,2553
32102,2565,1316,1249,424,366,749,1026
32110,7600,3854,3746,1859,1700,2369,1672
32112,7713,3814,3899,2175,1619,1701,2218
32113,6627,3279,3348,1554,1424,2083,1566
32114,32084,16106,15978,8267,10316,7176,6325
32117,24170,11807,12363,5509,6163,6979,5519
32118,16961,8677,8284,1944,3334,5244,6439
32119,20189,9734,10455,3638,4878,5343,6330
32124,5986,4404,1582,760,2574,1981,671
32127,29413,14335,15078,5303,5331,8991,9788
32128,16910,8184,8726,3487,2700,4628,6095
32129,20104,9611,10493,3768,5031,5242,6063
32130,5474,2797,2677,1461,1231,1518,1264
32131,4701,2599,2102,991,1185,1352,1173
32132,7265,3517,3748,1425,1410,2150,2280
32133,137,67,70,35,24,39,39
32134,8084,4120,3964,1456,1195,2549,2884
32136,7080,3417,3663,831,768,2170,3311
32137,37821,18043,19778,7360,5990,9826,14645
32139,1129,588,541,189,153,316,471
32140,1741,869,872,403,333,562,443
32141,17603,8469,9134,3466,3188,4878,6071
32145,5456,2837,2619,1640,1166,1691,959
32147,593,296,297,175,144,163,111
32148,11201,5604,5597,2803,2365,3121,2912
32157,407,212,195,77,75,104,151
32159,28867,13420,15447,2949,2749,4349,18820
32162,45180,21193,23987,228,572,5091,39289
32164,41616,19949,21667,10836,9522,10406,10852
32168,23642,11517,12125,4496,4346,7027,7773
32169,9816,4719,5097,1043,1228,2736,4809
32174,47552,22617,24935,8866,7716,14103,16867
32176,14339,6866,7473,2034,2092,4332,5881
32177,27132,13074,14058,7871,6216,7332,5713
32179,8156,4126,4030,1725,1523,2560,2348
32180,4218,2212,2006,1309,1023,1100,786
32181,2551,1277,1274,620,505,695,731
32187,1713,874,839,385,342,534,452
32189,5807,2903,2904,1120,939,1618,2130
32190,1170,594,576,368,253,273,276
32193,825,399,426,120,97,203,405
32195,3328,1608,1720,748,596,1093,891
32202,7915,5633,2282,832,3455,2435,1193
32204,6906,3201,3705,1247,2355,1628,1676
32205,28225,13616,14609,6856,8797,7913,4659
32206,17669,8500,9169,5273,4508,5111,2777
32207,33306,16363,16943,7921,9210,9886,6289
32208,30879,14269,16610,8410,6859,8978,6632
32209,34305,15211,19094,10564,7857,8761,7123
32210,59080,28112,30968,16937,16162,16212,9769
32211,30501,14754,15747,8402,8601,8626,4872
32212,1959,1438,521,503,1363,89,4
32216,34876,16793,18083,7893,11288,9240,6455
32217,18817,8893,9924,4223,4968,5177,4449
32218,53473,25483,27990,15918,14652,15256,7647
32219,11886,5877,6009,3460,2911,3548,1967
32220,12946,6437,6509,3517,3196,4106,2127
32221,27918,13519,14399,8361,7150,8218,4189
32222,8691,4269,4422,2630,2387,2534,1140
32223,23980,11611,12369,5640,4827,8221,5292
32224,38934,18709,20225,10653,13663,9261,5357
32225,52485,25655,26830,14090,14629,15872,7894
32226,15761,7776,7985,4476,4093,4880,2312
32227,2149,1271,878,865,1162,115,7
32228,314,276,38,56,251,7,0
32233,23673,12759,10914,5223,8122,6233,4095
32234,6606,3252,3354,1776,1626,2013,1191
32244,57369,27230,30139,17068,17438,15436,7427
32246,48789,24161,24628,13020,16928,13026,5815
32250,25356,12869,12487,4466,8154,7627,5109
32254,13570,6580,6990,4295,3453,3918,1904
32256,38483,18465,20018,7839,15234,9228,6182
32257,36430,17246,19184,9121,9516,10745,7048
32258,26759,12936,13823,7323,8147,7974,3315
32259,36917,18225,18692,12221,6992,12769,4935
32266,7037,3586,3451,1322,2121,2192,1402
32277,29517,13833,15684,8559,8671,7792,4495
32301,29321,12848,16473,6942,13395,5904,3080
32303,47359,22633,24726,10999,19998,10013,6349
32304,46145,22678,23467,13531,26840,3710,2064
32305,20073,9441,10632,5822,5585,5442,3224
32308,21586,9745,11841,4300,6502,5486,5298
32309,30159,14369,15790,7722,6196,9647,6594
32310,17402,8797,8605,5311,5837,4042,2212
32311,17493,8413,9080,4437,5447,5117,2492
32312,31869,15425,16444,9017,6349,10477,6026
32317,14067,6778,7289,4064,2875,4853,2275
32320,3858,2014,1844,843,1000,1140,875
32321,6460,4138,2322,1428,2107,1994,931
32322,4007,2724,1283,561,1483,1116,847
32323,217,115,102,32,24,61,100
32324,5445,3107,2338,1056,1255,1970,1164
32327,26953,15062,11891,6732,7725,8447,4049
32328,3149,1625,1524,706,707,875,861
32330,804,383,421,275,213,213,103
32331,4242,2118,2124,1168,873,1169,1032
32332,1642,761,881,501,475,401,265
32333,11330,5453,5877,2500,2311,3694,2825
32334,1904,954,950,537,504,512,351
32336,1391,668,723,293,277,443,378
32340,11808,6382,5426,2773,3283,3323,2429
32343,3044,1381,1663,1038,1009,728,269
32344,13193,6963,6230,2730,3151,4176,3136
32346,1693,901,792,335,271,529,558
32347,8057,3901,4156,2008,1750,2323,1976
32348,12442,7599,4843,2572,3925,3702,2243
32350,1417,677,740,353,303,384,377
32351,17486,8403,9083,5202,4627,4468,3189
32352,6638,3159,3479,1887,1507,1944,1300
32355,312,154,158,57,59,121,75
32356,129,66,63,33,26,31,39
32358,2145,1057,1088,504,403,644,594
32359,1721,882,839,252,242,494,733
32361,252,134,118,52,64,81,55
32399,2,1,1,0,0,0,2
32401,22647,10597,12050,5570,5563,6364,5150
32403,2995,1642,1353,1216,1508,252,19
32404,38425,19907,18518,9509,10578,11055,7283
32405,29980,14225,15755,7649,7964,7960,6407
32407,9347,4741,4606,2084,3009,2514,1740
32408,15352,7728,7624,3113,4102,4833,3304
32409,8691,4399,4292,2328,1934,2783,1646
32410,740,361,379,90,125,226,299
32413,13128,6613,6515,2549,3057,4181,3341
32420,2144,1076,1068,483,411,715,535
32421,4497,2248,2249,1199,1068,1292,938
32423,1264,626,638,321,265,326,352
32424,7994,4649,3345,1755,2372,2246,1621
32425,14268,7742,6526,3370,3674,3900,3324
32426,942,453,489,226,171,312,233
32427,1475,779,696,364,382,411,318
32428,17412,9783,7629,4009,4748,5023,3632
32430,1199,604,595,295,258,349,297
32431,4983,2395,2588,1364,1119,1359,1141
32432,89,42,47,26,19,20,24
32433,16025,8805,7220,3921,4331,4565,3208
32435,6651,3251,3400,1635,1470,1825,1721
32437,679,348,331,160,153,209,157
32438,4060,2048,2012,1103,889,1322,746
32439,7715,3906,3809,1887,1950,2352,1526
32440,7563,4635,2928,1518,2294,2215,1536
32442,3699,1759,1940,968,841,1005,885
32443,2921,1415,1506,743,595,890,693
32444,18985,9097,9888,5048,4295,5753,3889
32445,2644,2004,640,319,1069,876,380
32446,11075,5759,5316,2414,2922,3032,2707
32447,78,78,0,78,0,0,0
32448,8684,4219,4465,2317,2105,2374,1888
32449,478,231,247,123,120,124,111
32455,4736,2409,2327,1271,1032,1374,1059
32456,6966,3367,3599,1389,1242,2053,2282
32459,11457,5660,5797,2512,3075,3523,2347
32460,5856,3865,1991,1037,1882,1931,1006
32461,13,6,7,2,2,9,0
32462,3412,1719,1693,867,700,1059,786
32463,114,62,52,31,25,28,30
32464,3994,2028,1966,904,777,1239,1074
32465,9232,6277,2955,1513,3219,2998,1502
32466,5641,2854,2787,1515,1248,1902,976
32501,11730,6248,5482,2520,3062,3764,2384
32502,3298,1690,1608,605,855,1079,759
32503,32011,14944,17067,7722,9492,8042,6755
32504,21441,10187,11254,4637,5765,5863,5176
32505,28213,13402,14811,8614,7026,7631,4942
32506,33846,16378,17468,9366,9107,8949,6424
32507,28996,14505,14491,7514,7811,7884,5787
32508,5852,4666,1186,2468,3279,94,11
32509,660,655,5,10,280,302,68
32511,1145,878,267,487,657,1,0
32514,37399,17494,19905,8728,11518,8800,8353
32526,36297,17445,18852,9339,9048,10351,7559
32530,38,16,22,7,7,12,12
32531,5296,2612,2684,1356,1078,1678,1184
32533,26493,13035,13458,7044,5721,8235,5493
32534,14029,6826,7203,3655,3716,3824,2834
32535,6326,3863,2463,1273,2031,1869,1153
32536,19709,9569,10140,6126,5357,5437,2789
32539,25079,13067,12012,6744,7000,7251,4084
32541,15565,7873,7692,3104,4299,4662,3500
32542,3457,2198,1259,1233,2054,161,9
32544,1818,1176,642,601,1105,111,1
32547,32485,16079,16406,8067,9837,8646,5935
32548,19343,9654,9689,4087,5114,5645,4497
32550,5867,2839,3028,871,1203,1644,2149
32561,7899,3857,4042,1739,1215,2772,2173
32563,22406,11020,11386,5720,4683,7212,4791
32564,2881,1461,1420,712,617,952,600
32565,5719,2904,2815,1528,1341,1621,1229
32566,33671,16772,16899,9744,8975,10136,4816
32567,3510,1748,1762,867,695,1064,884
32568,3122,1567,1555,794,616,936,776
32569,11235,5650,5585,2604,3338,3391,1902
32570,28817,14166,14651,7491,7435,7913,5978
32571,28881,14139,14742,8301,6465,8996,5119
32577,4625,2273,2352,1160,835,1517,1113
32578,30108,14876,15232,7344,6297,9504,6963
32579,9997,4757,5240,2269,2077,2839,2812
32580,3662,1827,1835,785,863,1083,931
32583,25586,14347,11239,5852,7447,7724,4563
32601,18585,8965,9620,3328,11082,2628,1547
32603,6741,3765,2976,1883,4352,275,231
32605,22925,11019,11906,4732,6948,6237,5008
32606,21833,10190,11643,5414,6485,5583,4351
32607,29750,14412,15338,7014,14605,5097,3034
32608,45842,22282,23560,9167,23055,8132,5488
32609,18756,9468,9288,4896,5916,5117,2827
32612,5458,2231,3227,4114,1340,3,1
32615,14295,6897,7398,3557,3074,4551,3113
32616,872,370,502,280,211,216,165
32617,4109,2045,2064,979,794,1337,999
32618,7732,3807,3925,1845,1586,2572,1729
32619,4730,2415,2315,1126,946,1376,1282
32621,5584,2697,2887,1432,1456,1562,1134
32622,1294,659,635,300,271,421,302
32625,1838,934,904,376,290,551,621
32626,8133,3979,4154,2016,1650,2127,2340
32628,4850,3011,1839,993,1550,1480,827
32631,291,147,144,31,36,116,108
32639,397,192,205,70,81,114,132
32640,10510,5257,5253,2241,1980,3361,2928
32641,14291,7044,7247,4241,3896,3827,2327
32643,10936,5375,5561,2714,2316,3462,2444
32648,437,227,210,95,66,134,142
32653,12844,5994,6850,2960,2832,4024,3028
32656,14014,6924,7090,3717,2856,4180,3261
32658,308,157,151,77,65,100,66
32664,510,250,260,88,83,146,193
32666,5916,2942,2974,1206,1065,1909,1736
32667,3794,1893,1901,698,653,1349,1094
32668,5082,2562,2520,1060,912,1688,1422
32669,11623,5526,6097,3111,2991,3352,2169
32680,10223,5129,5094,2288,1845,3003,3087
32681,136,78,58,16,18,40,62
32683,151,78,73,29,35,46,41
32686,5003,2493,2510,1217,1088,1553,1145
32692,295,157,138,9,18,82,186
32693,12154,6343,5811,3225,3143,3059,2727
32694,2142,1067,1075,540,444,644,514
32696,12071,5867,6204,2994,2579,3555,2943
32697,253,119,134,99,86,44,24
32701,21577,10290,11287,4462,6528,5767,4820
32702,2705,1312,1393,556,468,722,959
32703,46207,22623,23584,13414,12795,12975,7023
32707,35335,17155,18180,8097,10259,10213,6766
32708,42012,20186,21826,10554,9793,13484,8181
32709,2566,1336,1230,617,528,906,515
32712,41769,20514,21255,11746,10118,12604,7301
32713,19491,9426,10065,4013,3633,5937,5908
32714,34862,16569,18293,8451,11246,9551,5614
32720,29700,14243,15457,7250,6623,8274,7553
32724,31826,15131,16695,7598,7172,8270,8786
32725,44905,21695,23210,11930,10711,12629,9635
32726,20029,9454,10575,5037,4514,5078,5400
32730,5354,2624,2730,1126,1584,1411,1233
32732,5589,2884,2705,1308,1063,2158,1060
32735,3903,1908,1995,755,649,982,1517
32736,9736,4864,4872,2549,1850,3325,2012
32738,43830,21617,22213,12939,11250,12851,6790
32744,3588,1748,1840,752,679,1197,960
32746,40571,19511,21060,10678,9908,13086,6899
32750,22713,10970,11743,5544,4937,7114,5118
32751,19928,9597,10331,4776,4241,6242,4669
32754,11313,5704,5609,2489,2038,3828,2958
32757,23746,11294,12452,5342,4772,6263,7369
32759,2871,1487,1384,522,471,891,987
32763,21263,10032,11231,4936,5004,5421,5902
32764,3120,1568,1552,653,544,1064,859
32765,56349,27578,28771,15384,16898,16275,7792
32766,15698,7800,7898,5394,3334,5390,1580
32767,2622,1364,1258,617,550,850,605
32771,49481,23727,25754,14229,14138,13443,7671
32773,28787,14273,14514,8018,9080,7757,3932
32776,10262,5185,5077,2756,2309,3315,1882
32778,18617,9093,9524,3336,3402,4294,7585
32779,27556,13306,14250,7035,4592,9514,6415
32780,34628,16693,17935,7438,7177,9759,10254
32784,11432,5739,5693,2989,2318,3407,2718
32789,24557,11763,12794,5463,5956,7443,5695
32792,46914,23842,23072,10430,16136,11581,8767
32796,20139,9811,10328,4490,3884,6068,5697
32798,2550,1167,1383,242,232,438,1638
32801,12050,6244,5806,1138,5432,2658,2822
32803,19020,9621,9399,2869,7358,5637,3156
32804,17312,8664,8648,3212,5299,5546,3255
32805,21810,10773,11037,5987,5463,6249,4111
32806,24820,12501,12319,5091,7058,7815,4856
32807,31465,15734,15731,8006,10110,8188,5161
32808,46334,21666,24668,15141,12873,12059,6261
32809,26773,13612,13161,7641,7879,7333,3920
32810,32210,15552,16658,9021,10136,8688,4365
32811,35825,17126,18699,10262,13483,8147,3933
32812,32844,15879,16965,8070,9231,9942,5601
32814,6151,3046,3105,1431,2679,1453,588
32817,35105,18143,16962,8409,14617,7793,4286
32818,43911,20569,23342,13937,12145,11609,6220
32819,24976,12192,12784,6174,6123,7987,4692
32820,7974,4000,3974,2394,2306,2348,926
32821,21423,9458,11965,3751,11491,3613,2568
32822,53029,25709,27320,13941,17242,13096,8750
32824,37401,18154,19247,12041,11125,10114,4121
32825,53024,26017,27007,14269,17955,13785,7015
32826,29347,14752,14595,9899,12518,4194,2736
32827,6362,3104,3258,1757,2061,1787,757
32828,57881,28477,29404,17677,20353,14782,5069
32829,17822,8650,9172,5058,6509,4428,1827
32830,26,12,14,6,3,9,8
32831,2542,2466,76,193,1538,808,3
32832,13787,6808,6979,4364,4498,3725,1200
32833,9241,4648,4593,2594,2205,2998,1444
32835,39633,19509,20124,10260,14228,11180,3965
32836,16647,8216,8431,4567,4227,5397,2456
32837,51219,24837,26382,14464,15007,15278,6470
32839,50279,26544,23735,13769,20434,11513,4563
32901,24521,11820,12701,5021,6301,5475,7724
32903,12869,6423,6446,2618,2303,4110,3838
32904,26710,12874,13836,5687,5734,7522,7767
32905,22084,10365,11719,4535,5297,5830,6422
32907,41870,20297,21573,11241,9333,12438,8858
32908,10892,5310,5582,3485,2945,2996,1466
32909,30120,14716,15404,8661,7225,8911,5323
32920,9848,5117,4731,1104,2030,3321,3393
32922,14916,7198,7718,4126,3801,4119,2870
32925,1222,683,539,420,651,129,22
32926,22752,11775,10977,4950,5238,7229,5335
32927,28092,14801,13291,7499,6965,9100,4528
32931,13567,6798,6769,1707,1894,4425,5541
32934,17338,8484,8854,3944,3005,5746,4643
32935,39082,19107,19975,8285,9849,11945,9003
32937,24969,12166,12803,4977,4542,7893,7557
32940,31999,15200,16799,6994,5120,9218,10667
32948,6773,3729,3044,2372,2121,1648,632
32949,2248,1107,1141,347,287,901,713
32950,3982,2068,1914,849,515,1562,1056
32951,10673,5315,5358,1656,1147,3236,4634
32952,19881,9889,9992,4170,3091,7056,5564
32953,22754,11080,11674,5196,3966,7399,6193
32955,36374,17469,18905,8802,7788,11025,8759
32958,25366,12097,13269,4862,3861,7372,9271
32960,20037,9758,10279,4060,4699,5486,5792
32962,22716,10903,11813,5286,4825,5873,6732
32963,14911,7020,7891,1480,777,3223,9431
32966,15626,7134,8492,2175,2140,3474,7837
32967,19518,9392,10126,5094,4250,5160,5014
32968,12830,6599,6231,3618,2331,3899,2982
32970,303,144,159,78,50,97,78
32976,9079,4259,4820,573,638,1860,6008
33001,315,159,156,18,35,95,167
33004,15588,7661,7927,3049,4054,4735,3750
33009,39341,18762,20579,6513,9403,10545,12880
33010,46187,22853,23334,9343,11453,13489,11902
33012,72248,34248,38000,14503,17151,20233,20361
33013,33852,16767,17085,6764,8267,9576,9245
33014,40654,19327,21327,9643,11138,11681,8192
33015,63544,29771,33773,17753,19708,17646,8437
33016,45342,21500,23842,11815,11862,13427,8238
33018,46117,22195,23922,12447,12000,14047,7623
33019,15107,7319,7788,2310,2878,4955,4964
33020,41329,20896,20433,8576,12413,13591,6749
33021,45921,21908,24013,10023,10900,13348,11650
33023,63576,30186,33390,19297,17539,18075,8665
33024,63916,30811,33105,17534,17366,18744,10272
33025,59039,27106,31933,16867,19748,14946,7478
33026,28498,13000,15498,7053,6251,9052,6142
33027,57663,26326,31337,15709,13271,15521,13162
33028,26696,12888,13808,8439,6474,8846,2937
33029,45235,21945,23290,14631,10100,15476,5028
33030,34110,18148,15962,11043,11723,7779,3565
33031,5859,2970,2889,1408,1233,1998,1220
33032,34088,16654,17434,12269,10296,8433,3090
33033,49028,24163,24865,17322,15172,11360,5174
33034,18613,8858,9755,6560,5633,4298,2122
33035,13497,6334,7163,4518,4509,3051,1419
33036,3035,1602,1433,355,429,1058,1193
33037,11612,5971,5641,1956,2221,3892,3543
33039,122,50,72,49,35,33,5
33040,32891,18060,14831,5822,9772,10792,6505
33042,5829,3077,2752,862,1016,2188,1763
33043,4313,2312,2001,627,849,1672,1165
33050,8922,4625,4297,1548,1868,2971,2535
33051,796,394,402,58,86,216,436
33054,29061,13763,15298,9229,8316,7129,4387
33055,43194,20761,22433,11891,11460,11819,8024
33056,35059,16357,18702,11224,9671,8764,5400
33060,32154,16178,15976,7993,8520,9505,6136
33062,23948,11777,12171,2231,3480,7507,10730
33063,51019,23576,27443,11014,12655,14077,13273
33064,52969,27102,25867,12613,14566,15791,9999
33065,51921,24749,27172,15738,14450,14910,6823
33066,15760,6730,9030,2164,2601,3405,7590
33067,26458,12916,13542,8053,5763,9393,3249
33068,49824,23844,25980,15578,15660,13035,5551
33069,25700,13400,12300,4751,7602,6588,6759
33070,5344,2744,2600,994,940,2032,1378
33071,36964,17780,19184,10286,8804,12446,5428
33073,29168,14245,14923,8513,8355,8805,3495
33076,29751,14510,15241,9865,5570,10828,3488
33101,0,0,0,0,0,0,0
33109,594,313,281,77,70,161,286
33122,1,1,0,0,1,0,0
33125,52677,26699,25978,11228,14365,14652,12432
33126,46867,22040,24827,9558,13099,13219,10991
33127,28909,14343,14566,8458,8155,7537,4759
33128,7562,3967,3595,1525,2252,1903,1882
33129,13833,6489,7344,2256,4728,3774,3075
33130,26108,13310,12798,4565,10131,6386,5026
33131,14917,7665,7252,1676,8418,3378,1445
33132,11165,6885,4280,830,6332,3004,999
33133,31926,15510,16416,6045,9468,9140,7273
33134,37456,17466,19990,6910,10071,10878,9597
33135,36066,17863,18203,6969,9656,10156,9285
33136,13791,6716,7075,3534,4474,3712,2071
33137,19410,10066,9344,3419,8025,5134,2832
33138,27571,14154,13417,6094,7407,8806,5264
33139,38613,21608,17005,3398,17107,10488,7620
33140,21210,10487,10723,3979,5476,6279,5476
33141,35249,17534,17715,6389,11307,10988,6565
33142,52606,26156,26450,14894,14667,13997,9048
33143,31407,14979,16428,7054,9051,9112,6190
33144,26903,12826,14077,4865,6308,7555,8175
33145,29758,14214,15544,5739,8197,8298,7524
33146,14995,7252,7743,4724,4887,3016,2368
33147,46933,22879,24054,13658,12691,12617,7967
33149,12389,5762,6627,3666,2125,3745,2853
33150,27811,13396,14415,8229,7474,7343,4765
33154,13971,6482,7489,2877,3106,3932,4056
33155,43788,20845,22943,8884,11100,12365,11439
33156,31315,15088,16227,8556,6479,10410,5870
33157,63226,30477,32749,17848,15058,19335,10985
33158,6694,3249,3445,1935,906,2320,1533
33160,40053,18816,21237,6818,10440,10997,11798
33161,53710,25560,28150,15352,15676,14793,7889
33162,43539,20867,22672,12762,11947,12160,6670
33165,56149,26970,29179,11121,13424,15695,15909
33166,23038,12054,10984,5043,6923,7025,4047
33167,18846,8962,9884,5193,5278,5016,3359
33168,25792,12686,13106,7295,6989,7320,4188
33169,39353,18117,21236,12023,11432,10041,5857
33170,12253,5858,6395,4196,3302,3110,1645
33172,37664,17639,20025,8233,11274,10839,7318
33173,33141,15158,17983,7228,8623,9553,7737
33174,32524,15051,17473,6732,9240,8447,8105
33175,53206,25230,27976,11738,13106,16040,12322
33176,50170,23539,26631,12340,11903,15512,10415
33177,53191,26615,26576,15016,14610,15873,7692
33178,39489,18934,20555,12494,12169,11095,3731
33179,41332,19045,22287,10263,11049,11955,8065
33180,30840,14363,16477,5975,7836,8002,9027
33181,18413,8809,9604,4344,6196,4932,2941
33182,16929,9612,7317,3687,5419,5277,2546
33183,35949,16666,19283,8602,9471,10840,7036
33184,21075,10003,11072,4515,5165,6428,4967
33185,27189,12937,14252,8076,7308,8028,3777
33186,67137,31475,35662,17004,19065,20160,10908
33187,16315,8141,8174,4574,3948,5179,2614
33189,23828,11368,12460,6769,6618,6687,3754
33190,11593,5378,6215,3845,4008,2725,1015
33193,46044,21649,24395,12841,12717,13929,6557
33194,7742,4601,3141,1900,2687,2492,663
33196,43620,20815,22805,12644,11980,13374,5622
33301,14586,8558,6028,1543,5621,4617,2805
33304,17724,10042,7682,2386,5642,5976,3720
33305,11927,7176,4751,1303,2566,5025,3033
33306,3397,1859,1538,405,694,1325,973
33308,28217,14236,13981,3070,4751,8726,11670
33309,33705,17335,16370,8486,9492,10880,4847
33311,63786,31079,32707,19454,16600,17154,10578
33312,49343,25304,24039,12159,14276,14947,7961
33313,56039,25917,30122,16609,15895,14660,8875
33314,21885,10727,11158,5529,7496,5925,2935
33315,12153,6577,5576,2084,3723,4062,2284
33316,10044,5368,4676,1180,2269,3317,3278
33317,35372,17502,17870,8977,8855,11035,6505
33319,44420,19967,24453,9657,11493,11196,12074
33321,44327,19634,24693,8168,10046,10977,15136
33322,37858,17062,20796,6869,7928,9927,13134
33323,18929,9290,9639,4983,5225,6400,2321
33324,42847,19991,22856,9143,12795,11893,9016
33325,27570,13518,14052,7793,7004,9164,3609
33326,31257,14975,16282,8997,7103,10635,4522
33327,22658,11185,11473,8592,4111,8029,1926
33328,27415,13328,14087,7321,6872,8979,4243
33330,14107,6839,7268,4286,2454,5443,1924
33331,23204,11373,11831,7206,4378,8463,3157
33332,11199,5115,6084,3607,2372,3972,1248
33334,28749,15745,13004,6084,8321,9892,4452
33351,32890,15313,17577,9190,9807,9495,4398
33401,24879,11736,13143,5048,8115,5813,5903
33403,12042,5802,6240,3195,3323,3572,1952
33404,27489,13185,14304,7301,6256,7131,6801
33405,19155,9876,9279,4598,5383,5522,3652
33406,26312,13989,12323,6749,7998,7569,3996
33407,29659,14713,14946,8528,8777,7979,4375
33408,16921,8276,8645,2351,2600,4904,7066
33409,29140,14277,14863,7877,10383,6896,3984
33410,32570,15702,16868,6348,7949,9497,8776
33411,65245,31299,33946,17019,15831,19209,13186
33412,14414,7215,7199,3410,2529,4879,3596
33413,15162,7364,7798,4416,4579,3983,2184
33414,53718,25813,27905,16197,11496,17866,8159
33415,44963,21688,23275,12614,12919,11354,8076
33417,29156,13475,15681,5876,6764,6166,10350
33418,36017,16991,19026,6625,6684,10491,12217
33426,20082,9386,10696,3662,5953,4937,5530
33428,38548,18602,19946,10047,8576,12221,7704
33430,21427,11212,10215,7248,5791,5524,2864
33431,18290,8996,9294,4788,4666,4624,4212
33432,18715,9265,9450,2810,4304,5145,6456
33433,41722,18886,22836,7714,8421,10589,14998
33434,19260,8511,10749,2656,2090,4292,10222
33435,32104,15532,16572,7216,7460,8706,8722
33436,41896,19329,22567,8224,9351,10363,13958
33437,35938,16210,19728,3763,4388,5180,22607
33438,459,236,223,127,104,134,94
33440,19743,10145,9598,6357,5213,5027,3146
33441,26838,13272,13566,5497,7250,7881,6210
33442,28075,12669,15406,4356,5946,6895,10878
33444,20221,10066,10155,4770,6002,5865,3584
33445,29754,13906,15848,5108,6477,7527,10642
33446,22088,9807,12281,1834,1423,3294,15537
33449,10817,5331,5486,3179,1784,3300,2554
33455,19980,9709,10271,3040,2660,5382,8898
33458,49396,25035,24361,12616,12655,15610,8515
33460,30790,16767,14023,7832,10269,8445,4244
33461,40748,20634,20114,11124,12678,9984,6962
33462,30879,15180,15699,7363,7389,8733,7394
33463,53766,26238,27528,16861,14599,14114,8192
33467,48808,23177,25631,11037,7621,13571,16579
33469,14449,6962,7487,2489,2008,4263,5689
33470,26551,13577,12974,7800,5682,9738,3331
33471,6818,4206,2612,1238,1933,1871,1776
33472,19100,8998,10102,3382,2555,4710,8453
33473,6265,3163,3102,2426,1709,1738,392
33476,7669,3782,3887,2723,1942,1815,1189
33477,13074,6074,7000,941,991,3050,8092
33478,12704,6426,6278,3166,2120,5178,2240
33480,9549,4300,5249,655,592,1906,6396
33483,12093,5963,6130,1453,2303,3582,4755
33484,23443,9982,13461,1512,2321,3836,15774
33486,21720,10595,11125,5154,4939,7087,4540
33487,16421,7948,8473,2363,2731,4739,6588
33493,4926,3374,1552,1103,1785,1507,531
33496,20969,9820,11149,3826,2808,5323,9012
33498,14557,7056,7501,3960,2118,4931,3548
33503,108,58,50,38,32,25,13
33510,27610,13112,14498,7746,7601,7920,4343
33511,52003,24839,27164,13629,16151,14409,7814
33513,12086,7024,5062,2292,2985,3582,3227
33514,1811,928,883,575,430,464,342
33521,599,277,322,160,134,186,119
33523,18313,9019,9294,5229,4117,5013,3954
33525,18439,8991,9448,4519,4026,4572,5322
33527,15203,8106,7097,4709,4254,3979,2261
33534,12839,6464,6375,4334,4135,3093,1277
33538,4789,2362,2427,997,849,1289,1654
33540,8752,4286,4466,1801,1595,2257,3099
33541,19759,9839,9920,2879,2805,4422,9653
33542,20824,9743,11081,3591,3561,4530,9142
33543,21898,10538,11360,6297,5689,6231,3681
33544,22800,11198,11602,6875,6099,6847,2979
33545,13996,6786,7210,4705,4358,3497,1436
33547,19813,9737,10076,7309,4081,6137,2286
33548,5807,2902,2905,1381,1010,2092,1324
33549,16132,7892,8240,3927,3360,5600,3245
33556,22015,10958,11057,6185,4030,8082,3718
33558,20064,9830,10234,5518,4248,6869,3429
33559,15427,7537,7890,3777,5595,4026,2029
33563,25488,12338,13150,7969,7225,6031,4263
33565,17975,8959,9016,4624,3810,5242,4299
33566,19522,9666,9856,5916,4926,5317,3363
33567,11505,5899,5606,3705,3122,2928,1750
33569,23074,11332,11742,6848,5486,7174,3566
33570,20758,10454,10304,6221,5630,4670,4237
33572,14117,6975,7142,3207,3089,4420,3401
33573,19172,8139,11033,531,644,1659,16338
33576,3784,1836,1948,545,497,903,1839
33578,36693,17345,19348,10631,12450,9614,3998
33579,25723,12263,13460,8705,7975,6643,2400
33584,25392,12545,12847,7136,6544,7648,4064
33585,1058,534,524,232,216,308,302
33592,10091,5070,5021,2545,2311,3052,2183
33594,32677,15763,16914,9348,7564,9694,6071
33596,29283,14347,14936,8656,5388,10468,4771
33597,8026,4000,4026,2045,1622,2294,2065
33598,13665,7187,6478,4771,4015,2953,1926
33602,11515,6092,5423,1891,4818,3118,1688
33603,19100,9421,9679,5070,5445,5448,3137
33604,35485,17443,18042,9833,9887,10265,5500
33605,17073,8469,8604,4793,4781,4406,3093
33606,17746,8632,9114,4104,6896,4307,2439
33607,23541,11198,12343,5944,7168,5600,4829
33609,15999,7977,8022,3067,5200,4631,3101
33610,39222,18366,20856,12596,10987,9668,5971
33611,29478,14566,14912,5665,8694,8981,6138
33612,44601,21742,22859,12577,13764,11453,6807
33613,31990,15615,16375,6656,13467,6722,5145
33614,46449,22763,23686,11483,15280,12287,7399
33615,43453,21302,22151,10575,12986,12624,7268
33616,13560,6807,6753,3476,4662,3730,1692
33617,41443,19756,21687,11036,13847,10336,6224
33618,25570,11991,13579,5427,6294,7820,6029
33619,34581,18472,16109,9915,11374,8863,4429
33620,5158,2294,2864,3369,1780,9,0
33621,1643,879,764,680,750,167,46
33624,37457,17845,19612,9057,10066,11917,6417
33625,24645,11869,12776,6709,6724,7596,3616
33626,27557,13243,14314,8454,7367,8434,3302
33629,23638,11362,12276,5737,5508,7643,4750
33634,20225,9824,10401,5233,5950,5648,3394
33635,15741,7619,8122,3811,4647,4703,2580
33637,15351,7323,8028,3730,6083,3711,1827
33647,55034,26490,28544,16335,17770,15280,5649
33701,15014,7623,7391,1892,4588,4554,3980
33702,29664,14343,15321,5835,7422,9239,7168
33703,23680,11513,12167,5064,5240,7821,5555
33704,16098,7760,8338,3337,3793,5739,3229
33705,26435,12606,13829,6639,6055,7888,5853
33706,15901,7901,8000,1622,2151,5468,6660
33707,24599,11406,13193,3589,4160,7432,9418
33708,15447,7505,7942,1793,1957,5037,6660
33709,26023,12476,13547,5094,5356,7296,8277
33710,32780,15838,16942,7013,7307,10588,7872
33711,19162,8762,10400,5426,4532,4791,4413
33712,25066,11417,13649,7300,6062,7159,4545
33713,29812,15075,14737,6652,8296,9825,5039
33714,18531,9314,9217,4185,4466,5903,3977
33715,7407,3540,3867,615,652,2099,4041
33716,15424,7251,8173,2533,7555,3485,1851
33744,148,137,11,2,14,75,57
33755,26146,12789,13357,6871,7312,7561,4402
33756,31275,15140,16135,6864,6845,9093,8473
33759,17820,8619,9201,4006,4741,4707,4366
33760,15133,7700,7433,3557,4931,4312,2333
33761,18167,8342,9825,2859,2869,5212,7227
33762,8499,5172,3327,1052,3209,2591,1647
33763,17887,7973,9914,2500,3365,3997,8025
33764,24045,11590,12455,4226,4704,7071,8044
33765,13275,6509,6766,2782,3918,3778,2797
33767,8007,3953,4054,585,781,2264,4377
33770,25281,12103,13178,4900,5593,7518,7270
33771,29839,13841,15998,4739,6346,7700,11054
33772,22981,10847,12134,4324,4194,7145,7318
33773,16826,8226,8600,3468,3644,5346,4368
33774,17712,8358,9354,3485,3139,5103,5985
33776,12402,5863,6539,2627,1877,4144,3754
33777,17140,8128,9012,3977,3365,5194,4604
33778,14263,6779,7484,2688,2500,4185,4890
33781,25922,12804,13118,6174,6734,7700,5314
33782,20850,9785,11065,4172,4378,5711,6589
33785,5533,2753,2780,574,852,2051,2056
33786,1669,807,862,229,174,522,744
33801,33741,16392,17349,9230,9531,8057,6923
33803,27094,12740,14354,6003,6763,6789,7539
33805,23153,10957,12196,6899,6081,5502,4671
33809,28929,13998,14931,6990,6467,8035,7437
33810,44254,21477,22777,11542,10584,11253,10875
33811,20980,10328,10652,5613,5413,6090,3864
33812,13166,6498,6668,4046,3253,4007,1860
33813,31698,15321,16377,8352,6444,9970,6932
33815,14267,7024,7243,3844,3314,3301,3808
33823,28874,14181,14693,7666,6642,7928,6638
33825,24942,12897,12045,5653,5398,5880,8011
33827,3036,1563,1473,834,768,816,618
33830,27542,13222,14320,8182,7063,7127,5170
33834,7448,4371,3077,2142,2480,1721,1105
33837,20234,10082,10152,5126,5054,5041,5013
33838,3515,1736,1779,1006,825,847,837
33839,2756,1305,1451,818,722,726,490
33841,8722,4427,4295,2589,2128,2104,1901
33843,11093,6298,4795,2630,2789,2562,3112
33844,33804,16769,17035,9298,8031,7603,8872
33847,227,118,109,65,43,67,52
33848,851,493,358,267,177,268,139
33849,856,450,406,256,220,238,142
33850,7519,3701,3818,1759,1615,1887,2258
33851,907,424,483,240,198,246,223
33852,21790,10965,10825,4413,3823,4918,8636
33853,11161,5353,5808,3246,2638,2705,2572
33854,194,96,98,16,15,40,123
33855,43,18,25,4,5,15,19
33856,487,260,227,0,0,68,419
33857,1728,915,813,274,271,479,704
33859,10582,5127,5455,2397,2043,2204,3938
33860,22886,11322,11564,7132,6239,5425,4090
33865,786,415,371,211,174,221,180
33867,106,49,57,1,2,13,90
33868,11720,6796,4924,2466,2846,3753,2655
33870,20601,9993,10608,4387,3899,4646,7669
33872,14158,6711,7447,2195,2032,2697,7234
33873,14742,7633,7109,4787,4038,3370,2547
33875,11108,5305,5803,2196,1782,2762,4368
33876,4968,2484,2484,929,775,1281,1983
33877,276,137,139,67,61,71,77
33880,37798,18573,19225,11310,9861,9701,6926
33881,29345,13919,15426,6745,5658,6991,9951
33884,28763,13567,15196,6486,6054,7451,8772
33890,5060,2609,2451,1575,1146,1263,1076
33896,6633,3305,3328,1646,2042,1972,973
33897,14117,6865,7252,3523,3636,3474,3484
33898,15355,7531,7824,3117,2610,4193,5435
33901,19500,9701,9799,4394,5020,5518,4568
33903,20776,10078,10698,2730,2614,4983,10449
33904,30613,14845,15768,4939,4835,9064,11775
33905,31203,16608,14595,8004,8825,7961,6413
33907,22138,10803,11335,4536,6804,5143,5655
33908,38251,18105,20146,4894,5460,8620,19277
33909,23119,11349,11770,7166,6521,6260,3172
33912,15392,7395,7997,2302,2247,3781,7062
33913,17103,8335,8768,4219,4026,4444,4414
33914,35848,17426,18422,8254,7004,11200,9390
33916,20134,9786,10348,6477,6291,4626,2740
33917,28666,14040,14626,4392,3744,7514,13016
33919,27837,12794,15043,4197,5098,7243,11299
33920,4947,2499,2448,1134,846,1540,1427
33921,1720,833,887,87,150,283,1200
33922,4055,2042,2013,670,599,1158,1628
33924,761,374,387,43,174,176,368
33928,20830,10037,10793,2980,3889,4472,9489
33930,1075,592,483,401,266,265,143
33931,10005,4978,5027,560,814,2436,6195
33935,20383,11066,9317,6239,5825,4623,3696
33936,18994,9019,9975,4402,3801,4999,5792
33944,298,143,155,75,46,82,95
33945,57,28,29,2,2,20,33
33946,2125,1028,1097,192,133,518,1282
33947,8180,3976,4204,1085,811,2081,4203
33948,15958,7628,8330,2951,2551,4469,5987
33950,20699,9912,10787,2127,1887,4198,12487
33952,28382,13546,14836,5445,5193,7766,9978
33953,5522,2695,2827,710,628,1417,2767
33954,9290,4491,4799,2131,1714,2786,2659
33955,10060,5559,4501,1238,1781,2543,4498
33956,3776,1882,1894,244,248,1007,2277
33957,6469,3061,3408,554,353,1416,4146
33960,854,449,405,165,133,298,258
33965,1648,719,929,1235,412,1,0
33966,8251,3976,4275,1804,1890,2262,2295
33967,22799,11663,11136,6197,6584,6576,3442
33971,19730,9731,9999,7028,5935,4889,1878
33972,10880,5419,5461,3285,2670,3069,1856
33973,10798,5361,5437,4203,3758,1861,976
33974,11982,5964,6018,4381,3701,2727,1173
33976,12534,6260,6274,4722,4078,2897,837
33980,10322,4776,5546,1466,1371,2056,5429
33981,9534,4687,4847,1671,1340,2771,3752
33982,9176,4823,4353,1587,1625,2632,3332
33983,13954,6589,7365,2856,2340,3580,5178
33990,28173,13632,14541,6736,6145,8531,6761
33991,18010,8823,9187,5095,4013,5240,3662
33993,20628,10354,10274,6321,5521,5652,3134
34101,10,6,4,2,2,1,5
34102,10460,4883,5577,1451,1148,2696,5165
34103,12150,5735,6415,1597,1428,2750,6375
34104,23691,11394,12297,4666,5165,5744,8116
34105,13933,6586,7347,2262,2592,3227,5852
34108,16874,8072,8802,1971,2193,3713,8997
34109,23338,10843,12495,4688,4442,6121,8087
34110,20762,9729,11033,2896,2675,4832,10359
34112,27002,13401,13601,3886,5116,6045,11955
34113,17971,8956,9015,4159,3816,4066,5930
34114,13653,6760,6893,2418,2257,3035,5943
34116,30005,15496,14509,9471,9352,7859,3323
34117,14250,7309,6941,4146,3348,4843,1913
34119,25756,12324,13432,5752,4309,6932,8763
34120,26147,13139,13008,7930,6212,7801,4204
34134,14112,6774,7338,966,1280,2938,8928
34135,37315,19019,18296,6442,7891,8371,14611
34137,227,107,120,55,43,87,42
34138,359,195,164,69,61,95,134
34139,561,295,266,90,103,154,214
34140,273,145,128,25,35,125,88
34141,232,141,91,69,50,67,46
34142,27304,15535,11769,9732,9801,5511,2260
34145,16407,8033,8374,1696,1526,3698,9487
34201,3682,1744,1938,434,488,761,1999
34202,19816,9709,10107,5135,3412,6294,4975
34203,34862,16865,17997,8618,7467,8322,10455
34205,29656,14276,15380,7241,7068,7949,7398
34207,29728,14261,15467,6209,6721,7217,9581
34208,33121,16079,17042,10200,8562,8239,6120
34209,31816,14798,17018,5734,5232,8768,12082
34210,15916,7363,8553,2719,3151,3638,6408
34211,2775,1389,1386,522,311,837,1105
34212,15146,7418,7728,4204,2956,4821,3165
34215,768,390,378,70,58,233,407
34216,1503,721,782,140,121,451,791
34217,5007,2428,2579,520,557,1397,2533
34219,17135,8436,8699,4225,3666,4874,4370
34221,39457,19832,19625,9518,8530,10090,11319
34222,11952,5644,6308,2235,2107,2357,5253
34223,16875,8029,8846,1727,1518,4130,9500
34224,15394,7410,7984,1969,1708,3940,7777
34228,6888,3188,3700,223,175,992,5498
34229,7192,3494,3698,1120,607,2121,3344
34231,30268,14325,15943,5043,5692,8781,10752
34232,30969,14969,16000,6514,7019,9394,8042
34233,16653,7663,8990,3197,2779,4725,5952
34234,19788,9474,10314,4792,4885,5192,4919
34235,13640,6303,7337,2230,2351,3297,5762
34236,12394,5860,6534,1280,2124,2951,6039
34237,16304,8272,8032,3600,5035,4401,3268
34238,17500,7892,9608,2125,1954,3978,9443
34239,15038,7312,7726,2826,3021,4728,4463
34240,11501,5713,5788,2806,1586,3785,3324
34241,13590,6693,6897,3000,1998,4275,4317
34242,8865,4283,4582,925,738,2306,4896
34243,26115,12404,13711,4287,5509,7125,9194
34251,6351,3260,3091,1798,1498,2196,859
34266,31055,17821,13234,8360,8965,7593,6137
34268,220,149,71,69,85,36,30
34269,3615,1762,1853,447,358,783,2027
34275,16245,7920,8325,2090,1724,4511,7920
34285,17599,7897,9702,1147,1125,3174,12153
34286,17970,8889,9081,5397,4363,5145,3065
34287,23859,11233,12626,4106,3668,5065,11020
34288,10856,5382,5474,3162,2689,2955,2050
34289,2199,1042,1157,627,533,438,601
34291,7125,3583,3542,2110,1834,2068,1113
34292,13516,6184,7332,1321,1194,2531,8470
34293,33001,15644,17357,4757,4478,8538,15228
34420,16287,7859,8428,4040,3568,4447,4232
34428,9109,4542,4567,1827,1538,2838,2906
34429,8563,4112,4451,1357,1142,2399,3665
34431,7815,3772,4043,1449,1219,2126,3021
34432,12273,5951,6322,2041,1672,3066,5494
34433,6647,3271,3376,1395,1142,2038,2072
34434,8191,3955,4236,2066,1684,1990,2451
34436,7938,3936,4002,1384,1099,2315,3140
34442,14568,7187,7381,2128,1706,3561,7173
34445,44,23,21,8,13,7,16
34446,16326,7921,8405,2336,2026,3974,7990
34448,10797,5313,5484,1790,1661,3061,4285
34449,2809,1407,1402,473,401,887,1048
34450,10293,4907,5386,1629,1376,2668,4620
34452,11919,5609,6310,2533,2142,3195,4049
34453,10112,4769,5343,2110,1737,2474,3791
34461,10562,5254,5308,1738,1654,2736,4434
34465,15870,7416,8454,2703,2202,3792,7173
34470,17838,8359,9479,4091,4159,4592,4996
34471,25152,11656,13496,6258,5042,7219,6633
34472,25968,12296,13672,7570,6108,6093,6197
34473,17029,8065,8964,4923,3796,4156,4154
34474,16062,7681,8381,3785,5019,3550,3708
34475,12177,6348,5829,3368,3499,3348,1962
34476,20862,9876,10986,3586,2892,4512,9872
34479,13032,6188,6844,3432,2977,3667,2956
34480,19068,9237,9831,5747,4204,5695,3422
34481,17536,8038,9498,1586,1371,2940,11639
34482,22500,10458,12042,4063,5917,6398,6122
34484,3069,1490,1579,783,680,859,747
34488,10291,5132,5159,2058,1790,2938,3505
34491,27454,13283,14171,4299,3856,5868,13431
34498,513,266,247,69,65,129,250
34601,22336,10649,11687,4949,4145,6243,6999
34602,7346,3638,3708,1797,1458,2223,1868
34604,10003,4903,5100,2281,2672,2881,2169
34606,26208,12209,13999,5015,4494,5715,10984
34607,8133,3919,4214,1390,1091,2302,3350
34608,31099,14606,16493,7320,6316,8127,9336
34609,37129,17819,19310,9082,7163,9870,11014
34610,12907,6525,6382,3163,2724,4343,2677
34613,17814,8457,9357,2675,2120,4268,8751
34614,6692,3331,3361,1928,1445,1964,1355
34637,6297,3404,2893,1356,1686,1759,1496
34638,20048,9929,10119,6509,6142,5275,2122
34639,24092,11906,12186,6951,5571,7784,3786
34652,24147,11761,12386,4748,4948,6946,7505
34653,30756,14542,16214,6272,6561,8187,9736
34654,21716,10608,11108,5149,4352,6679,5536
34655,38464,18309,20155,8660,7028,10599,12177
34661,297,140,157,65,49,95,88
34667,32144,15470,16674,5053,4769,8169,14153
34668,42619,20378,22241,9717,9626,10885,12391
34669,12648,6273,6375,2887,2624,3761,3376
34677,20842,9957,10885,4843,4474,6575,4950
34679,99,45,54,19,22,27,31
34681,1294,655,639,261,198,529,306
34683,31268,15049,16219,6862,5827,11349,7230
34684,25847,11745,14102,4395,4598,7019,9835
34685,17286,8277,9009,4174,2921,5989,4202
34688,7274,3509,3765,1629,1021,2496,2128
34689,26132,12556,13576,5354,4762,7744,8272
34690,13137,6387,6750,2860,3099,3605,3573
34691,21079,10215,10864,4779,4860,5832,5608
34695,17496,8330,9166,3632,2987,5990,4887
34698,37240,17383,19857,6213,6609,10676,13742
34705,2500,1266,1234,692,517,739,552
34711,51847,25008,26839,14064,11354,14700,11729
34714,14685,7103,7582,4185,4327,3761,2412
34715,15455,8132,7323,4196,3975,4740,2544
34731,10815,5193,5622,2436,2050,2947,3382
34734,3835,1829,2006,1160,859,1329,487
34736,13961,6986,6975,4158,3434,3906,2463
34737,2523,1289,1234,541,402,835,745
34739,793,405,388,185,159,213,236
34741,40828,19842,20986,11488,13309,10349,5682
34743,33632,16139,17493,10156,9197,8864,5415
34744,44142,22200,21942,12416,12378,12503,6845
34746,35022,17318,17704,9967,9016,9786,6253
34747,13692,6631,7061,3690,3704,4294,2004
34748,38246,17798,20448,6340,5784,6928,19194
34753,5353,2751,2602,1953,1636,1219,545
34756,3006,1518,1488,716,590,1081,619
34758,30879,14895,15984,10551,7925,8018,4385
34759,30170,14489,15681,9190,7266,6621,7093
34760,875,402,473,240,180,277,178
34761,37500,18331,19169,11279,10285,11107,4829
34762,622,310,312,132,128,194,168
34769,21399,10172,11227,5400,5396,5898,4705
34771,14280,7259,7021,3908,3069,4702,2601
34772,22770,11119,11651,7051,5644,6617,3458
34773,2983,1540,1443,962,770,880,371
34785,17406,11187,6219,2404,5495,5092,4415
34786,28092,13889,14203,8673,6979,8981,3459
34787,46083,22447,23636,13556,12862,12849,6816
34788,17519,8361,9158,2858,2471,4225,7965
34797,1293,626,667,224,170,404,495
34945,5514,3259,2255,1080,1769,1566,1099
34946,6025,2921,3104,1551,1296,1673,1505
34947,12186,5814,6372,4273,3429,2881,1603
34949,7103,3492,3611,507,770,1776,4050
34950,15436,7897,7539,4505,4001,4203,2727
34951,14115,6772,7343,2483,2363,3532,5737
34952,38285,18210,20075,7012,7404,9507,14362
34953,61494,30362,31132,19370,16055,17926,8143
34956,9874,6162,3712,2718,3296,2473,1387
34957,22257,10730,11527,3283,3075,6166,9733
34972,20180,11492,8688,6097,5910,5308,2865
34974,23661,11925,11736,5355,4791,5931,7584
34981,4239,2108,2131,1195,1036,1145,863
34982,24544,12063,12481,6425,5686,6428,6005
34983,38480,18880,19600,10391,8993,11111,7985
34984,13764,6733,7031,3549,3039,4229,2947
34986,23297,10983,12314,4597,3982,5506,9212
34987,6118,2975,3143,1574,1404,1816,1324
34990,27707,13203,14504,6200,3357,8674,9476
34994,15967,7845,8122,2989,3683,4291,5004
34996,10649,4915,5734,1353,1091,2526,5679
34997,40405,19977,20428,8321,7971,11078,13035
30002,5861,2739,3122,1412,1642,1878,929
30004,53033,26005,27028,16701,13204,17202,5926
30005,34442,16926,17516,12018,7633,12031,2760
30008,29822,15259,14563,8929,10132,7513,3248
30009,13722,6521,7201,3517,3779,4042,2384
30011,14402,7265,7137,4585,3969,4218,1630
30012,27258,13122,14136,8262,7646,6975,4375
30013,25183,11729,13454,7924,6419,7202,3638
30014,35037,16878,18159,10531,8957,9488,6061
30016,51140,24136,27004,17530,14196,13597,5817
30017,20160,9748,10412,6398,4467,6621,2674
30019,40447,19752,20695,14279,9172,12690,4306
30021,21989,10769,11220,7206,8085,5066,1632
30022,64359,31161,33198,20145,14562,22473,7179
30024,64614,31764,32850,22151,13992,22122,6349
30025,9270,4519,4751,2610,2115,2563,1982
30028,22182,11032,11150,7167,5535,6593,2887
30030,26473,11712,14761,6080,8232,7741,4420
30032,47222,23582,23640,11896,14545,13061,7720
30033,30763,14339,16424,5955,11261,7824,5723
30034,43113,19440,23673,12400,11378,12614,6721
30035,20396,9229,11167,6095,5815,5714,2772
30038,37233,16597,20636,11670,11075,10835,3653
30039,41517,19634,21883,13759,11005,12365,4388
30040,54653,26982,27671,17188,14144,15682,7639
30041,52749,26238,26511,16860,11193,16855,7841
30043,80241,40225,40016,24196,22732,25160,8153
30044,79701,38957,40744,25979,24549,21593,7580
30045,34402,16518,17884,12078,9244,9767,3313
30046,34523,16584,17939,11264,10458,8689,4112
30047,59660,29436,30224,17447,14244,18611,9358
30052,59451,28724,30727,19314,14866,17164,8107
30054,11985,5819,6166,3540,2720,3348,2377
30055,3018,1524,1494,779,664,945,630
30056,2500,1281,1219,707,572,803,418
30058,52945,23649,29296,17709,14823,15487,4926
30060,34562,17717,16845,10721,11702,7767,4372
30062,62136,30329,31807,17486,14045,20157,10448
30064,46076,22206,23870,12677,9978,14825,8596
30066,52936,25966,26970,14185,12870,17249,8632
30067,45182,22148,23034,11520,16796,11391,5475
30068,31595,15457,16138,8549,5598,10572,6876
30070,342,156,186,86,83,96,77
30071,23005,12120,10885,7338,8499,5358,1810
30072,730,287,443,121,209,296,104
30075,52573,25722,26851,14393,10600,18012,9568
30076,42678,21341,21337,12022,12920,11547,6189
30078,33057,15819,17238,9910,7032,10388,5727
30079,2960,1376,1584,914,947,750,349
30080,49905,24264,25641,11388,21279,12015,5223
30082,25905,12234,13671,6485,8453,6933,4034
30083,50384,23591,26793,15129,15400,13960,5895
30084,35921,17728,18193,9049,10693,9955,6224
30087,36761,17371,19390,10194,7768,12186,6613
30088,25257,11655,13602,7495,6763,7941,3058
30092,31704,15468,16236,9282,9706,9155,3561
30093,53351,27999,25352,17960,21866,10720,2805
30094,31244,14879,16365,8988,6744,10156,5356
30096,62265,30486,31779,16951,21522,17218,6574
30097,41715,20374,21341,13369,8605,15076,4665
30101,54373,26602,27771,17758,13105,17196,6314
30102,37470,18898,18572,11020,10611,11231,4608
30103,14781,7270,7511,4481,3890,4017,2393
30104,4708,2312,2396,1340,1191,1384,793
30105,2294,1114,1180,564,439,736,555
30106,20300,9216,11084,5880,5786,5498,3136
30107,12908,6428,6480,3668,2849,4086,2305
30108,7256,3528,3728,1895,1587,2176,1598
30110,13349,6506,6843,3858,3325,3715,2451
30113,6218,3051,3167,1604,1423,1836,1355
30114,49774,24635,25139,15728,13839,12985,7222
30115,35672,17844,17828,10904,8893,10655,5220
30116,23156,11624,11532,6922,6392,6493,3349
30117,34296,16520,17776,9252,11325,7764,5955
30118,2373,973,1400,1585,784,4,0
30120,38085,18398,19687,11670,9813,10432,6170
30121,22078,10883,11195,6105,6464,6075,3434
30122,21561,10328,11233,6289,6745,5870,2657
30124,2978,1440,1538,775,536,956,711
30125,24352,12156,12196,7266,6328,6075,4683
30126,37088,17940,19148,10925,11594,10457,4112
30127,60347,28942,31405,19469,13535,19736,7607
30132,34215,16624,17591,11072,9843,8845,4455
30134,43356,20851,22505,14234,12566,11690,4866
30135,61912,29760,32152,19633,15506,18539,8234
30137,1650,844,806,465,410,483,292
30139,3845,1927,1918,1020,913,1119,793
30141,22457,10747,11710,7095,6118,6573,2671
30143,21145,10300,10845,4925,4367,6083,5770
30144,52252,25117,27135,15158,18436,13132,5526
30145,8378,4243,4135,2612,1999,2568,1199
30147,4365,2144,2221,1196,1034,1282,853
30148,453,234,219,95,97,152,109
30149,1569,464,1105,961,573,33,2
30152,40393,19484,20909,12595,9872,13040,4886
30153,18411,9001,9410,5421,4833,4987,3170
30157,45123,22205,22918,14635,12721,12962,4805
30161,35058,17215,17843,9080,8752,9705,7521
30164,16,8,8,3,3,8,2
30165,39905,19183,20722,11455,10714,10115,7621
30168,24241,11358,12883,8295,8016,6013,1917
30170,2994,1476,1518,838,693,857,606
30171,3491,1791,1700,1027,833,1014,617
30173,6221,3043,3178,1774,1525,1778,1144
30175,6074,3067,3007,1623,1451,1764,1236
30176,7050,3414,3636,2021,1695,1879,1455
30177,1049,517,532,284,303,247,215
30178,3468,1730,1738,995,816,1132,525
30179,16807,8276,8531,5188,4716,4595,2308
30180,34274,16578,17696,10680,9582,8984,5028
30182,2666,1351,1315,696,630,800,540
30183,5282,2594,2688,1356,1151,1503,1272
30184,6847,3494,3353,1842,1679,2120,1206
30185,3892,1972,1920,1033,882,1214,763
30187,8740,4351,4389,2496,1757,2898,1589
30188,52380,25482,26898,14671,14918,15402,7389
30189,36859,18097,18762,11576,8734,12015,4534
30204,13493,6431,7062,3912,3402,3564,2615
30205,3061,1570,1491,799,546,1098,618
30206,2958,1442,1516,956,641,851,510
30213,29384,13581,15803,9508,8936,7648,3292
30214,28913,13855,15058,7492,5652,9015,6754
30215,33665,16168,17497,10210,5534,12016,5905
30216,2159,1084,1075,615,496,650,398
30217,9433,4693,4740,2691,2144,2767,1831
30218,1974,1002,972,499,457,620,398
30220,5533,2720,2813,1745,1546,1476,766
30222,4042,1946,2096,1081,897,1188,876
30223,36769,17689,19080,10550,9259,10016,6944
30224,25197,12303,12894,6895,6617,6674,5011
30228,38569,18395,20174,12915,10640,10684,4330
30230,9103,4403,4700,2629,2124,2618,1732
30233,23218,12293,10925,5766,6428,6636,4388
30234,1934,948,986,558,522,557,297
30236,46434,22938,23496,13411,14149,12466,6408
30238,34713,16131,18582,11932,9555,9618,3608
30240,30014,14183,15831,8818,7394,8066,5736
30241,23176,11390,11786,6904,6370,6242,3660
30248,23249,11353,11896,7822,6114,6606,2707
30250,679,617,62,69,411,179,20
30251,2342,1143,1199,686,581,658,417
30252,41428,20106,21322,13640,9647,12529,5612
30253,49380,23317,26063,16168,13727,13468,6017
30256,2826,1439,1387,805,644,829,548
30257,4138,2059,2079,1054,969,1246,869
30258,2622,1303,1319,764,588,740,530
30259,3041,1526,1515,826,647,955,613
30260,23244,10999,12245,6944,7254,5696,3350
30263,53008,25812,27196,15291,14575,14444,8698
30265,31713,15241,16472,9728,8192,9186,4607
30268,9090,4413,4677,2729,2276,2464,1621
30269,35069,16936,18133,10455,6132,12080,6402
30273,14709,6862,7847,4680,4195,4356,1478
30274,31893,14821,17072,10473,9381,8838,3201
30275,19,8,11,1,3,5,10
30276,13866,6844,7022,4179,3541,4089,2057
30277,20270,10090,10180,6118,3979,6883,3290
30281,66140,31553,34587,20230,17910,19534,8466
30284,55,28,27,12,14,19,10
30285,707,373,334,186,167,216,138
30286,23490,11210,12280,6257,5538,6486,5209
30288,8929,4297,4632,2848,2481,2594,1006
30289,82,38,44,14,17,16,35
30290,8286,4056,4230,2431,1501,2936,1418
30291,21010,9110,11900,7221,6705,4745,2339
30292,5943,2835,3108,1733,1535,1725,950
30293,2981,1466,1515,659,601,885,836
30294,39865,18743,21122,12686,10823,12219,4137
30295,4159,2038,2121,1199,968,1223,769
30296,25840,12106,13734,8302,7317,7375,2846
30297,27188,14128,13060,8787,9096,6279,3026
30303,5934,3295,2639,2088,2272,1386,188
30305,22999,11065,11934,3761,8409,5791,5038
30306,22246,11329,10917,3764,9408,6485,2589
30307,18004,8931,9073,3685,7111,5155,2053
30308,15413,9001,6412,1330,8537,3995,1551
30309,21845,11576,10269,2124,11544,5619,2558
30310,26912,12925,13987,7404,7574,7326,4608
30311,32218,14194,18024,9160,8199,8089,6770
30312,19360,9635,9725,3714,9013,4424,2209
30313,9495,6173,3322,3049,4834,1370,242
30314,22020,10476,11544,7074,7024,4817,3105
30315,33857,17027,16830,10267,11169,8073,4348
30316,31110,14952,16158,6752,12184,7970,4204
30317,11970,5686,6284,2554,4586,2945,1885
30318,49736,25530,24206,12196,21284,10459,5797
30319,38423,18692,19731,7229,15100,9402,6692
30322,2023,1006,1017,1406,617,0,0
30324,24267,13046,11221,3273,12723,5764,2507
30326,4802,2424,2378,398,2605,1109,690
30327,22208,10724,11484,5820,3563,7478,5347
30328,30348,14364,15984,6271,9771,8043,6263
30329,28539,14943,13596,6399,13653,5426,3061
30331,54094,23865,30229,15691,15223,13596,9584
30332,2970,1974,996,1090,1880,0,0
30334,1,1,0,0,0,0,1
30336,971,522,449,253,352,305,61
30337,11505,5560,5945,3376,3462,3221,1446
30338,33617,15922,17695,8583,9539,8833,6662
30339,18304,8869,9435,2464,9795,3976,2069
30340,29394,15585,13809,8339,11046,6831,3178
30341,31793,17280,14513,7331,13751,7377,3334
30342,29879,14830,15049,7957,11063,7200,3659
30344,31776,15127,16649,9149,9775,8422,4430
30345,23129,11945,11184,5428,7689,6377,3635
30346,4696,2222,2474,529,3110,850,207
30349,67602,30874,36728,21580,22033,17235,6754
30350,34740,16520,18220,7904,13561,8770,4505
30354,14857,7083,7774,4623,4603,3798,1833
30360,14536,7704,6832,4094,5156,3523,1763
30363,2680,1505,1175,236,1984,381,79
30401,13500,6474,7026,3969,3491,3398,2642
30410,2168,1282,886,502,668,635,363
30411,4371,3116,1255,709,1670,1384,608
30412,80,38,42,15,16,19,30
30413,1575,746,829,397,319,458,401
30415,6780,3356,3424,1994,1668,1989,1129
30417,11090,5434,5656,3122,2964,2875,2129
30420,1460,743,717,374,351,382,353
30421,3381,1653,1728,935,759,960,727
30423,120,59,61,29,28,33,30
30425,1198,593,605,329,276,347,246
30426,1100,525,575,289,244,346,221
30427,12864,7144,5720,3326,4053,3364,2121
30428,2766,1343,1423,783,612,737,634
30429,205,100,105,77,62,39,27
30434,5728,2777,2951,1583,1412,1554,1179
30436,11961,5789,6172,3719,2966,3069,2207
30438,74,33,41,31,19,12,12
30439,10877,5381,5496,3104,2723,2809,2241
30441,1663,833,830,425,365,468,405
30442,7698,3650,4048,2350,1718,1994,1636
30445,3285,1616,1669,977,964,802,542
30446,1357,678,679,384,257,426,290
30448,81,44,37,25,22,26,8
30449,119,60,59,37,27,36,19
30450,2583,1233,1350,819,582,709,473
30451,33,12,21,5,3,9,16
30452,1567,784,783,437,376,479,275
30453,9703,6306,3397,2091,3551,2844,1217
30454,538,269,269,129,123,158,128
30455,597,285,312,153,119,166,159
30456,2119,1023,1096,642,510,548,419
30457,6424,3217,3207,1777,1696,1687,1264
30458,41139,20498,20641,12214,18014,6314,4597
30460,427,219,208,101,326,0,0
30461,13390,6764,6626,3794,3815,3706,2075
30464,78,39,39,27,33,9,9
30467,12600,6150,6450,3574,2864,3513,2649
30470,517,260,257,160,109,145,103
30471,4702,2401,2301,1242,1254,1286,920
30473,2972,1508,1464,841,699,820,612
30474,16594,7739,8855,4903,4001,4337,3353
30475,52,24,28,9,15,14,14
30477,3070,1443,1627,865,727,821,657
30501,28048,13825,14223,9360,8473,5828,4387
30504,22463,11313,11150,7535,7620,4623,2685
30506,41667,20547,21120,11646,9463,12291,8267
30507,28399,14704,13695,9614,8371,6991,3423
30510,8291,3385,4906,1999,2571,2453,1268
30511,3186,1565,1621,920,771,887,608
30512,19490,9462,10028,3891,3299,5293,7007
30513,11172,5416,5756,2384,2083,3263,3442
30516,2054,1035,1019,606,486,554,408
30517,11963,5924,6039,3686,3282,3318,1677
30518,45211,22227,22984,14522,12344,12666,5679
30519,39812,20128,19684,12748,10616,12061,4387
30520,4426,2203,2223,1207,998,1281,940
30521,4944,2513,2431,1233,1144,1488,1079
30522,1092,546,546,152,154,369,417
30523,12904,6364,6540,3050,2612,3600,3642
30525,7364,3639,3725,1728,1602,1946,2088
30527,4043,1996,2047,1085,856,1221,881
30528,22679,11052,11627,6079,5146,6355,5099
30529,10920,5227,5693,3055,2822,2754,2289
30530,6752,3406,3346,1947,1592,2009,1204
30531,11279,5482,5797,3473,2952,2651,2203
30533,25296,12536,12760,6595,7243,6623,4835
30534,26685,13351,13334,6862,6674,7819,5330
30535,7042,3392,3650,1886,1861,1780,1515
30536,8363,4213,4150,1934,1744,2449,2236
30537,1249,602,647,222,218,339,470
30538,2854,1408,1446,792,675,776,611
30540,17297,8576,8721,4394,3847,4825,4231
30541,1603,803,800,380,317,467,439
30542,31946,15836,16110,9535,8149,9640,4622
30543,4487,2276,2211,1489,1146,1195,657
30545,936,481,455,173,164,271,328
30546,6496,3064,3432,1124,936,1635,2801
30547,3268,1655,1613,920,770,922,656
30548,15870,7810,8060,4696,3276,4631,3267
30549,22500,11277,11223,6713,5924,6305,3558
30552,1697,850,847,352,302,486,557
30553,7232,3537,3695,1763,1580,2038,1851
30554,8535,4269,4266,2446,2228,2402,1459
30555,2061,967,1094,429,425,561,646
30557,4975,2449,2526,1195,1032,1557,1191
30558,5456,2732,2724,1505,1358,1620,973
30559,4333,2141,2192,948,794,1328,1263
30560,4599,2270,2329,884,789,1451,1475
30562,1128,533,595,299,255,310,264
30563,5373,2659,2714,1492,1293,1503,1085
30564,4463,2237,2226,1155,1046,1354,908
30565,4758,2378,2380,1346,1150,1423,839
30566,7906,3851,4055,2180,2330,2102,1294
30567,2981,1513,1468,854,706,895,526
30568,1877,917,960,568,326,471,512
30571,3682,1810,1872,697,559,1107,1319
30572,1260,633,627,205,180,390,485
30573,163,86,77,42,26,50,45
30575,1375,725,650,382,381,403,209
30576,2521,1253,1268,543,527,699,752
30577,22230,10606,11624,5738,5259,6065,5168
30581,73,35,38,22,12,17,22
30582,4567,2234,2333,1161,936,1050,1420
30601,20835,10386,10449,4906,9936,3878,2115
30602,2409,1013,1396,1077,1331,1,0
30605,39952,19304,20648,9578,20144,6089,4141
30606,40225,18671,21554,8828,16713,8391,6293
30607,10895,5406,5489,3470,3444,2506,1475
30609,1956,548,1408,1867,89,0,0
30619,1440,708,732,355,336,442,307
30620,12486,6163,6323,4123,3826,3152,1385
30621,5109,2498,2611,1612,1024,1609,864
30622,10344,4983,5361,2872,2650,2940,1882
30623,154,77,77,38,37,51,28
30624,2611,1304,1307,654,594,783,580
30625,2438,1227,1211,536,488,761,653
30627,2273,1100,1173,558,482,740,493
30628,6556,3265,3291,1871,1644,1918,1123
30629,4531,2237,2294,1166,1069,1274,1022
30630,2438,1167,1271,651,531,729,527
30631,1767,852,915,388,344,546,489
30633,8474,4207,4267,2233,1935,2643,1663
30634,2281,1131,1150,628,539,669,445
30635,16109,7630,8479,4203,3590,4449,3867
30641,1810,897,913,460,407,539,404
30642,11001,5390,5611,2285,2105,2937,3674
30643,16382,8128,8254,3923,3486,4551,4422
30646,6946,3392,3554,1978,1707,1945,1316
30648,2988,1467,1521,804,645,869,670
30650,11708,5569,6139,3316,2557,3344,2491
30655,24136,11613,12523,7112,6311,6452,4261
30656,15133,7419,7714,4223,3656,4422,2832
30660,1191,586,605,303,256,339,293
30662,8537,4120,4417,2203,2142,2217,1975
30663,3032,1516,1516,809,591,981,651
30664,38,24,14,9,16,7,6
30665,80,36,44,23,17,26,14
30666,8659,4263,4396,2549,2423,2263,1424
30667,1035,537,498,291,219,297,228
30668,1924,958,966,371,314,595,644
30669,3313,1591,1722,935,751,861,766
30673,7897,3844,4053,1973,1722,2228,1974
30677,17065,8315,8750,5218,3576,5479,2792
30678,1294,635,659,277,274,375,368
30680,37837,18437,19400,11669,10879,9630,5659
30683,6749,3322,3427,1771,1879,1911,1188
30701,40053,19682,20371,12257,10918,10477,6401
30705,33566,16600,16966,10101,8838,9288,5339
30707,16483,8069,8414,4534,3903,4843,3203
30708,293,152,141,72,72,90,59
30710,6661,3364,3297,1870,1482,2112,1197
30711,3569,1795,1774,944,836,1083,706
30720,26895,13247,13648,7880,7273,6868,4874
30721,53601,26789,26812,18186,14841,13025,7549
30725,4647,2282,2365,1253,1106,1300,988
30726,56,30,26,11,15,14,16
30728,19612,9526,10086,5097,4702,5596,4217
30730,1993,1019,974,547,459,554,433
30731,2428,1200,1228,570,505,739,614
30733,2080,1041,1039,604,471,619,386
30734,3466,1754,1712,881,791,1094,700
30735,6153,3099,3054,1800,1518,1821,1014
30736,41029,20197,20832,11645,10165,11894,7325
30738,3799,1900,1899,919,738,1235,907
30739,5571,2984,2587,1334,1600,1576,1061
30740,8600,4281,4319,2426,2038,2583,1553
30741,29290,14021,15269,7348,7377,7838,6727
30742,7460,3367,4093,1936,2027,1756,1741
30746,1223,629,594,319,261,385,258
30747,16859,8957,7902,3937,4535,4851,3536
30750,4125,2031,2094,1262,1184,958,721
30751,91,43,48,20,20,35,16
30752,9800,4830,4970,2597,2381,2824,1998
30753,6697,3345,3352,1934,1674,1845,1244
30755,9590,4855,4735,2670,2405,2841,1674
30756,74,40,34,16,17,26,15
30757,1787,880,907,414,417,548,408
30802,6321,3277,3044,1552,1283,2178,1308
30803,741,381,360,200,179,216,146
30805,2734,1342,1392,779,620,849,486
30807,92,40,52,16,20,36,20
30808,4615,2193,2422,1314,1045,1356,900
30809,38168,18371,19797,11913,8082,12246,5927
30810,2138,1009,1129,592,481,581,484
30812,363,212,151,1,51,205,106
30813,30415,15410,15005,9349,9921,7750,3395
30814,8150,3997,4153,2304,1920,2401,1525
30815,39640,18869,20771,12543,9790,11832,5475
30816,2109,1006,1103,517,452,640,500
30817,7676,3725,3951,1823,1592,2397,1864
30818,555,261,294,153,127,183,92
30820,1205,600,605,338,258,371,238
30821,882,410,472,193,194,244,251
30822,526,260,266,138,111,159,118
30823,1800,900,900,488,403,561,348
30824,17201,8031,9170,4946,4025,4735,3495
30828,4368,2013,2355,1220,890,1260,998
30830,13966,6606,7360,4609,3482,3637,2238
30833,4043,1949,2094,1163,947,1066,867
30901,16445,8031,8414,4276,4247,4280,3642
30903,585,300,285,192,150,173,70
30904,25666,12063,13603,6325,7594,6854,4893
30905,8955,6145,2810,3464,5017,452,22
30906,57748,27097,30651,18095,15001,15327,9325
30907,50913,24497,26416,13858,13159,14696,9200
30909,41585,19251,22334,10023,14396,9830,7336
30912,296,186,110,58,128,17,93
31001,4816,3303,1513,799,1699,1495,823
31002,2910,1434,1476,771,667,806,666
31003,112,50,62,15,14,32,51
31005,15102,7518,7584,4646,4222,4393,1841
31006,4923,2397,2526,1391,1232,1350,950
31007,1117,551,566,257,215,342,303
31008,18453,9035,9418,5071,4807,5506,3069
31009,1477,799,678,328,442,416,291
31011,923,474,449,257,207,268,191
31012,2683,1958,725,368,980,939,396
31014,13756,6542,7214,4195,3260,3515,2786
31015,21938,10456,11482,6395,5193,5879,4471
31016,1517,747,770,345,306,511,355
31017,1985,963,1022,458,401,635,491
31018,2837,2186,651,385,1225,932,295
31019,2318,1151,1167,663,580,618,457
31020,2541,1248,1293,605,511,808,617
31021,28549,13366,15183,8103,6845,7645,5956
31022,1424,681,743,408,327,413,276
31023,15383,7632,7751,4523,3723,4071,3066
31024,20039,9727,10312,4787,4406,5655,5191
31025,1226,613,613,341,241,422,222
31027,10012,4812,5200,3019,2409,2787,1797
31028,5912,2877,3035,1480,1604,1665,1163
31029,16287,8269,8018,4249,4117,4875,3046
31030,18977,9173,9804,6032,5281,4609,3055
31031,6576,3201,3375,1799,1516,1972,1289
31032,13993,6730,7263,4078,3272,3938,2705
31033,2660,1269,1391,696,629,846,489
31035,1364,658,706,374,309,393,288
31036,12998,5666,7332,3187,3126,3885,2800
31037,4313,2698,1615,959,1615,1136,603
31038,761,385,376,158,157,242,204
31039,74,39,35,20,12,28,14
31041,988,463,525,210,187,315,276
31042,1841,873,968,495,407,567,372
31044,2911,1398,1513,660,574,940,737
31045,73,32,41,5,12,21,35
31046,3343,1670,1673,840,720,1127,656
31047,11193,5574,5619,3515,2759,3560,1359
31049,1806,872,934,468,378,530,430
31050,965,493,472,237,246,313,169
31051,187,91,96,69,47,42,29
31052,8652,4254,4398,2105,1751,2828,1968
31054,1671,814,857,464,424,466,317
31055,8245,4773,3472,1751,2364,2538,1592
31057,2182,1058,1124,562,478,621,521
31058,2123,1029,1094,547,429,711,436
31060,1915,973,942,436,425,542,512
31061,43755,21547,22208,11523,13312,11270,7650
31062,495,413,82,8,46,146,295
31063,5666,2671,2995,1760,1334,1529,1043
31064,9450,4650,4800,2620,2270,2705,1855
31065,1118,529,589,304,210,353,251
31066,1147,564,583,241,225,390,291
31067,222,112,110,30,42,57,93
31068,5425,3526,1899,1050,1937,1678,760
31069,18948,9205,9743,5171,4944,5174,3659
31070,998,521,477,207,273,288,230
31071,1199,550,649,286,253,365,295
31072,1326,653,673,346,298,383,299
31075,2496,1207,1289,728,651,679,438
31076,3064,1459,1605,814,622,881,747
31077,1275,647,628,291,276,391,317
31078,3566,1744,1822,925,815,1082,744
31079,2398,1162,1236,662,552,627,557
31081,251,133,118,55,45,84,67
31082,10408,4818,5590,2985,2251,3001,2171
31083,362,171,191,103,78,118,63
31084,129,66,63,34,39,27,29
31085,1043,528,515,297,230,326,190
31087,9656,5284,4372,2031,2462,2978,2185
31088,50163,24336,25827,14921,14325,13748,7169
31089,4838,2316,2522,1466,1160,1356,856
31090,1038,503,535,229,191,334,284
31091,5189,3383,1806,931,1692,1721,845
31092,7420,3526,3894,2036,1704,2042,1638
31093,28087,13334,14753,8216,7700,7360,4811
31094,1114,523,591,283,222,349,260
31096,7395,4319,3076,1608,2068,2375,1344
31097,1302,631,671,319,243,438,302
31098,2888,1583,1305,1121,1363,363,41
31201,8761,4655,4106,2005,3168,2223,1365
31204,31482,14112,17370,8761,8422,7834,6465
31206,29072,13420,15652,10423,7530,7191,3928
31207,974,428,546,651,322,0,1
31210,30968,14222,16746,8238,8183,8321,6226
31211,16282,7836,8446,4520,4173,4573,3016
31213,0,0,0,0,0,0,0
31216,16109,8424,7685,4049,4050,4873,3137
31217,18408,8662,9746,5660,4243,5076,3429
31220,13839,6594,7245,3695,3667,4124,2353
31301,4591,2150,2441,1554,1393,1222,422
31302,7853,3931,3922,2223,1925,2323,1382
31303,1999,994,1005,500,455,664,380
31304,132,67,65,36,27,48,21
31305,5989,2914,3075,1498,1288,1813,1390
31307,998,488,510,276,251,304,167
31308,7305,3674,3631,2110,1865,2158,1172
31309,1210,607,603,336,302,373,199
31312,16443,8139,8304,5310,4111,4967,2055
31313,40302,19090,21212,13525,13128,9968,3681
31314,1931,1712,219,359,1502,66,4
31315,7488,3502,3986,3725,3266,476,21
31316,9749,4826,4923,3163,2856,2522,1208
31318,341,162,179,91,68,88,94
31320,8794,4302,4492,2288,2022,2741,1743
31321,6326,3135,3191,1802,1509,1870,1145
31322,21137,10357,10780,6038,7413,5367,2319
31323,1762,863,899,458,347,573,384
31324,20495,9993,10502,6810,4980,6180,2525
31326,19269,9486,9783,6251,5123,5459,2436
31327,195,100,95,38,29,62,66
31328,3306,1609,1697,431,514,1206,1155
31329,9034,4673,4361,2766,2538,2298,1432
31331,7856,3825,4031,1834,1508,2431,2083
31401,21696,10108,11588,5554,9205,3915,3022
31404,31024,14292,16732,9162,9147,7637,5078
31405,37207,18328,18879,9746,11731,9249,6481
31406,33965,16059,17906,8821,9317,9010,6817
31407,7244,3503,3741,2063,2780,1566,835
31408,9952,5774,4178,2381,3562,2605,1404
31409,652,619,33,128,518,5,1
31410,23654,11461,12193,5514,6018,7407,4715
31411,8384,3985,4399,1094,632,1733,4925
31415,12091,5610,6481,3717,3060,2926,2388
31419,50954,24045,26909,13699,17625,12442,7188
31501,15576,8018,7558,3901,4185,4117,3373
31503,21116,10227,10889,5798,5331,5685,4302
31510,9848,4890,4958,2734,2647,2601,1866
31512,2248,1114,1134,635,567,627,419
31513,16084,8095,7989,4650,3936,4387,3111
31516,14735,7167,7568,4226,3493,3998,3018
31518,704,359,345,182,144,217,161
31519,3569,1754,1815,970,818,1048,733
31520,22336,10635,11701,6525,6148,5556,4107
31522,14447,6678,7769,2611,2276,4414,5146
31523,13229,6492,6737,3652,3049,4096,2432
31524,0,0,0,0,0,0,0
31525,28247,13401,14846,8281,7588,7760,4618
31527,805,378,427,45,83,143,534
31532,727,355,372,186,149,230,162
31533,17494,8249,9245,5403,4668,4359,3064
31535,11264,5507,5757,3620,3013,2998,1633
31537,10097,5755,4342,2419,2971,2935,1772
31539,14468,7179,7289,4409,3661,3769,2629
31542,2811,1414,1397,803,679,735,594
31543,4796,2403,2393,1374,1136,1437,849
31544,994,493,501,258,236,256,244
31545,16133,7816,8317,4790,4043,4273,3027
31546,8095,4940,3155,1766,2486,2529,1314
31547,1293,1103,190,325,932,25,11
31548,20020,9819,10201,6476,6077,5185,2282
31549,2239,1084,1155,616,417,682,524
31550,780,391,389,203,176,225,176
31551,1020,514,506,289,264,283,184
31552,932,465,467,225,208,298,201
31553,5237,2574,2663,1511,1285,1462,979
31554,7076,4468,2608,1562,2546,2004,964
31555,2868,1441,1427,812,669,810,577
31556,67,30,37,24,22,12,9
31557,3043,1535,1508,873,690,840,640
31558,20373,10304,10069,6177,6416,4849,2931
31560,2842,1435,1407,809,684,744,605
31561,298,132,166,21,7,53,217
31562,2177,1133,1044,583,502,652,440
31563,1324,643,681,323,298,383,320
31565,1841,904,937,410,397,632,402
31566,3471,1761,1710,1062,843,1043,523
31567,782,414,368,213,172,235,162
31568,1273,607,666,323,259,418,273
31569,5580,2775,2805,1524,1339,1754,963
31601,32730,15681,17049,10120,10509,7535,4566
31602,34702,17318,17384,8665,12751,7914,5372
31605,20188,9783,10405,6145,7050,4526,2467
31606,3861,1865,1996,1136,843,1167,715
31620,10690,5196,5494,3199,2688,2748,2055
31622,2178,1075,1103,602,530,542,504
31623,120,57,63,45,24,31,20
31624,1273,654,619,378,317,377,201
31625,1171,580,591,264,249,347,311
31626,3463,1667,1796,899,723,1018,823
31627,239,110,129,67,56,70,46
31629,902,433,469,212,182,279,229
31630,419,225,194,115,107,114,83
31631,559,283,276,145,113,163,138
31632,10295,4936,5359,3290,2710,2820,1475
31634,5844,2823,3021,1748,1475,1560,1061
31635,6560,3326,3234,1952,1864,1618,1126
31636,9539,4688,4851,2729,2453,2567,1790
31637,2848,1432,1416,720,712,826,590
31638,1045,516,529,283,244,339,179
31639,10537,5097,5440,2896,2466,2922,2253
31641,1831,887,944,492,429,573,337
31642,4898,2488,2410,1600,1350,1223,725
31643,8709,4217,4492,2442,2026,2350,1891
31645,5147,2579,2568,1607,1538,1315,687
31647,3535,1733,1802,1140,879,914,602
31648,1040,511,529,343,289,262,146
31649,1056,540,516,303,254,320,179
31650,3311,1653,1658,1069,859,849,534
31698,2223,928,1295,1824,397,2,0
31699,621,516,105,125,495,1,0
31701,20552,9490,11062,6119,5412,5247,3774
31705,35565,16892,18673,11892,10447,8285,4941
31707,25299,11416,13883,6780,7573,6147,4799
31709,16019,7317,8702,4781,4851,3632,2755
31711,867,440,427,205,184,281,197
31712,1263,636,627,308,277,433,245
31714,6474,3021,3453,1882,1522,1668,1402
31716,2896,1441,1455,841,668,867,520
31719,10977,5441,5536,3537,2937,2808,1695
31720,455,217,238,118,111,129,97
31721,20095,9520,10575,5436,4463,5912,4284
31722,494,247,247,163,114,115,102
31730,9682,4695,4987,2913,2465,2517,1787
31733,1580,796,784,364,326,458,432
31735,817,419,398,124,153,241,299
31738,2102,1013,1089,553,461,637,451
31743,630,299,331,158,136,201,135
31744,3202,1555,1647,850,717,902,733
31747,281,136,145,74,70,77,60
31749,2783,1419,1364,816,754,734,479
31750,18687,8956,9731,5406,4538,5009,3734
31756,966,495,471,254,206,294,212
31757,10451,5070,5381,2896,2432,3098,2025
31763,23304,11703,11601,7259,6253,6769,3023
31764,1296,637,659,315,263,427,291
31765,2647,1247,1400,789,561,746,551
31768,23617,11419,12198,7153,6024,5956,4484
31771,5666,2860,2806,1812,1545,1395,914
31772,482,241,241,110,106,146,120
31773,3729,1897,1832,980,835,1125,789
31774,6714,3398,3316,1846,1765,1793,1310
31775,2979,1535,1444,1047,832,651,449
31778,2562,1254,1308,652,540,795,575
31779,9927,5574,4353,2463,2893,2820,1751
31780,2285,1107,1178,555,484,608,638
31781,1752,873,879,497,407,522,326
31783,1107,543,564,294,249,277,287
31784,781,400,381,226,196,190,169
31787,1488,698,790,441,328,452,267
31788,10602,5475,5127,3254,3060,2630,1658
31789,1236,605,631,308,266,376,286
31790,2078,1150,928,496,551,592,439
31791,12354,5772,6582,3548,2864,3415,2527
31792,23835,11065,12770,6560,5595,6536,5144
31793,9043,4402,4641,2904,2478,2164,1497
31794,27153,12882,14271,7990,7249,6977,4937
31795,2010,988,1022,581,459,595,375
31796,1112,536,576,260,217,365,270
31798,983,476,507,260,230,276,217
31801,3008,1497,1511,712,607,1048,641
31803,5662,2761,2901,1601,1281,1610,1170
31804,5934,3010,2924,1655,1183,2013,1083
31805,3191,1554,1637,914,661,966,650
31806,4962,2388,2574,1624,1056,1359,923
31807,2483,1231,1252,733,575,803,372
31808,6679,3334,3345,1794,1369,2312,1204
31810,225,107,118,41,45,72,67
31811,5103,2646,2457,1309,1199,1569,1026
31812,565,279,286,127,105,183,150
31814,272,132,140,66,57,86,63
31815,3675,2570,1105,528,1682,926,539
31816,6091,2756,3335,1776,1389,1562,1364
31820,8473,4166,4307,2506,1688,2894,1385
31821,250,129,121,57,54,80,59
31822,5429,2645,2784,1392,1082,1659,1296
31823,754,372,382,179,142,231,202
31824,1838,883,955,529,392,548,369
31825,2312,1068,1244,556,511,673,572
31826,2350,1086,1264,609,472,783,486
31827,2134,1012,1122,542,437,676,479
31829,1370,665,705,369,222,503,276
31830,2191,1024,1167,544,471,566,610
31831,3095,1541,1554,704,602,995,794
31832,217,110,107,49,28,66,74
31833,6900,3265,3635,1986,1549,1897,1468
31836,1154,544,610,285,202,368,299
31901,8638,4520,4118,2075,2837,2425,1301
31903,20128,9435,10693,6778,5434,4976,2940
31904,32871,15644,17227,8722,9191,8678,6280
31905,16035,10354,5681,6402,8659,899,75
31906,21757,9884,11873,6042,5743,5650,4322
31907,55332,25876,29456,15774,15802,14607,9149
31909,35177,16699,18478,9577,11141,8898,5561
39813,2110,997,1113,656,455,568,431
39815,1686,812,874,457,367,522,340
39817,10894,5605,5289,3226,2976,3040,1652
39819,11282,5230,6052,3219,2647,2927,2489
39823,8550,3994,4556,2515,1874,2266,1895
39824,544,268,276,128,121,172,123
39825,1461,723,738,382,323,442,314
39826,418,200,218,104,82,121,111
39827,3842,1929,1913,1170,958,1072,642
39828,15150,7233,7917,4340,3948,3920,2942
39834,2138,1029,1109,569,435,652,482
39836,461,219,242,105,74,128,154
39837,6166,2940,3226,1597,1375,1718,1476
39840,5726,2612,3114,1486,1246,1587,1407
39841,878,430,448,247,170,264,197
39842,8357,4012,4345,2349,1954,2355,1699
39845,7871,3727,4144,2001,1582,2199,2089
39846,2440,1096,1344,796,532,602,510
39851,2388,1083,1305,624,467,619,678
39854,2592,1240,1352,597,482,688,825
39859,1281,620,661,333,265,352,331
39861,1003,487,516,251,200,283,269
39862,1326,637,689,319,254,422,331
39866,2122,1876,246,111,1050,783,178
39867,321,159,162,51,54,98,118
39870,2238,1067,1171,579,512,676,471
39877,500,247,253,126,109,121,144
39885,76,40,36,14,16,30,16
39886,1616,762,854,424,341,462,389
39897,3430,1657,1773,857,725,978,870
96701,40281,20577,19704,8403,10558,11447,9873
96703,2368,1167,1201,632,596,698,442
96704,6505,3331,3174,1427,1302,2114,1662
96705,2319,1183,1136,667,514,662,476
96706,62730,31173,31557,19776,18422,16514,8018
96707,38817,19470,19347,12315,11054,10904,4544
96708,10220,5244,4976,2463,2570,3491,1696
96710,613,315,298,133,100,206,174
96712,7352,3860,3492,1643,2300,2165,1244
96713,1990,1032,958,540,462,556,432
96714,1390,748,642,305,347,454,284
96716,2823,1462,1361,749,685,855,534
96717,5555,2749,2806,1671,1499,1457,928
96719,1692,839,853,407,376,502,407
96720,46165,22808,23357,11235,11529,12183,11218
96722,2484,1205,1279,419,490,810,765
96725,3592,1849,1743,839,863,1108,782
96726,661,366,295,152,184,178,147
96727,4878,2427,2451,1252,1127,1371,1128
96728,610,313,297,139,127,197,147
96729,1303,627,676,472,291,326,214
96730,1541,782,759,413,405,464,259
96731,3292,1667,1625,1087,810,857,538
96732,24816,12002,12814,6828,6280,6309,5399
96734,50746,26155,24591,12491,15735,12729,9791
96737,4552,2369,2183,1217,856,1531,948
96738,6609,3311,3298,1749,1619,2141,1100
96740,33321,16738,16583,7779,8196,10180,7166
96741,5929,2974,2955,1461,1331,1800,1337
96742,90,42,48,0,19,42,29
96743,12160,5922,6238,3384,2716,3564,2496
96744,54247,26581,27666,12926,13143,15690,12488
96746,18319,9152,9167,4545,4327,5649,3798
96747,749,404,345,232,167,216,134
96748,4503,2196,2307,1191,901,1200,1211
96749,17047,8614,8433,4997,4151,4848,3051
96750,3793,1845,1948,959,869,1090,875
96751,175,74,101,32,38,58,47
96752,3680,1847,1833,1012,881,979,808
96753,26892,13720,13172,5832,7200,8671,5189
96754,4084,2115,1969,957,1040,1326,761
96755,3575,1782,1793,923,773,998,881
96756,5190,2573,2617,1148,1200,1503,1339
96757,758,391,367,227,155,204,172
96759,457,255,202,123,125,132,77
96760,3001,1546,1455,774,633,1028,566
96761,22156,11264,10892,5268,6149,6776,3963
96762,6419,2997,3422,2110,2885,887,537
96763,3135,1600,1535,856,763,857,659
96764,799,411,388,197,170,236,196
96765,553,294,259,135,141,175,102
96766,14683,7339,7344,3790,3346,4220,3327
96768,17668,8811,8857,4570,4307,5559,3232
96769,464,224,240,141,109,114,100
96770,691,347,344,232,143,175,141
96771,8339,4270,4069,2422,1954,2635,1328
96772,2304,1192,1112,567,423,679,635
96773,210,111,99,37,34,63,76
96774,342,168,174,99,72,97,74
96776,1490,767,723,398,277,478,337
96777,1479,746,733,374,317,408,380
96778,14409,7335,7074,3896,3440,4294,2779
96779,3088,1580,1508,716,893,948,531
96780,557,280,277,155,145,136,121
96781,1670,814,856,382,374,467,447
96782,40496,21509,18987,8923,12170,9501,9902
96783,2060,1029,1031,540,458,539,523
96785,2646,1323,1323,500,458,956,732
96786,40859,20432,20427,13780,15047,7111,4921
96789,54129,27022,27107,15071,14199,15849,9010
96790,8065,3970,4095,1865,1542,2823,1835
96791,8014,4253,3761,1825,2459,2160,1570
96792,48519,23975,24544,16862,13040,11878,6739
96793,29549,14803,14746,8077,7464,9031,4977
96795,10034,4916,5118,3022,2480,2692,1840
96796,1881,940,941,436,419,557,469
96797,72289,36154,36135,19313,19791,20183,13002
96813,22881,11350,11531,3952,6399,6796,5734
96814,18721,9176,9545,2600,5474,5756,4891
96815,31470,16126,15344,3661,10616,9182,8011
96816,49368,24024,25344,9285,12145,14458,13480
96817,54628,26491,28137,11593,12462,15792,14781
96818,50586,25014,25572,15508,17065,11047,6966
96819,49492,25200,24292,12845,13299,13163,10185
96821,19856,9689,10167,3933,3435,6170,6318
96822,45007,21772,23235,8220,13485,12184,11118
96825,30263,14742,15521,6553,5670,9516,8524
96826,30842,15126,15716,5127,9709,8719,7287
96850,0,0,0,0,0,0,0
96853,462,359,103,49,413,0,0
96857,2522,2335,187,372,2126,24,0
96859,156,113,43,14,130,8,4
96860,1124,997,127,102,1010,11,1
96863,52,51,1,2,45,5,0
59847,52,33,19,6,21,18,7
83111,54,25,29,27,10,10,7
83120,112,65,47,40,18,34,20
83201,37199,18707,18492,11083,12186,8119,5811
83202,21608,10575,11033,7537,5711,4959,3401
83203,309,149,160,100,78,79,52
83204,18026,8959,9067,4969,5450,4796,2811
83209,1175,597,578,561,566,42,6
83210,3449,1774,1675,1307,776,838,528
83211,6374,3300,3074,2228,1544,1555,1047
83212,137,81,56,29,29,48,31
83213,1644,848,796,480,289,452,423
83214,671,346,325,258,136,158,119
83215,26,13,13,0,0,14,12
83217,843,429,414,292,171,186,194
83218,338,158,180,102,83,73,80
83220,137,63,74,47,19,43,28
83221,27021,13553,13468,9506,6692,6407,4416
83223,139,76,63,40,16,49,34
83226,2504,1331,1173,554,495,816,639
83227,142,80,62,11,15,62,54
83228,522,269,253,213,112,105,92
83232,467,232,235,182,101,114,70
83233,109,52,57,42,22,20,25
83234,1213,616,597,369,204,307,333
83235,99,52,47,29,24,26,20
83236,2275,1156,1119,755,497,618,405
83237,1146,571,575,448,295,254,149
83238,109,60,49,28,19,33,29
83239,572,266,306,169,145,132,126
83241,1980,1012,968,638,433,480,429
83243,80,41,39,20,14,26,20
83244,358,190,168,136,71,88,63
83245,2257,1108,1149,731,449,639,438
83246,1069,523,546,226,164,325,354
83250,1637,837,800,486,299,441,411
83251,1097,574,523,242,194,333,328
83252,4154,2122,2032,1341,779,1093,941
83253,165,85,80,39,43,44,39
83254,3617,1796,1821,1100,762,905,850
83255,1213,612,601,314,219,355,325
83261,536,279,257,152,111,139,134
83262,1386,698,688,493,324,342,227
83263,9258,4683,4575,3423,2135,2044,1656
83271,531,272,259,198,103,126,104
83272,313,152,161,104,50,68,91
83274,9246,4630,4616,3410,2177,2249,1410
83276,4097,2034,2063,1183,892,1157,865
83277,111,60,51,24,16,35,36
83278,186,108,78,17,46,78,45
83281,93,48,45,29,15,23,26
83283,147,76,71,51,23,41,32
83285,131,64,67,31,31,35,34
83286,1241,653,588,503,273,294,171
83287,299,153,146,46,34,82,137
83301,52010,25448,26562,15569,14597,12078,9766
83302,196,98,98,64,52,45,35
83311,562,286,276,173,115,143,131
83312,143,72,71,44,27,47,25
83313,3625,1862,1763,1042,870,1205,508
83314,898,465,433,259,218,235,186
83316,9626,4806,4820,2770,2046,2540,2270
83318,17226,8685,8541,6112,4169,3919,3026
83320,1006,517,489,353,215,254,184
83321,550,284,266,155,157,135,103
83322,42,21,21,10,6,14,12
83323,1951,985,966,742,422,495,292
83324,788,430,358,323,190,173,102
83325,918,466,452,281,211,243,183
83327,970,506,464,228,225,290,227
83328,5347,2666,2681,1646,1250,1441,1010
83330,6599,3381,3218,2173,1538,1519,1369
83332,2361,1191,1170,589,432,627,713
83333,10472,5266,5206,3020,2444,3462,1546
83334,2060,1056,1004,735,516,490,319
83335,1840,939,901,619,395,512,314
83336,4951,2502,2449,1566,1132,1293,960
83337,33,14,19,9,5,13,6
83338,19782,10112,9670,6768,5289,4697,3028
83340,4682,2424,2258,912,1135,1484,1151
83341,6491,3256,3235,2187,1454,1754,1096
83342,1298,672,626,515,273,254,256
83344,1128,598,530,386,302,273,167
83346,1442,727,715,568,274,338,262
83347,3258,1669,1589,1082,735,791,650
83348,132,68,64,36,32,38,26
83349,1062,547,515,350,276,251,185
83350,12268,6215,6053,4003,2788,3049,2428
83352,3330,1708,1622,1093,817,853,567
83353,1335,678,657,174,268,374,519
83354,18,9,9,0,2,3,13
83355,5405,2844,2561,1904,1460,1245,796
83401,37966,18945,19021,13486,11090,8255,5135
83402,26069,13356,12713,8380,7110,6725,3854
83404,21606,10510,11096,6686,4921,5731,4268
83406,15902,7828,8074,5962,4065,3545,2330
83420,2539,1283,1256,827,502,628,582
83421,319,172,147,107,71,77,64
83422,3392,1757,1635,1061,1020,896,415
83423,860,467,393,289,211,203,157
83424,290,160,130,99,72,84,35
83425,581,299,282,247,118,126,90
83427,1372,668,704,534,374,287,177
83428,416,221,195,53,77,149,137
83429,1048,587,461,139,141,352,416
83431,876,423,453,271,206,213,186
83433,44,22,22,4,6,16,18
83434,1741,901,840,589,376,473,303
83435,653,360,293,284,146,151,72
83436,491,255,236,169,112,121,89
83440,34610,16934,17676,11711,16187,4133,2579
83442,19250,9563,9687,7437,5033,4235,2545
83443,1107,557,550,382,253,264,208
83444,1381,737,644,503,336,332,210
83445,7406,3961,3445,2698,1880,1676,1152
83446,48,29,19,10,5,19,14
83448,2451,1197,1254,1059,560,516,316
83449,249,128,121,45,34,89,81
83450,1104,570,534,443,270,249,142
83451,791,393,398,248,194,200,149
83452,1484,752,732,471,333,439,241
83454,531,272,259,211,137,124,59
83455,4970,2637,2333,1564,1737,1271,398
83460,860,230,630,698,162,0,0
83462,464,243,221,79,49,165,171
83463,130,74,56,10,14,36,70
83464,345,181,164,81,73,108,83
83465,109,58,51,30,16,34,29
83466,273,152,121,36,20,106,111
83467,6270,3159,3111,1413,1071,1839,1947
83468,170,91,79,35,19,62,54
83469,32,17,15,8,4,6,14
83501,34230,16889,17341,8490,8546,9033,8161
83520,194,103,91,51,31,60,52
83522,2215,1297,918,557,576,669,413
83523,759,383,376,165,145,234,215
83524,989,510,479,212,182,316,279
83525,376,211,165,68,50,109,149
83526,278,149,129,86,55,74,63
83530,5404,2671,2733,1359,1007,1582,1456
83533,178,90,88,44,37,49,48
83535,1089,554,535,205,195,346,343
83536,4230,2135,2095,1046,671,1232,1281
83537,1044,534,510,177,172,336,359
83539,2001,1032,969,436,303,584,678
83540,2190,1094,1096,691,540,552,407
83541,1076,563,513,147,121,375,433
83542,129,68,61,29,14,38,48
83543,717,371,346,189,115,227,186
83544,6092,3327,2765,1234,1240,1806,1812
83545,484,251,233,86,72,178,148
83546,587,326,261,105,70,196,216
83547,219,128,91,40,28,65,86
83548,117,63,54,30,25,42,20
83549,908,479,429,139,153,286,330
83552,1225,626,599,263,180,360,422
83553,1100,569,531,235,152,366,347
83554,638,341,297,89,60,215,274
83555,564,296,268,106,77,204,177
83601,41,24,17,1,4,17,19
83602,24,13,11,3,6,10,5
83604,762,399,363,250,178,190,144
83605,39649,19619,20030,14149,11852,8201,5447
83607,21732,10778,10954,7342,4936,5716,3738
83610,946,477,469,191,122,290,343
83611,2453,1265,1188,462,335,830,826
83612,1925,970,955,396,321,559,649
83615,1571,804,767,411,370,471,319
83616,22780,11211,11569,7427,3591,7598,4164
83617,15422,7613,7809,4175,3028,4342,3877
83619,7201,3556,3645,2371,1614,1789,1427
83622,1737,926,811,391,224,591,531
83623,1517,768,749,401,306,385,425
83624,1195,632,563,382,273,312,228
83626,1192,579,613,371,226,356,239
83627,620,322,298,161,114,224,121
83628,4329,2177,2152,1473,1002,1033,821
83629,1721,875,846,501,334,514,372
83631,1333,679,654,303,208,470,352
83632,214,108,106,24,18,79,93
83633,540,276,264,146,93,174,127
83634,24494,14507,9987,7334,8999,6130,2031
83636,153,78,75,50,31,41,31
83637,206,112,94,31,19,66,90
83638,5903,3068,2835,1256,1298,1987,1362
83639,3300,1685,1615,1070,788,854,588
83641,3438,1803,1635,1121,740,922,655
83642,37008,18072,18936,12242,9499,9759,5508
83643,129,66,63,24,13,38,54
83644,9976,5005,4971,3474,2315,2755,1432
83645,636,326,310,125,93,180,238
83646,47098,23306,23792,17121,12399,11449,6129
83647,20789,10663,10126,6309,6170,5236,3074
83648,3238,1765,1473,1261,1793,178,6
83650,552,300,252,126,123,168,135
83651,28611,13919,14692,9310,8039,6062,5200
83654,1672,876,796,369,288,593,422
83655,4397,2183,2214,1414,887,1217,879
83656,582,272,310,202,142,147,91
83657,174,86,88,35,16,59,64
83660,5890,2965,2925,1898,1224,1617,1151
83661,9881,4862,5019,2930,2292,2466,2193
83666,52,31,21,9,5,20,18
83669,7365,3652,3713,2598,1790,1970,1007
83670,553,279,274,152,88,162,151
83671,33,17,16,4,3,9,17
83672,8583,4197,4386,2451,1704,2203,2225
83676,4347,2202,2145,1368,922,1171,886
83677,44,25,19,1,4,15,24
83686,46224,22627,23597,15985,12145,10940,7154
83687,29697,15005,14692,10785,8846,6574,3492
83702,22293,11393,10900,4584,7422,6712,3575
83703,16565,8049,8516,3880,4597,4903,3185
83704,39628,19609,20019,10051,12105,10187,7285
83705,26631,13179,13452,6233,9261,6664,4473
83706,29732,14805,14927,6691,10790,7505,4746
83709,50034,25000,25034,15436,13665,13227,7706
83712,8148,3938,4210,1719,2159,2617,1653
83713,28103,13707,14396,9055,7158,7879,4011
83714,20290,9886,10404,5453,4848,5972,4017
83716,14523,7405,7118,4405,3609,4736,1773
83801,6150,3183,2967,1681,1109,2055,1305
83802,68,37,31,11,18,23,16
83803,744,385,359,79,82,251,332
83804,1254,658,596,244,202,411,397
83805,7437,3724,3713,2031,1393,2115,1898
83806,220,112,108,51,26,84,59
83808,147,76,71,33,27,35,52
83809,401,204,197,106,54,138,103
83810,1189,600,589,264,176,431,318
83811,1411,716,695,297,226,460,428
83812,66,35,31,17,8,19,22
83813,1158,587,571,225,206,397,330
83814,23371,11549,11822,5332,6400,6363,5276
83815,31015,15103,15912,8628,8035,7957,6395
83821,210,109,101,31,23,59,97
83822,2006,1002,1004,519,402,627,458
83823,1318,702,616,333,254,408,323
83824,348,176,172,110,74,104,60
83825,190,101,89,51,33,57,49
83826,45,26,19,9,8,14,14
83827,143,77,66,18,21,56,48
83830,733,363,370,186,148,196,203
83832,1524,768,756,436,324,491,273
83833,1164,613,551,182,133,372,477
83834,254,126,128,64,45,87,58
83835,19990,9735,10255,5329,4016,5668,4977
83836,1033,510,523,177,121,326,409
83837,3063,1543,1520,790,659,904,710
83839,1417,699,718,318,236,428,435
83840,227,115,112,63,56,63,45
83841,338,174,164,62,50,124,102
83842,148,71,77,27,21,53,47
83843,25866,13383,12483,6288,11405,4944,3229
83844,1353,684,669,967,383,3,0
83845,1742,873,869,504,388,479,371
83846,770,391,379,159,142,253,216
83847,1719,909,810,477,332,546,364
83848,137,72,65,19,22,51,45
83849,1925,971,954,439,352,581,553
83850,2129,1029,1100,527,380,585,637
83851,1691,868,823,538,354,454,345
83852,884,417,467,225,272,227,160
83854,37245,18265,18980,11337,9569,9891,6448
83855,2111,1060,1051,571,450,607,483
83856,6340,3258,3082,1529,1153,1998,1660
83857,691,356,335,178,135,229,149
83858,13656,6804,6852,4097,2982,4152,2425
83860,6119,3124,2995,1484,1009,2010,1616
83861,6360,3257,3103,1541,1088,2000,1731
83864,17076,8458,8618,4193,3735,5148,4000
83866,320,175,145,76,56,98,90
83867,616,297,319,137,98,188,193
83868,769,402,367,189,163,250,167
83869,4161,2116,2045,1150,795,1353,863
83870,312,154,158,61,42,95,114
83871,1938,973,965,495,357,649,437
83872,705,370,335,177,97,251,180
83873,1591,838,753,316,303,522,450
83874,64,34,30,8,8,27,21
83876,1442,747,695,400,259,401,382
89832,356,167,189,126,101,89,40
97910,68,38,30,14,11,22,21
97913,4,3,1,0,3,1,0
99128,43,22,21,13,3,20,7
60002,24299,12213,12086,6849,5408,7771,4271
60004,50582,24268,26314,12602,11021,15758,11201
60005,29308,14208,15100,6759,7425,8414,6710
60007,33820,16322,17498,7749,8045,10937,7089
60008,22717,11357,11360,5834,6524,6477,3882
60010,44095,21677,22418,12299,5867,15551,10378
60012,11120,5503,5617,3453,1628,4171,1868
60013,26872,13390,13482,8624,5463,9487,3298
60014,48550,24186,24364,14805,11071,15558,7116
60015,26800,13018,13782,8001,4566,8941,5292
60016,59690,28964,30726,13122,17031,16974,12563
60018,30099,15031,15068,8045,7882,8443,5729
60020,9825,4792,5033,2113,2823,2810,2079
60021,5545,2770,2775,1555,1115,2145,730
60022,8153,4018,4135,2726,821,2867,1739
60025,39105,18608,20497,10413,6834,12438,9420
60026,13335,6307,7028,3370,2360,3981,3624
60029,482,263,219,147,78,148,109
60030,36056,17491,18565,10533,8051,11349,6123
60031,37947,18222,19725,11535,8599,12661,5152
60033,13922,7084,6838,4342,3768,3570,2242
60034,2040,1047,993,547,431,630,432
60035,29763,14396,15367,8187,4271,9396,7909
60040,5431,2829,2602,1603,1757,1304,767
60041,9250,4735,4515,2397,2269,3083,1501
60042,8547,4235,4312,2446,2158,2954,989
60043,2513,1226,1287,920,240,854,499
60044,9792,4664,5128,2576,1959,3282,1975
60045,20925,10114,10811,6243,2769,6879,5034
60046,35111,17532,17579,10962,7729,11749,4671
60047,41669,20593,21076,12676,7068,15708,6217
60048,29095,14198,14897,8550,4441,10450,5654
60050,31620,15498,16122,8720,8117,9574,5209
60051,25192,12770,12422,6864,6071,8277,3980
60053,23260,11107,12153,4906,5014,6824,6516
60056,55219,27253,27966,13799,14191,15704,11525
60060,37189,18901,18288,10946,9763,11359,5121
60061,25748,12368,13380,7415,6112,8576,3645
60062,39936,19106,20830,9720,5832,12252,12132
60064,15407,7745,7662,5372,4724,3436,1875
60067,38585,18940,19645,9439,9105,12620,7421
60068,37475,17935,19540,9978,6216,12102,9179
60069,8384,3963,4421,1813,904,2537,3130
60070,16001,7984,8017,3986,4541,4416,3058
60071,3598,1784,1814,819,923,1193,663
60072,928,464,464,278,145,356,149
60073,60002,30189,29813,20987,19054,14904,5057
60074,38985,19462,19523,10710,12350,10509,5416
60076,33415,16021,17394,8362,7237,10007,7809
60077,26825,12567,14258,5994,6627,7548,6656
60081,10079,5079,5000,3001,1857,3673,1548
60083,9838,4841,4997,2800,2137,3119,1782
60084,16771,8495,8276,4671,4286,5206,2608
60085,71714,36563,35151,24650,22964,16900,7200
60087,26978,13202,13776,8288,7693,7118,3879
60088,15761,11288,4473,5484,9876,370,31
60089,41533,20092,21441,10647,8873,14602,7411
60090,37633,18518,19115,9129,11843,10115,6546
60091,27020,12966,14054,8421,3134,9197,6268
60093,19570,9583,9987,6456,2222,6509,4383
60096,6897,3397,3500,1710,1504,2371,1312
60097,11250,5717,5533,3183,3000,3465,1602
60098,32228,16214,16014,8850,8391,9427,5560
60099,31104,14989,16115,10165,8017,8491,4431
60101,39119,19653,19466,11224,11574,10130,6191
60102,32193,15922,16271,9905,6944,11163,4181
60103,41928,20567,21361,12359,9933,13913,5723
60104,19038,8902,10136,5638,4905,5429,3066
60106,20309,10473,9836,5407,6117,5525,3260
60107,39927,19796,20131,11481,12022,11297,5127
60108,22735,10882,11853,4861,5725,6847,5302
60109,560,291,269,146,134,187,93
60110,38557,19433,19124,14082,12470,8868,3137
60111,258,133,125,57,33,104,64
60112,4560,2259,2301,1593,1592,1015,360
60113,337,171,166,91,107,103,36
60115,46272,23279,22993,12365,21115,7622,5170
60118,15851,7907,7944,3978,3399,5438,3036
60119,10371,5179,5192,3105,2185,3409,1672
60120,50955,25739,25216,16852,16190,12618,5295
60123,47405,23412,23993,14047,13856,12296,7206
60124,18935,9326,9609,5177,4640,5713,3405
60126,46371,22412,23959,13722,9313,14290,9046
60129,242,124,118,62,56,75,49
60130,14167,6686,7481,2578,4628,4472,2489
60131,18097,9099,8998,4942,5238,5039,2878
60133,38103,19271,18832,12396,11624,10235,3848
60134,28565,14028,14537,9224,5335,9868,4138
60135,7248,3639,3609,2293,1731,2132,1092
60136,7013,3480,3533,2345,2253,1867,548
60137,37805,18383,19422,10821,7387,12369,7228
60139,34381,17495,16886,10070,11510,8744,4057
60140,14341,7132,7209,4319,4109,3997,1916
60141,224,177,47,0,7,32,185
60142,26447,12606,13841,6626,4756,5879,9186
60143,10360,5092,5268,2534,2468,3197,2161
60144,58,25,33,14,18,16,10
60145,2627,1329,1298,781,594,880,372
60146,2713,1354,1359,804,660,810,439
60148,51468,24965,26503,12366,14020,15206,9876
60150,1794,913,881,538,476,486,294
60151,4061,2092,1969,1023,865,1455,718
60152,12533,6277,6256,3574,2763,3835,2361
60153,24106,11445,12661,7536,6483,6103,3984
60154,16773,7864,8909,3556,3479,4843,4895
60155,7927,3692,4235,2036,1940,2401,1550
60156,28987,14413,14574,9825,7932,8722,2508
60157,2380,1190,1190,581,401,851,547
60160,25432,12744,12688,8290,8058,5596,3488
60162,8111,3916,4195,2125,2117,2308,1561
60163,5209,2575,2634,1424,1280,1597,908
60164,22048,10946,11102,6438,5841,6029,3740
60165,4946,2571,2375,1837,1619,1029,461
60169,33847,16682,17165,9037,10150,9577,5083
60171,10246,5013,5233,2283,3081,3031,1851
60172,24537,11938,12599,6288,6158,8028,4063
60173,12217,6164,6053,2483,5154,3223,1357
60174,30752,15183,15569,7934,7167,9584,6067
60175,25564,13279,12285,8349,4142,9549,3524
60176,11795,5992,5803,2764,3930,3224,1877
60177,22659,11214,11445,7643,5779,6843,2394
60178,21840,10758,11082,6056,6146,6106,3532
60180,1694,860,834,440,305,602,347
60181,28836,14483,14353,7614,8183,8418,4621
60184,2448,1211,1237,636,343,954,515
60185,36527,18731,17796,11858,9902,10094,4673
60187,29016,14412,14604,8369,7455,8230,4962
60188,42656,20901,21755,12273,11432,13462,5489
60189,30472,14648,15824,8154,6616,10039,5663
60190,10663,5219,5444,2814,1940,3851,2058
60191,14310,7100,7210,3354,3482,4228,3246
60192,16343,8043,8300,4734,3649,5587,2373
60193,39188,18763,20425,8948,10046,12029,8165
60194,19777,9349,10428,4729,5441,5790,3817
60195,4769,2437,2332,875,2574,896,424
60201,43125,20706,22419,11089,14701,9431,7904
60202,31361,14784,16577,7339,9635,9429,4958
60203,4523,2136,2387,1279,747,1352,1145
60301,2539,1134,1405,368,944,634,593
60302,32108,14842,17266,7943,8156,10210,5799
60304,17231,8093,9138,5090,4351,5403,2387
60305,11172,5227,5945,3485,1924,3446,2317
60401,7797,3772,4025,1954,1507,2427,1909
60402,63448,31383,32065,19196,19143,16063,9046
60403,17529,8399,9130,4559,5049,4147,3774
60404,17395,8514,8881,5035,4113,5236,3011
60406,25460,12522,12938,8406,7503,6492,3059
60407,1684,845,839,497,404,541,242
60408,5696,2889,2807,1709,1434,1768,785
60409,37186,17111,20075,11648,9492,9981,6065
60410,12687,6368,6319,4200,2989,4000,1498
60411,58136,28032,30104,19709,15029,14732,8666
60415,14139,6936,7203,3650,4477,3652,2360
60416,9397,4740,4657,2792,2521,2613,1471
60417,15547,7599,7948,3527,2926,5070,4024
60419,22788,10355,12433,7374,5527,6705,3182
60420,6102,2461,3641,1323,1757,1932,1090
60421,3968,1980,1988,1027,955,1180,806
60422,9403,4452,4951,2664,1440,3155,2144
60423,30423,15028,15395,9366,5930,10077,5050
60424,2440,1249,1191,695,608,696,441
60425,9117,4233,4884,2555,2059,2569,1934
60426,29594,14326,15268,10197,7820,6964,4613
60428,12203,5702,6501,4035,2976,3069,2123
60429,15630,7024,8606,4845,3644,4355,2786
60430,20094,9362,10732,5422,4146,6435,4091
60431,22577,11294,11283,7335,6806,5699,2737
60432,21403,11014,10389,7561,7054,4554,2234
60433,17160,8506,8654,5268,4795,4135,2962
60435,48899,23631,25268,13959,14317,12263,8360
60436,18315,9071,9244,5600,5603,4360,2752
60437,187,91,96,53,39,57,38
60438,28884,13654,15230,7970,7118,8353,5443
60439,22919,11186,11733,6202,4190,7715,4812
60440,52911,26173,26738,16975,15429,14206,6301
60441,36869,19950,16919,10284,11324,10445,4816
60442,9924,5020,4904,3181,2718,2945,1080
60443,21145,9715,11430,5999,4733,6236,4177
60444,1761,866,895,524,396,500,341
60445,26057,12686,13371,6494,6884,7583,5096
60446,39807,19667,20140,13697,12311,9531,4268
60447,13709,6803,6906,4646,3888,3738,1437
60448,24423,12137,12286,7223,5203,8399,3598
60449,9217,4666,4551,2560,2082,2856,1719
60450,20332,10045,10287,5318,4875,6088,4051
60451,34063,16930,17133,10959,7367,11137,4600
60452,27969,13802,14167,7539,7334,8396,4700
60453,56855,27073,29782,13716,13890,15883,13366
60455,16446,8247,8199,4533,4436,4512,2965
60456,4349,2026,2323,1069,1130,1254,896
60457,14049,6994,7055,3537,3693,4063,2756
60458,14428,6900,7528,4202,4532,3789,1905
60459,28929,14332,14597,7970,7614,8014,5331
60460,1522,775,747,423,298,495,306
60461,4836,2254,2582,1049,744,1416,1627
60462,38723,18501,20222,8790,8239,11582,10112
60463,14671,6784,7887,3022,2425,4037,5187
60464,9620,4497,5123,1959,1452,3039,3170
60465,17495,8253,9242,3721,4486,4971,4317
60466,22115,9927,12188,6300,5571,6153,4091
60467,26046,12487,13559,6908,4238,8590,6310
60468,6116,3075,3041,1731,1323,1990,1072
60469,5930,2999,2931,2067,1746,1485,632
60470,616,317,299,169,146,177,124
60471,14101,6390,7711,4423,3666,4077,1935
60472,5390,2612,2778,1683,1223,1444,1040
60473,22439,10458,11981,6198,4404,6766,5071
60474,760,373,387,179,195,219,167
60475,9870,4808,5062,2707,2670,2803,1690
60476,2391,1165,1226,548,600,735,508
60477,38161,18192,19969,8993,9758,11246,8164
60478,16833,7647,9186,5179,3860,4865,2929
60479,760,396,364,202,169,238,151
60480,5246,2634,2612,1172,1188,1777,1109
60481,11851,6052,5799,2770,2603,3864,2614
60482,11063,5503,5560,2706,3082,3321,1954
60484,6829,3065,3764,2501,1823,1703,802
60487,26928,13146,13782,8181,6081,8806,3860
60490,20463,10198,10265,7592,5073,6263,1535
60491,22743,11310,11433,6161,4353,7959,4270
60501,11626,5888,5738,3795,3604,2771,1456
60502,21873,10702,11171,6975,6421,6401,2076
60503,16717,8247,8470,6132,5650,4016,919
60504,37919,18333,19586,12187,13198,9672,2862
60505,76573,39088,37485,27932,25010,16078,7553
60506,53013,26101,26912,17202,14988,13263,7560
60510,28897,14139,14758,8636,5577,9842,4842
60511,1793,927,866,429,329,669,366
60512,1111,581,530,256,203,383,269
60513,19047,9221,9826,4821,4848,5947,3431
60514,9708,4627,5081,3129,1738,3251,1590
60515,27503,13231,14272,7006,5864,8711,5922
60516,29084,14084,15000,6904,6207,9553,6420
60517,32038,15767,16271,8404,9463,9699,4472
60518,3580,1789,1791,968,848,1089,675
60519,88,43,45,28,21,32,7
60520,2886,1458,1428,781,667,968,470
60521,17597,8591,9006,6193,2135,6155,3114
60523,9890,4540,5350,1675,1278,2527,4410
60525,31168,14991,16177,8347,5859,9830,7132
60526,13576,6169,7407,3448,2614,3940,3574
60527,27486,13072,14414,6395,5866,8310,6915
60530,649,340,309,187,143,209,110
60531,1902,941,961,515,465,590,332
60532,27066,13433,13633,6190,8209,8143,4524
60534,10649,5340,5309,2786,3147,2854,1862
60536,126,64,62,33,29,39,25
60537,665,350,315,188,174,210,93
60538,26619,13081,13538,8987,8409,6034,3189
60539,341,168,173,261,51,28,1
60540,42910,20956,21954,12486,9430,13596,7398
60541,3148,1608,1540,917,675,1033,523
60542,17099,8317,8782,4959,4645,5064,2431
60543,36156,17849,18307,12138,9376,10452,4190
60544,25959,12523,13436,8174,6137,6492,5156
60545,12940,6438,6502,4321,4107,3066,1446
60546,15668,7548,8120,4037,3074,5000,3557
60548,12218,6125,6093,3334,2789,3647,2448
60549,643,320,323,173,131,224,115
60550,1440,675,765,373,260,431,376
60551,5062,3228,1834,1085,1674,1611,692
60552,4448,2215,2233,1207,993,1390,858
60553,782,423,359,212,149,259,162
60554,11796,5902,5894,3389,2511,3794,2102
60555,13538,6741,6797,3696,3678,4291,1873
60556,2007,984,1023,569,521,599,318
60557,155,89,66,40,29,51,35
60558,12960,6277,6683,4441,1614,4408,2497
60559,24852,11834,13018,6040,7061,7138,4613
60560,22415,11152,11263,7006,6213,6202,2994
60561,23115,11170,11945,5151,4624,7527,5813
60563,35922,17208,18714,8814,11322,9704,6082
60564,41312,20354,20958,15520,7146,15365,3281
60565,40524,19825,20699,12766,7206,14982,5570
60585,22311,11178,11133,8708,5494,6561,1548
60586,46251,23059,23192,17806,12864,12487,3094
60601,11110,5381,5729,1020,5739,2444,1907
60602,1204,582,622,154,619,255,176
60603,493,181,312,99,285,74,35
60604,570,279,291,38,305,136,91
60605,24668,12058,12610,3995,12480,5247,2946
60606,2308,1187,1121,100,1413,570,225
60607,23897,12148,11749,3368,14188,4431,1910
60608,82739,46367,36372,21845,32704,19427,8763
60609,64906,32356,32550,23051,20030,14763,7062
60610,37726,16924,20802,4410,17414,8242,7660
60611,28718,13104,15614,1747,12760,6939,7272
60612,33472,16038,17434,9421,12343,7647,4061
60613,48281,24514,23767,5394,27325,10000,5562
60614,66617,31745,34872,10341,35871,12695,7710
60615,40603,18373,22230,8352,15503,9591,7157
60616,48433,23520,24913,8852,17847,12488,9246
60617,84155,39258,44897,25945,21058,21224,15928
60618,92084,46094,45990,22885,36539,22072,10588
60619,63825,27823,36002,16753,14466,18464,14142
60620,72216,31816,40400,20634,17030,19060,15492
60621,35912,16086,19826,12162,9291,8800,5659
60622,52548,26577,25971,9081,28735,9972,4760
60623,92108,46188,45920,34289,29065,19751,9003
60624,38105,17668,20437,13064,10188,9450,5403
60625,78651,39591,39060,19126,31404,18924,9197
60626,50139,25286,24853,10756,20443,12700,6240
60628,72202,32612,39590,21700,17020,18484,14998
60629,113916,56240,57676,40854,35817,25888,11357
60630,54093,26432,27661,12771,15208,15829,10285
60631,28641,13485,15156,6338,6481,8681,7141
60632,91326,46717,44609,33286,29498,19735,8807
60633,12927,6360,6567,3683,3226,3606,2412
60634,74298,36399,37899,17906,20897,21391,14104
60636,40916,18976,21940,13769,10290,10022,6835
60637,49503,21956,27547,15916,14838,11423,7326
60638,55026,26821,28205,14578,14929,15071,10448
60639,90407,44906,45501,30941,28844,21279,9343
60640,65790,34150,31640,9857,27498,18374,10061
60641,71663,35678,35985,19210,22931,19582,9940
60642,18480,9652,8828,2695,10763,3361,1661
60643,49952,22641,27311,13698,10393,14622,11239
60644,48648,22214,26434,15269,12881,12754,7744
60645,45274,22078,23196,13083,12850,12026,7315
60646,27177,12953,14224,6536,5461,8261,6919
60647,87291,44168,43123,21168,39912,18382,7829
60649,46650,20334,26316,11906,12563,13455,8726
60651,64267,30345,33922,21050,18822,15606,8789
60652,40959,19507,21452,12989,10774,11516,5680
60653,29908,12717,17191,8633,8262,7619,5394
60654,14875,7758,7117,804,9093,3681,1297
60655,28550,13976,14574,8066,7437,8615,4432
60656,27613,13534,14079,5683,8000,7849,6081
60657,65996,32536,33460,6540,40765,11772,6919
60659,38104,19072,19032,10386,11784,9992,5942
60660,42752,21979,20773,7467,16888,11816,6581
60661,7792,3963,3829,609,5618,1241,324
60706,23134,10979,12155,4548,5483,6687,6416
60707,42920,20622,22298,10709,11935,12365,7911
60712,12590,6031,6559,3068,2441,3456,3625
60714,29931,14142,15789,5578,6290,8353,9710
60803,22285,10703,11582,5909,6279,6272,3825
60804,84573,43116,41457,31267,27658,18129,7519
60805,19852,9467,10385,5524,4773,6053,3502
60827,27946,12356,15590,10087,7345,7037,3477
60901,37157,18215,18942,10984,9876,9646,6651
60910,538,267,271,152,143,139,104
60911,1372,697,675,372,309,402,289
60912,599,286,313,163,124,165,147
60913,1617,832,785,405,310,559,343
60914,29107,13948,15159,8871,8128,7581,4527
60915,10774,5237,5537,3001,3015,2779,1979
60917,574,290,284,149,129,182,114
60918,898,450,448,239,176,253,230
60919,558,284,274,169,130,163,96
60920,178,88,90,51,41,51,35
60921,1519,742,777,396,306,453,364
60922,2459,1212,1247,642,570,752,495
60924,1635,772,863,398,263,466,508
60926,67,34,33,19,20,14,14
60927,2404,1168,1236,692,485,670,557
60928,709,338,371,159,154,209,187
60929,730,341,389,180,139,231,180
60930,918,423,495,229,187,235,267
60931,615,299,316,178,130,199,108
60932,78,38,40,26,15,22,15
60933,302,153,149,75,65,80,82
60934,273,147,126,74,59,80,60
60935,1064,546,518,298,241,324,201
60936,4321,2091,2230,1112,924,1166,1119
60938,2131,1023,1108,542,424,574,591
60940,3369,1690,1679,939,722,1042,666
60941,2039,1002,1037,596,473,527,443
60942,6181,2910,3271,1673,1303,1688,1517
60945,153,78,75,22,24,59,48
60946,426,212,214,118,77,132,99
60948,1533,749,784,379,263,435,456
60949,636,309,327,177,146,185,128
60950,12168,6044,6124,3394,2607,3333,2834
60951,961,484,477,251,189,319,202
60952,684,338,346,220,140,175,149
60953,2469,1193,1276,613,469,764,623
60954,6104,3157,2947,1504,1357,1902,1341
60955,1901,988,913,587,414,542,358
60957,5615,2709,2906,1475,1208,1623,1309
60958,2135,1057,1078,607,442,600,486
60959,1082,528,554,268,194,319,301
60960,1064,551,513,319,236,294,215
60961,700,366,334,151,121,238,190
60962,524,252,272,113,103,165,143
60963,1807,882,925,490,387,483,447
60964,4968,2505,2463,1213,1082,1464,1209
60966,1526,754,772,379,322,443,382
60968,433,221,212,108,82,125,118
60969,65,33,32,17,15,19,14
60970,7190,3447,3743,1776,1471,1989,1954
60973,385,203,182,88,62,115,120
60974,283,148,135,89,61,72,61
61001,1179,608,571,195,164,320,500
61006,1759,889,870,471,340,576,372
61007,534,284,250,138,84,188,124
61008,34311,17025,17286,10804,8097,9430,5980
61010,8032,3921,4111,2388,1670,2616,1358
61011,2945,1469,1476,760,574,1038,573
61012,2175,1119,1056,661,531,629,354
61013,528,262,266,121,118,163,126
61014,1173,603,570,284,214,382,293
61015,946,486,460,226,157,329,234
61016,4837,2451,2386,1085,1071,1636,1045
61018,1080,542,538,296,243,316,225
61019,3550,1776,1774,817,515,1000,1218
61020,3108,1573,1535,1083,838,849,338
61021,23745,12706,11039,5244,5874,7369,5258
61024,2620,1298,1322,698,508,819,595
61025,4867,2491,2376,1270,1013,1439,1145
61027,52,27,25,10,10,18,14
61028,1989,984,1005,455,353,550,631
61030,2205,1099,1106,633,441,668,463
61031,1656,805,851,431,343,431,451
61032,31651,15065,16586,7954,6782,8947,7968
61036,6821,3393,3428,1335,1205,1927,2354
61037,140,66,74,43,26,37,34
61038,1354,679,675,339,250,490,275
61039,802,421,381,215,177,250,160
61041,1327,646,681,305,226,408,388
61042,527,285,242,146,91,172,118
61043,131,73,58,35,29,35,32
61044,232,110,122,61,40,89,42
61046,2831,1415,1416,581,486,829,935
61047,1711,875,836,390,311,568,442
61048,4360,2141,2219,1121,833,1257,1149
61049,585,306,279,178,115,181,111
61050,376,205,171,87,90,113,86
61051,1574,794,780,400,341,432,401
61052,1148,588,560,302,263,370,213
61053,2852,1403,1449,645,526,848,833
61054,3973,1919,2054,968,799,1128,1078
61057,168,88,80,58,46,48,16
61059,141,74,67,45,26,46,24
61060,1432,700,732,365,282,464,321
61061,7009,3481,3528,1551,1371,2186,1901
61062,1983,998,985,569,412,597,405
61063,4132,2043,2089,1101,871,1277,883
61064,3868,1861,2007,995,790,1134,949
61065,11156,5632,5524,3905,2724,3090,1437
61067,811,406,405,172,145,276,218
61068,14858,7365,7493,4383,3727,4088,2660
61070,1130,582,548,322,205,360,243
61071,14381,7052,7329,3747,3207,4084,3343
61072,11797,5708,6089,3505,2468,3627,2197
61073,20052,9963,10089,5965,4128,6734,3225
61074,4431,2226,2205,1040,939,1228,1224
61075,958,496,462,218,196,302,242
61077,73,33,40,17,16,23,17
61078,1374,685,689,361,275,379,359
61079,188,104,84,58,35,60,35
61080,10599,5246,5353,3114,2675,3062,1748
61081,21934,10632,11302,5880,4981,6135,4938
61084,3175,1587,1588,915,627,1029,604
61085,3443,1723,1720,819,668,1008,948
61087,1670,813,857,419,345,489,417
61088,6020,3004,3016,1728,1300,1915,1077
61089,867,453,414,229,202,275,161
61091,63,34,29,11,14,22,16
61101,21593,10351,11242,7096,5459,5543,3495
61102,20538,10384,10154,6699,5440,5360,3039
61103,24578,11682,12896,6335,6247,6803,5193
61104,19269,9564,9705,6384,5778,4833,2274
61107,30439,14534,15905,7114,7201,8518,7606
61108,28550,13852,14698,6840,7295,7567,6848
61109,28333,14230,14103,7807,7817,7763,4946
61111,23492,11399,12093,6195,6285,6717,4295
61112,86,20,66,0,2,1,83
61114,15776,7371,8405,3702,2971,4640,4463
61115,23180,11588,11592,6302,5843,6784,4251
61201,39116,18763,20353,10328,10586,10065,8137
61230,1232,631,601,288,271,366,307
61231,5627,2731,2896,1373,1073,1594,1587
61232,1284,650,634,328,274,422,260
61234,1258,611,647,342,253,366,297
61235,1391,710,681,328,291,437,335
61236,193,101,92,66,48,54,25
61238,3247,1643,1604,809,772,930,736
61239,1219,559,660,474,345,221,179
61240,5870,2966,2904,1429,1103,1906,1432
61241,7124,3623,3501,1862,1738,2129,1395
61242,1145,608,537,257,219,361,308
61243,264,125,139,86,41,89,48
61244,24053,12253,11800,5846,6187,6493,5527
61250,2737,1346,1391,734,594,803,606
61251,347,179,168,92,61,104,90
61252,5436,2704,2732,1282,1052,1662,1440
61254,11414,5531,5883,2921,2135,3374,2984
61256,1822,912,910,440,350,553,479
61257,1210,640,570,300,258,381,271
61258,204,99,105,60,43,52,49
61259,1276,640,636,313,211,461,291
61260,856,425,431,222,182,248,204
61261,975,499,476,253,195,314,213
61262,1188,607,581,296,230,370,292
61263,530,268,262,160,143,144,83
61264,10548,5181,5367,2474,2326,3149,2599
61265,45099,21865,23234,11373,11481,12262,9983
61270,7306,3626,3680,1792,1500,2126,1888
61272,1504,740,764,356,324,449,375
61273,3316,1640,1676,933,702,921,760
61274,351,194,157,90,72,123,66
61275,4347,2208,2139,1093,846,1462,946
61276,138,68,70,44,29,32,33
61277,3355,1677,1678,809,615,1014,917
61278,412,210,202,92,78,124,118
61279,1061,533,528,286,207,332,236
61281,2597,1328,1269,641,498,901,557
61282,7809,3747,4062,1973,1843,2127,1866
61283,1640,813,827,533,376,409,322
61284,2292,1171,1121,533,389,801,569
61285,1631,823,808,333,328,469,501
61301,10588,5323,5265,2742,2654,2986,2206
61310,3970,1966,2004,1042,812,1234,882
61311,232,120,112,44,38,73,77
61312,474,240,234,109,93,160,112
61313,282,146,136,71,49,92,70
61314,807,393,414,225,166,253,163
61315,322,162,160,92,70,111,49
61316,282,134,148,73,67,70,72
61317,513,261,252,129,111,150,123
61318,700,360,340,185,155,215,145
61319,1293,663,630,328,254,423,288
61320,710,346,364,167,137,237,169
61321,282,149,133,74,59,101,48
61322,1647,846,801,542,407,414,284
61323,111,46,65,33,23,37,18
61324,109,58,51,25,19,37,28
61325,1073,553,520,325,242,284,222
61326,2452,1215,1237,615,537,755,545
61327,1235,627,608,291,240,400,304
61328,42,21,21,12,13,11,6
61329,1303,636,667,329,341,333,300
61330,1483,741,742,400,299,448,336
61331,55,27,28,17,16,14,8
61332,134,61,73,34,31,30,39
61333,381,185,196,85,91,119,86
61334,741,364,377,200,177,189,175
61335,532,273,259,115,92,177,148
61336,628,315,313,164,142,208,114
61337,478,236,242,136,106,140,96
61338,284,139,145,86,65,75,58
61340,292,147,145,83,59,92,58
61341,8234,4080,4154,2146,1850,2560,1678
61342,9216,4454,4762,2504,2103,2429,2180
61344,374,193,181,97,89,104,84
61345,846,411,435,186,188,262,210
61346,75,39,36,19,14,17,25
61348,4696,2310,2386,1195,1096,1318,1087
61349,977,470,507,254,195,282,246
61350,24246,11939,12307,6059,5539,7181,5467
61353,1333,657,676,375,279,404,275
61354,10870,5209,5661,2488,2291,3067,3024
61356,11281,5393,5888,2639,2234,3268,3140
61358,478,245,233,103,111,154,110
61359,312,150,162,70,70,107,65
61360,3393,1699,1694,992,755,1023,623
61361,1409,718,691,357,296,408,348
61362,5911,2850,3061,1532,1364,1673,1342
61363,220,107,113,49,52,61,58
61364,20133,9871,10262,5268,4387,5676,4802
61367,864,425,439,200,144,261,259
61368,1489,774,715,396,291,412,390
61369,1711,818,893,417,314,514,466
61370,1460,750,710,400,312,423,325
61372,145,78,67,31,50,42,22
61373,2031,984,1047,486,428,678,439
61374,119,58,61,29,15,42,33
61375,1156,578,578,232,186,347,391
61376,2280,1119,1161,656,438,628,558
61377,1457,697,760,426,319,378,334
61378,512,267,245,138,96,173,105
61379,1359,683,676,352,310,413,284
61401,34788,17559,17229,8062,9079,9198,8449
61410,3912,1905,2007,1031,872,1086,923
61411,378,187,191,74,68,120,116
61412,1321,643,678,312,255,400,354
61413,1075,535,540,268,223,327,257
61414,854,422,432,201,178,272,203
61415,1747,863,884,412,347,490,498
61416,235,117,118,66,53,76,40
61417,259,135,124,52,51,90,66
61418,673,331,342,151,134,197,191
61419,128,60,68,17,23,40,48
61420,1067,538,529,221,237,307,302
61421,1392,691,701,409,261,393,329
61422,3416,1666,1750,912,753,924,827
61423,682,344,338,160,118,237,167
61424,100,52,48,30,26,22,22
61425,483,242,241,87,63,182,151
61426,107,52,55,34,25,29,19
61427,2329,1125,1204,562,497,637,633
61428,986,496,490,159,145,332,350
61430,828,427,401,193,164,256,215
61431,371,183,188,91,68,109,103
61432,676,334,342,192,146,189,149
61433,74,37,37,26,20,12,16
61434,3312,1642,1670,874,705,920,813
61435,116,52,64,13,15,33,55
61436,951,484,467,242,184,293,232
61437,818,401,417,174,138,288,218
61438,760,394,366,182,149,245,184
61439,269,134,135,54,56,73,86
61440,766,375,391,188,165,220,193
61441,897,456,441,193,186,274,244
61442,762,373,389,162,151,228,221
61443,14214,7036,7178,3997,3225,3771,3221
61447,924,448,476,228,195,292,209
61448,3823,1857,1966,955,735,1097,1036
61449,512,253,259,125,85,165,137
61450,1742,862,880,432,334,502,474
61451,393,203,190,107,81,138,67
61452,293,151,142,78,59,96,60
61453,781,376,405,225,185,214,157
61454,725,348,377,175,127,221,202
61455,22086,11120,10966,5117,9526,3779,3664
61458,822,421,401,176,169,231,246
61459,433,220,213,90,86,146,111
61460,291,156,135,56,61,100,74
61462,11643,5645,5998,3276,3085,2878,2404
61465,1213,611,602,308,256,372,277
61466,342,184,158,82,83,91,86
61467,1048,512,536,302,198,305,243
61468,104,56,48,38,18,26,22
61469,2184,1100,1084,487,390,688,619
61470,547,272,275,141,123,144,139
61471,140,71,69,22,31,41,46
61472,648,322,326,157,112,208,171
61473,1667,786,881,359,314,482,512
61474,292,148,144,50,54,91,97
61475,205,101,104,54,37,56,58
61476,407,202,205,110,82,124,91
61477,631,319,312,143,104,195,189
61478,290,140,150,86,56,68,80
61479,165,91,74,45,37,45,38
61480,1324,622,702,339,269,360,356
61482,650,330,320,161,159,183,147
61483,1961,946,1015,464,362,545,590
61484,825,423,402,201,158,260,206
61485,560,302,258,152,106,184,118
61486,1552,751,801,418,319,435,380
61488,1120,561,559,285,242,333,260
61489,900,461,439,229,175,262,234
61490,1091,550,541,256,218,341,276
61491,2197,1079,1118,554,461,615,567
61501,1921,966,955,485,415,534,487
61516,720,346,374,206,179,171,164
61517,3259,1650,1609,902,602,1019,736
61519,233,116,117,62,47,78,46
61520,17839,9650,8189,3933,4948,4921,4037
61523,11204,5527,5677,2880,2455,3297,2572
61524,262,129,133,59,51,86,66
61525,9021,4481,4540,2916,2032,2754,1319
61526,1088,549,539,302,185,374,227
61528,2668,1363,1305,831,633,750,454
61529,2880,1433,1447,851,626,785,618
61530,6713,3274,3439,1969,1651,1660,1433
61531,3379,1634,1745,913,738,920,808
61532,534,267,267,159,93,156,126
61533,2427,1200,1227,591,548,759,529
61534,1737,878,859,467,371,554,345
61535,1629,829,800,421,275,547,386
61536,2919,1429,1490,687,596,900,736
61537,2974,1426,1548,759,600,820,795
61539,205,111,94,50,52,57,46
61540,2916,1433,1483,655,599,860,802
61541,136,70,66,31,38,39,28
61542,3794,1864,1930,832,821,1121,1020
61543,151,80,71,25,36,44,46
61544,713,354,359,166,135,222,190
61545,646,326,320,160,129,224,133
61546,4276,2169,2107,1079,895,1354,948
61547,3779,1884,1895,1022,766,1273,718
61548,12085,5982,6103,3667,2538,3659,2221
61550,17721,8552,9169,4503,3970,4882,4366
61552,239,114,125,70,59,62,48
61553,213,96,117,49,54,56,54
61554,43810,21624,22186,10774,11491,12206,9339
61559,3332,1650,1682,992,692,919,729
61560,754,405,349,129,99,236,290
61561,2788,1373,1415,768,592,790,638
61562,46,24,22,13,12,15,6
61563,526,263,263,132,134,143,117
61564,1077,517,560,352,297,266,162
61565,1504,777,727,348,309,489,358
61567,624,314,310,138,93,225,168
61568,4459,2226,2233,1339,929,1264,927
61569,1220,616,604,279,231,404,306
61570,1879,936,943,538,433,522,386
61571,23744,11573,12171,6721,5881,6415,4727
61572,1068,552,516,266,216,316,270
61602,1055,677,378,58,476,353,168
61603,17600,8528,9072,5810,5396,4349,2045
61604,31647,14969,16678,8386,8661,8180,6420
61605,16303,7624,8679,5867,4089,3819,2528
61606,8051,3922,4129,2484,3730,1223,614
61607,10941,5386,5555,2650,2465,3259,2567
61610,5476,2809,2667,1409,1467,1601,999
61611,25268,12474,12794,6007,6061,7257,5943
61614,27628,13115,14513,5935,7248,7029,7416
61615,22432,10890,11542,5603,6076,6256,4497
61616,6116,2967,3149,1358,1865,1683,1210
61625,385,122,263,125,259,1,0
61701,36105,17457,18648,8799,12222,8947,6137
61704,35981,17665,18316,10466,9966,10614,4935
61705,12263,6079,6184,3856,2897,3905,1605
61720,236,124,112,56,51,75,54
61721,613,326,287,172,135,165,141
61722,549,278,271,158,126,174,91
61723,2321,1135,1186,589,527,700,505
61724,536,269,267,131,120,175,110
61725,1547,791,756,458,313,493,283
61726,2544,1295,1249,672,557,711,604
61727,10015,4906,5109,2610,2299,2887,2219
61728,1410,713,697,364,324,433,289
61729,1073,546,527,314,244,291,224
61730,379,196,183,92,97,127,63
61731,280,144,136,91,59,73,57
61732,2096,1047,1049,584,491,650,371
61733,1124,568,556,297,298,350,179
61734,2867,1398,1469,765,600,860,642
61735,420,208,212,87,75,142,116
61736,1808,916,892,580,393,581,254
61737,516,252,264,120,104,205,87
61738,4212,2077,2135,1159,917,1275,861
61739,4897,2431,2466,1430,1012,1302,1153
61740,1634,780,854,400,319,449,466
61741,1746,883,863,545,416,455,330
61742,1144,567,577,381,264,317,182
61743,212,103,109,55,41,67,49
61744,2031,1016,1015,599,444,579,409
61745,4408,2183,2225,1383,1010,1322,693
61747,1560,745,815,442,310,418,390
61748,2782,1411,1371,763,574,887,558
61749,556,291,265,108,106,190,152
61750,133,71,62,31,28,36,38
61751,124,65,59,32,22,43,27
61752,4339,2138,2201,1225,985,1201,928
61753,3012,1512,1500,834,685,894,599
61754,1261,611,650,325,290,408,238
61755,4669,2361,2308,1438,1060,1386,785
61756,2337,1170,1167,680,525,690,442
61759,1534,759,775,394,341,454,345
61760,2544,1221,1323,724,503,753,564
61761,52879,24926,27953,14706,22648,9466,6059
61764,14460,7889,6571,3435,3848,4261,2916
61769,619,318,301,178,125,200,116
61770,1108,543,565,293,230,327,258
61771,860,427,433,241,194,283,142
61772,351,181,170,82,65,121,83
61773,477,243,234,125,107,141,104
61774,962,502,460,255,240,319,148
61775,307,145,162,113,61,90,43
61776,1409,713,696,334,289,472,314
61777,952,460,492,229,207,292,224
61778,683,348,335,166,145,231,141
61801,30937,15858,15079,7651,16204,4000,3082
61802,19052,9108,9944,4451,6121,4789,3691
61810,361,190,171,101,92,99,69
61811,703,362,341,207,148,221,127
61812,375,196,179,90,57,134,94
61813,1971,973,998,530,449,553,439
61814,1157,573,584,320,224,358,255
61815,228,105,123,51,50,78,49
61816,509,255,254,140,110,151,108
61817,2583,1283,1300,703,570,692,618
61818,1665,807,858,508,374,468,315
61820,36964,20060,16904,9339,21545,3967,2113
61821,30174,14401,15773,7951,9264,7526,5433
61822,21608,10646,10962,5629,6151,6368,3460
61830,478,240,238,113,101,140,124
61831,157,82,75,32,19,58,48
61832,37290,17773,19517,10799,8827,9460,8204
61833,2124,1028,1096,483,455,598,588
61834,8454,5144,3310,1605,2461,2623,1765
61839,586,296,290,142,138,180,126
61840,709,354,355,184,146,227,152
61841,1386,654,732,348,296,415,327
61842,2984,1492,1492,780,635,894,675
61843,2363,1177,1186,708,525,690,440
61844,970,474,496,220,219,330,201
61845,364,184,180,82,82,116,84
61846,5101,2524,2577,1477,1163,1373,1088
61847,1256,603,653,311,255,369,321
61848,227,106,121,69,53,69,36
61849,1842,925,917,509,393,552,388
61850,671,354,317,168,131,195,177
61851,436,215,221,102,84,151,99
61852,261,133,128,71,54,89,47
61853,13206,6516,6690,4068,2995,4153,1990
61854,1438,729,709,342,335,466,295
61855,96,53,43,20,23,30,23
61856,7433,3607,3826,1946,1466,2270,1751
61857,153,80,73,42,23,53,35
61858,3124,1531,1593,832,621,914,757
61859,1297,648,649,365,285,387,260
61862,510,258,252,149,105,157,99
61863,814,410,404,200,178,245,191
61864,1715,860,855,551,368,520,276
61865,1391,692,699,387,309,403,292
61866,14048,6747,7301,4438,3752,3614,2244
61870,1327,644,683,367,293,359,308
61871,284,139,145,60,59,90,75
61872,760,387,373,182,155,269,154
61873,6250,3006,3244,1914,1504,1856,976
61874,7114,3259,3855,1550,2884,1338,1342
61875,761,388,373,213,155,240,153
61876,800,407,393,216,167,236,181
61877,1627,798,829,484,355,502,286
61878,1433,702,731,297,345,445,346
61880,4183,2084,2099,1248,1080,1229,626
61882,713,367,346,167,172,221,153
61883,4438,2141,2297,1118,1035,1281,1004
61884,1244,631,613,301,192,479,272
61910,4463,2227,2236,1419,1033,1189,822
61911,4860,2402,2458,1664,1179,1051,966
61912,1344,671,673,348,313,417,266
61913,1684,827,857,411,384,490,399
61914,1920,951,969,511,405,545,459
61917,591,304,287,149,131,170,141
61919,813,425,388,175,159,276,203
61920,25594,12203,13391,6248,11026,4688,3632
61924,2449,1187,1262,582,498,663,706
61925,912,462,450,258,208,300,146
61928,757,362,395,174,166,268,149
61929,769,413,356,209,158,229,173
61930,515,250,265,124,121,145,125
61931,1255,633,622,368,307,346,234
61932,456,219,237,101,80,150,125
61933,1141,551,590,299,279,305,258
61936,243,120,123,54,63,73,53
61937,2022,986,1036,564,465,559,434
61938,22409,10784,11625,5710,5577,5940,5182
61940,258,124,134,69,57,83,49
61941,57,31,26,9,10,22,16
61942,1202,563,639,262,233,353,354
61943,1637,826,811,367,320,523,427
61944,12908,6220,6688,3148,2880,3663,3217
61949,179,91,88,46,36,53,44
61951,8017,3873,4144,2048,1745,2146,2078
61953,6216,2992,3224,1660,1457,1755,1344
61955,157,81,76,42,33,47,35
61956,2909,1478,1431,792,725,788,604
61957,1869,929,940,495,416,545,413
62001,1752,875,877,396,329,584,443
62002,32704,15763,16941,8326,8672,8954,6752
62006,648,340,308,168,170,173,137
62009,1810,919,891,482,419,478,431
62010,11186,5441,5745,2824,2721,3210,2431
62011,284,154,130,86,65,77,56
62012,6654,3331,3323,1760,1440,2053,1401
62013,552,281,271,119,114,173,146
62014,4122,2078,2044,1087,879,1251,905
62015,487,247,240,104,87,175,121
62016,3816,1877,1939,962,819,1101,934
62017,1185,594,591,302,252,346,285
62018,3604,1813,1791,1019,913,1009,663
62019,490,250,240,114,83,174,119
62021,936,479,457,181,174,344,237
62022,1138,585,553,292,221,397,228
62023,91,41,50,29,21,27,14
62024,9775,4860,4915,2292,2424,2809,2250
62025,33748,16594,17154,8996,10068,9243,5441
62027,536,270,266,121,90,184,141
62028,1276,603,673,358,470,257,191
62030,114,59,55,28,31,38,17
62031,970,489,481,235,195,320,220
62032,749,398,351,197,144,239,169
62033,4894,2395,2499,1267,1100,1394,1133
62034,13819,6685,7134,3502,3874,3693,2750
62035,16494,8029,8465,3834,3464,4906,4290
62036,704,338,366,164,118,207,215
62037,1993,1022,971,480,381,697,435
62040,43735,21343,22392,11045,11529,12425,8736
62044,2009,989,1020,538,440,591,440
62045,647,329,318,154,123,203,167
62046,713,347,366,202,214,162,135
62047,1555,742,813,385,336,425,409
62048,1459,720,739,351,363,431,314
62049,8470,5079,3391,1652,2628,2442,1748
62050,473,242,231,121,93,148,111
62051,950,494,456,224,203,315,208
62052,13002,6216,6786,3365,3064,3620,2953
62053,650,321,329,146,113,202,189
62054,872,467,405,233,206,274,159
62056,8930,4291,4639,2275,1930,2489,2236
62058,843,413,430,202,234,238,169
62059,746,320,426,273,188,161,124
62060,4847,2309,2538,1448,1205,1326,868
62061,1718,874,844,421,435,529,333
62062,7658,3727,3931,1845,2004,2295,1514
62063,1214,603,611,333,284,332,265
62065,97,51,46,19,11,35,32
62067,2401,1174,1227,605,502,770,524
62069,3313,1621,1692,787,739,1031,756
62070,37,20,17,3,1,14,19
62074,1087,563,524,263,212,360,252
62075,3458,1721,1737,895,738,960,865
62076,135,68,67,29,22,47,37
62077,347,179,168,80,81,88,98
62078,119,60,59,37,32,36,14
62079,256,124,132,56,47,82,71
62080,2508,1206,1302,715,524,689,580
62081,298,148,150,60,74,89,75
62082,3109,1675,1434,779,780,925,625
62083,295,142,153,98,64,79,54
62084,1606,770,836,437,425,425,319
62085,209,102,107,50,53,62,44
62086,1437,708,729,378,288,480,291
62087,2087,1065,1022,601,576,581,329
62088,6960,3368,3592,1711,1696,1930,1623
62089,489,255,234,110,114,157,108
62090,1189,502,687,425,306,278,180
62091,337,169,168,70,66,117,84
62092,2979,1455,1524,767,658,807,747
62093,435,217,218,119,106,127,83
62094,1152,576,576,282,234,360,276
62095,11237,5432,5805,2774,3098,3014,2351
62097,2828,1434,1394,722,659,922,525
62098,91,45,46,31,20,27,13
62201,7547,3372,4175,3120,2171,1374,882
62203,8209,4299,3910,2100,2248,2243,1618
62204,7960,3738,4222,2707,1986,2039,1228
62205,9329,4367,4962,2620,2212,2517,1980
62206,16509,7651,8858,5905,4306,4140,2158
62207,8750,3882,4868,2955,2044,2154,1597
62208,17376,8498,8878,4058,4816,5026,3476
62214,1229,633,596,284,271,427,247
62215,1872,969,903,561,489,569,253
62216,2526,1243,1283,728,694,678,426
62217,807,425,382,194,167,276,170
62218,1481,773,708,435,352,467,227
62219,1009,516,493,264,289,257,199
62220,20504,10015,10489,5477,5677,5851,3499
62221,27858,13342,14516,7604,7806,8008,4440
62223,17560,8390,9170,4126,4058,5155,4221
62225,5381,2770,2611,2309,2226,816,30
62226,29744,13842,15902,7380,7618,8681,6065
62230,6194,3028,3166,1665,1491,1782,1256
62231,7589,3787,3802,1845,1748,2211,1785
62232,7260,3562,3698,1812,1796,2174,1478
62233,10037,6825,3212,1653,3726,3039,1619
62234,33430,16453,16977,8217,9563,9327,6323
62236,12562,6148,6414,3407,2767,4044,2344
62237,2659,1297,1362,603,555,807,694
62238,696,345,351,166,183,209,138
62239,4954,2429,2525,1306,1371,1462,815
62240,1966,978,988,492,446,665,363
62241,1061,533,528,279,218,345,219
62242,1526,759,767,360,344,427,395
62243,5910,2909,3001,1479,1207,2018,1206
62244,1156,595,561,280,255,428,193
62245,1794,898,896,473,422,548,351
62246,10355,5522,4833,2268,3206,2771,2110
62248,320,169,151,96,80,78,66
62249,15971,7770,8201,4365,3861,4559,3186
62250,504,246,258,144,119,152,89
62253,696,346,350,149,136,206,205
62254,6089,2989,3100,1565,1705,1574,1245
62255,1001,507,494,252,187,372,190
62257,3214,1596,1618,810,705,940,759
62258,9199,4553,4646,2647,2326,2722,1504
62260,7290,3600,3690,1833,1578,2395,1484
62261,152,80,72,34,28,54,36
62262,1810,902,908,463,374,526,447
62263,5387,2645,2742,1313,1233,1570,1271
62264,3338,1623,1715,850,769,1010,709
62265,4353,2107,2246,1226,1073,1268,786
62266,254,134,120,77,70,85,22
62268,738,390,348,176,142,224,196
62269,31348,15262,16086,9301,7791,9787,4469
62271,2077,1032,1045,520,488,613,456
62272,1674,856,818,401,401,492,380
62273,426,218,208,117,124,122,63
62274,8410,5323,3087,1625,2911,2318,1556
62275,3621,1872,1749,958,792,1172,699
62277,1314,657,657,350,304,405,255
62278,6690,3258,3432,1675,1523,1923,1569
62279,69,32,37,17,15,23,14
62280,444,228,216,107,95,143,99
62281,2155,1058,1097,566,523,705,361
62282,471,225,246,111,122,134,104
62284,636,324,312,157,133,221,125
62285,4484,2181,2303,1249,1010,1376,849
62286,6008,2966,3042,1483,1266,1808,1451
62288,2918,1448,1470,696,640,829,753
62289,350,187,163,96,83,113,58
62292,947,473,474,226,227,279,215
62293,4748,2388,2360,1179,1070,1490,1009
62294,14367,7105,7262,4162,3607,4503,2095
62295,1599,803,796,498,398,460,243
62297,452,230,222,104,84,151,113
62298,16609,8202,8407,4304,3612,5367,3326
62301,33758,16239,17519,8560,8940,8506,7752
62305,18052,8797,9255,4580,3432,5434,4606
62311,860,422,438,215,174,238,233
62312,2162,1005,1157,557,434,610,561
62313,389,195,194,98,88,105,98
62314,611,312,299,152,128,191,140
62316,660,332,328,173,174,180,133
62319,264,139,125,55,56,78,75
62320,2185,1098,1087,596,455,661,473
62321,4091,2019,2072,986,852,1147,1106
62323,290,150,140,82,61,79,68
62324,1361,677,684,412,306,361,282
62325,403,198,205,122,97,112,72
62326,2478,1233,1245,571,569,727,611
62330,1769,860,909,405,356,507,501
62334,172,88,84,33,40,52,47
62336,47,24,23,6,12,16,13
62338,1473,735,738,400,300,491,282
62339,874,426,448,226,168,234,246
62340,1715,842,873,466,367,472,410
62341,3610,1719,1891,918,743,1024,925
62343,712,363,349,173,161,215,163
62344,138,66,72,35,22,44,37
62345,357,169,188,90,82,102,83
62346,178,92,86,44,34,46,54
62347,2282,1180,1102,628,518,695,441
62348,170,76,94,57,41,47,25
62349,636,315,321,172,106,198,160
62351,1856,897,959,483,370,540,463
62352,271,130,141,89,61,70,51
62353,5637,3800,1837,997,2253,1565,822
62354,1684,823,861,360,257,450,617
62355,820,436,384,203,180,231,206
62356,571,279,292,146,133,168,124
62357,245,117,128,66,47,61,71
62358,752,388,364,205,147,219,181
62359,166,73,93,46,32,42,46
62360,1656,820,836,460,401,466,329
62361,539,283,256,165,115,136,123
62362,399,176,223,97,83,96,123
62363,6353,3258,3095,1471,1459,1723,1700
62365,647,344,303,175,152,190,130
62366,1408,698,710,371,284,414,339
62367,1345,673,672,409,265,357,314
62370,520,264,256,125,99,178,118
62373,300,146,154,83,41,100,76
62374,298,145,153,60,51,105,82
62375,369,186,183,97,71,116,85
62376,1198,593,605,316,263,357,262
62378,896,447,449,206,168,288,234
62379,2049,1025,1024,466,450,625,508
62380,401,202,199,115,77,117,92
62401,19096,9415,9681,4967,4566,5363,4200
62410,985,497,488,276,222,292,195
62411,4430,2136,2294,1212,1069,1193,956
62413,421,212,209,117,88,141,75
62414,1886,963,923,506,422,548,410
62417,3064,1485,1579,811,733,841,679
62418,2133,1057,1076,581,471,631,450
62419,410,216,194,91,92,130,97
62420,4759,2313,2446,1209,999,1336,1215
62421,778,399,379,213,148,236,181
62422,1156,577,579,322,273,304,257
62423,724,367,357,187,155,253,129
62424,2092,1055,1037,688,488,585,331
62425,649,327,322,157,146,210,136
62426,1085,559,526,266,250,339,230
62427,1702,869,833,430,365,497,410
62428,3104,1530,1574,752,661,884,807
62431,1232,618,614,328,255,340,309
62432,571,290,281,134,125,180,132
62433,998,524,474,217,198,322,261
62434,330,174,156,70,78,81,101
62436,562,296,266,137,130,179,116
62438,433,217,216,101,95,143,94
62439,7536,3629,3907,1764,1621,2135,2016
62440,1316,687,629,331,305,438,242
62441,7395,3588,3807,1891,1640,2142,1722
62442,2421,1185,1236,563,524,730,604
62443,1623,835,788,458,348,496,321
62444,387,194,193,104,87,99,97
62445,907,463,444,233,211,280,183
62446,414,225,189,104,74,134,102
62447,3404,1678,1726,907,679,943,875
62448,5834,2831,3003,1474,1279,1703,1378
62449,3175,1535,1640,834,631,920,790
62450,12218,5904,6314,3053,2744,3263,3158
62451,2156,1072,1084,512,495,602,547
62452,400,215,185,102,81,124,93
62454,11467,6148,5319,2491,3086,3373,2517
62458,2228,1088,1140,631,484,601,512
62459,243,119,124,63,53,57,70
62460,1231,619,612,317,267,362,285
62461,854,442,412,210,186,260,198
62462,1149,603,546,368,274,294,213
62463,1294,647,647,355,275,360,304
62465,858,435,423,213,172,260,213
62466,4848,3596,1252,739,2202,1374,533
62467,3741,1930,1811,1169,859,1059,654
62468,2564,1306,1258,648,632,753,531
62469,419,209,210,110,103,119,87
62471,10233,5730,4503,2321,2990,2857,2065
62473,1422,711,711,449,344,432,197
62474,848,424,424,221,180,269,178
62475,387,195,192,95,74,144,74
62476,1734,891,843,436,376,495,427
62477,946,472,474,227,212,297,210
62478,398,191,207,98,93,125,82
62479,820,443,377,212,203,222,183
62480,787,401,386,204,165,237,181
62481,386,196,190,91,74,129,92
62501,2661,1358,1303,668,513,881,599
62510,1669,814,855,471,321,481,396
62512,500,258,242,130,111,158,101
62513,1766,888,878,543,405,510,308
62514,252,127,125,65,50,88,49
62515,961,489,472,230,214,306,211
62517,226,108,118,66,56,53,51
62518,457,240,217,118,91,142,106
62519,94,44,50,21,19,26,28
62520,1529,783,746,391,310,524,304
62521,35851,17137,18714,8832,7935,10203,8881
62522,16630,7902,8728,4771,4805,4212,2842
62523,1237,734,503,247,434,418,138
62526,34075,15765,18310,8228,8379,9092,8376
62530,1532,770,762,390,334,522,286
62531,1792,933,859,420,411,558,403
62532,105,50,55,23,25,30,27
62533,973,466,507,243,216,305,209
62534,1130,558,572,257,237,323,313
62535,3534,1745,1789,1029,606,1078,821
62536,912,465,447,243,160,368,141
62537,92,46,46,27,19,31,15
62538,378,196,182,89,76,125,88
62539,1358,670,688,391,302,402,263
62540,1492,737,755,399,355,399,339
62541,57,31,26,12,9,20,16
62543,540,282,258,151,103,162,124
62544,1776,891,885,435,385,566,390
62545,1246,629,617,331,304,392,219
62546,1630,820,810,457,339,467,367
62547,804,390,414,199,164,240,201
62548,2258,1078,1180,567,430,621,640
62549,6269,3032,3237,1879,1440,1724,1226
62550,2869,1392,1477,757,597,828,687
62551,837,429,408,247,197,239,154
62553,437,230,207,124,92,123,98
62554,1563,778,785,393,337,476,357
62555,540,263,277,140,101,176,123
62556,422,207,215,114,85,119,104
62557,7607,3701,3906,1931,1604,2064,2008
62558,3590,1778,1812,1035,856,1023,676
62560,1508,743,765,388,310,474,336
62561,5315,2611,2704,1567,1226,1622,900
62563,5686,2817,2869,1698,982,1926,1080
62565,7538,3687,3851,1766,1590,2096,2086
62567,1154,564,590,333,265,310,246
62568,16355,8565,7790,3781,4027,4823,3724
62570,512,248,264,129,129,139,115
62571,1532,789,743,417,309,475,331
62572,666,337,329,187,139,198,142
62573,1513,764,749,431,340,455,287
62601,434,226,208,92,77,181,84
62610,199,97,102,62,50,46,41
62611,1067,536,531,260,234,334,239
62612,1915,936,979,479,402,587,447
62613,3872,1882,1990,1173,905,1102,692
62615,5748,2793,2955,1763,1478,1622,885
62617,762,383,379,186,155,229,192
62618,7955,4027,3928,2356,2080,2017,1502
62621,1171,609,562,316,284,334,237
62622,49,24,25,17,11,9,12
62624,546,280,266,131,81,194,140
62625,855,428,427,199,147,304,205
62626,8354,4078,4276,2083,2041,2276,1954
62627,992,491,501,237,203,280,272
62628,896,474,422,232,179,278,207
62629,12949,6281,6668,3971,3236,3864,1878
62630,532,276,256,142,120,163,107
62631,262,144,118,60,62,82,58
62633,647,325,322,144,120,205,178
62634,821,402,419,185,181,274,181
62635,738,363,375,193,149,222,174
62638,1337,690,647,352,305,425,255
62639,316,151,165,81,64,99,72
62640,3756,1842,1914,872,775,1145,964
62642,1440,729,711,355,292,451,342
62643,526,270,256,146,126,164,90
62644,5385,2619,2766,1252,1146,1489,1498
62649,488,266,222,120,129,125,114
62650,26992,13521,13471,6527,6921,7345,6199
62655,568,288,280,139,113,179,137
62656,20405,10448,9957,4592,6198,5520,4095
62661,1213,611,602,321,272,383,237
62663,292,138,154,73,54,91,74
62664,3042,1462,1580,752,591,861,838
62665,1629,826,803,440,336,484,369
62666,616,311,305,141,138,205,132
62667,464,239,225,115,84,139,126
62668,1512,760,752,353,285,506,368
62670,2997,1501,1496,823,642,952,580
62671,572,305,267,150,131,179,112
62672,244,122,122,62,61,67,54
62673,530,253,277,142,101,173,114
62674,1454,728,726,351,301,430,372
62675,6154,2956,3198,1468,1170,1941,1575
62677,2562,1291,1271,694,457,856,555
62681,5602,2938,2664,1272,1260,1709,1361
62682,907,460,447,245,194,273,195
62684,5111,2472,2639,1468,1004,1554,1085
62685,2097,1073,1024,527,439,649,482
62688,761,386,375,184,157,235,185
62689,518,258,260,151,134,135,98
62690,4120,2000,2120,1124,991,1104,901
62691,2426,1205,1221,557,529,754,586
62692,2093,1034,1059,552,454,561,526
62693,1638,804,834,461,347,556,274
62694,3192,1515,1677,817,651,922,802
62695,296,146,150,82,76,82,56
62701,1152,689,463,58,516,364,214
62702,37281,17711,19570,9542,9942,10284,7513
62703,30333,14270,16063,8882,8594,7593,5264
62704,39831,18622,21209,8809,11215,10822,8985
62707,7648,3784,3864,1772,1621,2572,1683
62711,15347,7279,8068,3775,2701,5182,3689
62712,10302,5072,5230,2691,2224,3369,2018
62801,22415,11541,10874,5268,5644,6361,5142
62803,1014,502,512,293,211,288,222
62806,3412,1683,1729,903,712,950,847
62807,961,454,507,269,190,285,217
62808,1457,746,711,367,351,431,308
62809,142,74,68,31,35,35,41
62810,1089,553,536,322,248,281,238
62811,310,161,149,89,72,79,70
62812,11265,5448,5817,2681,2503,3036,3045
62814,2124,1058,1066,587,479,639,419
62815,416,202,214,126,96,113,81
62816,1306,654,652,280,295,410,321
62817,557,277,280,127,112,154,164
62818,330,164,166,64,60,126,80
62819,448,228,220,104,100,137,107
62820,162,83,79,30,37,40,55
62821,7657,3664,3993,1756,1589,2145,2167
62822,2574,1223,1351,641,588,649,696
62823,1691,843,848,424,369,447,451
62824,1761,871,890,417,398,494,452
62825,203,105,98,51,43,58,51
62827,1245,603,642,302,280,349,314
62828,1426,692,734,377,302,408,339
62829,72,40,32,18,13,21,20
62830,1392,694,698,352,297,415,328
62831,573,287,286,114,132,173,154
62832,9208,4444,4764,2455,2133,2447,2173
62833,383,201,182,83,77,130,93
62835,1152,561,591,260,231,323,338
62836,801,396,405,246,179,203,173
62837,8867,4276,4591,2125,1908,2447,2387
62838,1497,759,738,380,309,452,356
62839,6718,3182,3536,1758,1503,1834,1623
62841,98,57,41,28,25,21,24
62842,835,419,416,222,201,237,175
62843,100,54,46,16,14,45,25
62844,2083,994,1089,478,418,610,577
62846,2631,2256,375,252,1221,880,278
62848,636,332,304,162,166,170,138
62849,2205,1121,1084,617,455,655,478
62850,381,192,189,139,77,80,85
62851,329,170,159,81,74,93,81
62852,160,81,79,30,36,52,42
62853,1034,522,512,279,197,320,238
62854,1776,896,880,442,376,503,455
62856,324,158,166,64,66,119,75
62858,2981,1508,1473,742,631,866,742
62859,5748,2774,2974,1450,1249,1506,1543
62860,524,266,258,143,114,143,124
62861,128,71,57,33,23,43,29
62862,364,183,181,77,78,105,104
62863,10183,4947,5236,2559,2264,2858,2502
62864,24108,11585,12523,6194,5546,6510,5858
62865,2018,1016,1002,479,421,641,477
62867,521,249,272,109,114,137,161
62868,1872,955,917,469,454,549,400
62869,2682,1305,1377,663,558,810,651
62870,2080,1033,1047,520,425,599,536
62871,686,341,345,165,130,209,182
62872,1178,600,578,380,258,338,202
62874,372,193,179,74,81,120,97
62875,1167,582,585,288,260,335,284
62876,247,129,118,64,50,67,66
62877,514,269,245,128,111,161,114
62878,410,211,199,103,84,135,88
62879,85,37,48,21,16,28,20
62880,717,348,369,192,136,219,170
62881,11385,5540,5845,2955,2669,3067,2694
62882,2331,1142,1189,683,529,664,455
62883,591,306,285,157,118,183,133
62884,2940,1452,1488,744,647,797,752
62885,839,419,420,242,181,225,191
62886,440,223,217,102,99,129,110
62887,295,149,146,74,68,87,66
62888,2135,1050,1085,559,450,649,477
62889,851,437,414,208,180,271,192
62890,2882,1467,1415,789,620,845,628
62891,652,316,336,174,143,181,154
62892,317,163,154,80,70,88,79
62893,977,536,441,244,202,312,219
62894,1006,493,513,274,248,262,222
62895,2022,975,1047,519,456,532,515
62896,12626,6138,6488,3211,2996,3478,2941
62897,398,202,196,105,64,120,109
62898,2097,1057,1040,587,445,670,395
62899,1612,855,757,433,331,456,392
62901,27182,14428,12754,6364,13891,3924,3003
62902,4531,2276,2255,1008,1361,1313,849
62903,2962,1490,1472,618,1375,581,388
62905,677,357,320,178,129,205,165
62906,7276,3570,3706,1627,1687,1998,1964
62907,2164,1081,1083,590,461,638,475
62908,467,239,228,124,94,141,108
62910,2865,1391,1474,761,650,838,616
62912,1179,607,572,291,263,359,266
62914,3147,1455,1692,975,655,794,723
62915,321,163,158,76,92,94,59
62916,995,503,492,299,253,251,192
62917,2305,1137,1168,557,486,666,596
62918,9793,4743,5050,2628,2739,2613,1813
62919,1003,505,498,219,167,321,296
62920,3265,1637,1628,798,682,998,787
62921,375,187,188,87,86,107,95
62922,3119,1617,1502,657,575,934,953
62923,518,253,265,129,113,158,118
62924,2809,1371,1438,707,808,798,496
62926,2263,1137,1126,598,544,593,528
62927,367,183,184,86,97,99,85
62928,293,140,153,54,61,98,80
62930,6263,3039,3224,1528,1439,1661,1635
62931,1571,804,767,335,305,483,448
62932,1592,762,830,424,376,452,340
62933,1230,616,614,253,311,291,375
62934,927,460,467,205,204,253,265
62935,1943,938,1005,502,424,502,515
62938,3033,1620,1413,732,654,795,852
62939,3119,1560,1559,734,617,886,882
62940,445,221,224,116,97,130,102
62941,808,370,438,205,163,223,217
62942,707,350,357,176,163,207,161
62943,715,375,340,184,143,193,195
62946,12930,6315,6615,3435,2840,3567,3088
62947,539,262,277,106,85,168,180
62948,12865,6090,6775,3400,3327,3289,2849
62949,810,372,438,209,181,233,187
62950,193,100,93,46,39,58,50
62951,5352,2568,2784,1340,1270,1511,1231
62952,3372,1708,1664,868,734,1001,769
62953,360,180,180,113,77,97,73
62954,515,270,245,115,114,148,138
62956,869,414,455,207,179,238,245
62957,996,492,504,245,237,262,252
62958,2262,1179,1083,521,539,733,469
62959,26948,13684,13264,6282,6763,7404,6499
62960,11603,5497,6106,2869,2517,3274,2943
62961,65,29,36,22,22,15,6
62962,82,42,40,7,19,21,35
62963,611,294,317,201,147,164,99
62964,1456,705,751,417,316,417,306
62965,125,61,64,35,23,37,30
62966,15607,7573,8034,3759,3989,4301,3558
62967,326,168,158,88,73,81,84
62969,731,384,347,160,153,214,204
62970,639,315,324,141,116,194,188
62972,1205,637,568,270,213,400,322
62974,1401,692,709,350,291,434,326
62975,279,141,138,62,42,101,74
62976,469,227,242,111,76,147,135
62977,700,344,356,191,153,205,151
62979,1230,592,638,287,256,326,361
62982,1328,639,689,341,293,345,349
62983,1504,738,766,385,331,419,369
62984,1841,874,967,461,414,469,497
62985,845,422,423,190,136,268,251
62987,1174,584,590,303,232,368,271
62988,2110,1235,875,424,609,672,405
62990,1109,537,572,299,223,321,266
62992,1032,482,550,275,213,261,283
62994,755,376,379,216,167,227,145
62995,5284,3319,1965,1035,1705,1504,1040
62996,535,258,277,104,114,177,140
62997,599,296,303,192,153,141,113
62998,419,209,210,106,101,126,86
62999,1829,897,932,501,447,468,413
63673,47,33,14,9,14,19,5
45053,10,5,5,2,1,5,2
46001,10459,5154,5305,2695,2226,3037,2501
46011,16770,8088,8682,4072,3486,4651,4561
46012,19414,9270,10144,4641,5008,5101,4664
46013,17876,8352,9524,4207,4432,4576,4661
46016,19225,9513,9712,5689,5456,5076,3004
46017,6025,2968,3057,1435,1333,1735,1522
46030,3308,1649,1659,986,717,1000,605
46031,2161,1082,1079,642,439,709,371
46032,42234,20401,21833,12470,9211,13951,6602
46033,34889,17125,17764,11434,5701,11979,5775
46034,6730,3345,3385,1854,1416,2234,1226
46035,1113,528,585,305,236,347,225
46036,11663,5745,5918,3030,2636,3460,2537
46037,35891,17421,18470,13119,9678,9996,3098
46038,37723,18256,19467,11899,11449,10581,3794
46039,745,377,368,201,167,221,156
46040,9944,4917,5027,3322,2257,2962,1403
46041,23891,11884,12007,7060,5890,6289,4652
46044,2965,1431,1534,835,657,859,614
46045,93,54,39,31,24,22,16
46047,43,20,23,16,14,11,2
46048,2406,1189,1217,833,853,453,267
46049,850,436,414,217,188,260,185
46050,1706,865,841,516,366,531,293
46051,2826,1393,1433,823,654,804,545
46052,22060,10743,11317,5920,5336,6473,4331
46055,10193,4968,5225,3531,2565,2981,1116
46056,2246,1129,1117,605,516,643,482
46057,1179,590,589,351,297,323,208
46058,2149,1009,1140,510,485,620,534
46060,34708,16873,17835,10865,10472,8860,4511
46062,29730,14535,15195,9366,7717,8212,4435
46063,401,205,196,116,105,110,70
46064,17148,10249,6899,4440,5363,4991,2354
46065,3669,1780,1889,1116,783,1059,711
46068,2850,1438,1412,740,543,949,618
46069,6664,3400,3264,1873,1504,2066,1221
46070,2351,1178,1173,649,487,729,486
46071,3417,1693,1724,986,698,1105,628
46072,9324,4482,4842,2365,1928,2682,2349
46074,26745,13117,13628,9445,7310,7335,2655
46075,2913,1481,1432,796,974,732,411
46076,1696,858,838,459,363,510,364
46077,24512,12145,12367,8645,4568,8229,3070
46103,159,78,81,54,39,45,21
46104,970,500,470,250,212,316,192
46105,1928,982,946,519,387,626,396
46106,5928,3066,2862,1770,1441,1772,945
46107,12774,5986,6788,3335,3239,3552,2648
46110,500,258,242,133,94,178,95
46111,322,158,164,103,87,90,42
46112,33662,16428,17234,10343,7931,10002,5386
46113,14063,7010,7053,4601,4225,3621,1616
46115,1933,979,954,536,389,622,386
46117,671,330,341,176,131,224,140
46118,5015,2564,2451,1358,1098,1524,1035
46120,5954,2969,2985,1538,1223,1977,1216
46121,5276,2689,2587,1464,1124,1638,1050
46122,14671,7240,7431,4317,3433,4366,2555
46123,31754,15473,16281,9794,7900,9426,4634
46124,8127,4230,3897,2123,2059,2513,1432
46125,51,28,23,11,7,25,8
46126,4668,2336,2332,1279,914,1579,896
46127,416,196,220,115,94,124,83
46128,1949,973,976,543,401,634,371
46130,2508,1267,1241,654,500,851,503
46131,31036,15099,15937,8844,8067,8117,6008
46133,816,401,415,219,159,254,184
46135,20992,11512,9480,5212,6726,5306,3748
46140,38543,18938,19605,10494,9113,11109,7827
46142,30413,14973,15440,8413,7264,8864,5872
46143,48555,23599,24956,14612,13127,12976,7840
46144,211,107,104,62,51,66,32
46146,117,63,54,29,24,34,30
46147,3264,1613,1651,966,717,1023,558
46148,5097,2539,2558,1408,1063,1530,1096
46149,1890,957,933,557,433,584,316
46150,764,391,373,194,145,262,163
46151,30921,15431,15490,8356,6923,9477,6165
46155,103,52,51,36,30,23,14
46156,1470,739,731,481,306,394,289
46157,3639,1825,1814,1018,849,1183,589
46158,23053,11280,11773,6364,5062,7168,4459
46160,6421,3198,3223,1650,1263,2085,1423
46161,2655,1260,1395,692,575,800,588
46162,458,243,215,115,93,174,76
46163,11963,5889,6074,3573,2123,4056,2211
46164,3957,1986,1971,1005,782,1331,839
46165,1498,757,741,369,289,499,341
46166,2306,1162,1144,675,488,740,403
46167,6336,3151,3185,2000,1276,2027,1033
46168,30309,15961,14348,8061,8763,8456,5029
46171,1695,846,849,425,343,569,358
46172,2427,1237,1190,660,497,778,492
46173,11190,5461,5729,3051,2529,3155,2455
46175,597,304,293,146,118,209,124
46176,27816,13716,14100,7573,6937,7977,5329
46180,1028,509,519,258,167,353,250
46181,4832,2445,2387,1365,949,1580,938
46182,1927,948,979,469,380,612,466
46183,82,44,38,26,23,25,8
46184,11806,5794,6012,3635,3093,3354,1724
46186,1753,890,863,496,363,548,346
46201,30962,15891,15071,8903,9641,8809,3609
46202,16335,8938,7397,2679,7769,3847,2040
46203,38950,19274,19676,11408,11184,10475,5883
46204,5125,3210,1915,287,2927,1479,432
46205,25356,12017,13339,6516,8431,6808,3601
46208,22239,10401,11838,5754,7450,5341,3694
46214,24306,10942,13364,6265,8136,6072,3833
46216,1697,683,1014,289,375,466,567
46217,29358,14324,15034,8030,8762,7913,4653
46218,29028,13605,15423,8392,6997,7991,5648
46219,33930,16364,17566,8371,8572,10012,6975
46220,34830,16928,17902,7036,12530,9541,5723
46221,26393,13138,13255,8290,7547,6922,3634
46222,34044,16844,17200,10873,10702,8486,3983
46224,35094,17408,17686,10364,11897,8235,4598
46225,7319,3804,3515,2003,2358,2093,865
46226,43904,20465,23439,13441,11652,11432,7379
46227,57086,27539,29547,15636,18177,13701,9572
46228,14755,7007,7748,3794,3507,4440,3014
46229,27262,12621,14641,8797,7189,7298,3978
46231,10440,5095,5345,3458,2942,2868,1172
46234,24810,11981,12829,7124,6843,7022,3821
46235,30825,14111,16714,11543,9695,6839,2748
46236,27294,13286,14008,8145,6248,9044,3857
46237,39624,19126,20498,11191,12029,10531,5873
46239,25345,12450,12895,8059,7077,6934,3275
46240,18731,8946,9785,3757,5775,4785,4414
46241,30670,15190,15480,9703,8782,8033,4152
46250,18546,8777,9769,3655,7620,4199,3072
46254,38095,17567,20528,11830,13149,9430,3686
46256,23647,11429,12218,5892,5961,7451,4343
46259,11617,5763,5854,3819,2743,3451,1604
46260,32406,15104,17302,8714,9581,7775,6336
46268,24965,11460,13505,6586,8033,6304,4042
46278,8197,3988,4209,2247,1648,3021,1281
46280,6793,3337,3456,1626,2016,1979,1172
46290,170,74,96,16,13,46,95
46301,669,336,333,75,63,228,303
46303,14170,7204,6966,3979,3783,4353,2055
46304,24207,11913,12294,6719,5623,7513,4352
46307,60619,30021,30598,15816,15087,17914,11802
46310,13565,6718,6847,3778,3048,3794,2945
46311,20816,10129,10687,5420,4453,6464,4479
46312,29698,13909,15789,10218,7917,6918,4645
46319,18404,8851,9553,4961,5081,5344,3018
46320,15508,7461,8047,5257,4253,3811,2187
46321,23603,11341,12262,6122,4151,7432,5898
46322,23727,11386,12341,5558,5825,6883,5461
46323,22743,11181,11562,6712,6743,5871,3417
46324,23165,11269,11896,7137,6431,6079,3518
46327,12153,6108,6045,4076,3423,2967,1687
46340,1068,549,519,258,242,336,232
46341,10426,5190,5236,2818,2514,3180,1914
46342,31244,15229,16015,8192,8175,8748,6129
46345,249,121,128,67,57,66,59
46346,1423,675,748,476,362,354,231
46347,4760,2368,2392,1393,1185,1311,871
46348,1045,523,522,234,265,302,244
46349,3336,1724,1612,850,740,1086,660
46350,43650,21654,21996,11592,10111,12783,9164
46356,17524,8738,8786,4985,4101,5344,3094
46360,43625,22278,21347,10778,10943,12568,9336
46365,1068,552,516,289,205,400,174
46366,5791,2875,2916,1596,1273,1715,1207
46368,38691,18705,19986,10800,10228,10800,6863
46371,3599,1810,1789,966,779,1127,727
46373,13859,6925,6934,4020,2637,4663,2539
46374,1012,506,506,229,213,333,237
46375,23820,11571,12249,5700,5570,7432,5118
46376,398,204,194,111,105,121,61
46377,386,204,182,102,90,128,66
46379,202,116,86,51,45,65,41
46381,235,115,120,57,53,67,58
46382,2108,1042,1066,617,436,641,414
46383,39687,19571,20116,10121,11725,10601,7240
46385,38866,19158,19708,10992,8719,12232,6923
46390,2796,1405,1391,729,645,886,536
46391,9726,6464,3262,1878,3788,2866,1194
46392,7957,3979,3978,2394,1895,2320,1348
46393,399,191,208,115,94,127,63
46394,12258,6064,6194,3215,3168,3498,2377
46402,6726,3054,3672,2247,1509,1569,1401
46403,12601,5811,6790,3621,2964,3503,2513
46404,17326,7738,9588,5063,3670,4410,4183
46405,11746,5871,5875,3444,3115,3291,1896
46406,9900,4643,5257,3064,2277,2595,1964
46407,12656,5730,6926,3891,2726,3328,2711
46408,17030,8259,8771,5129,4127,4795,2979
46409,8932,4205,4727,3137,2151,2276,1368
46410,38340,17957,20383,10738,10385,10095,7122
46501,3856,1929,1927,1177,968,1010,701
46502,115,56,59,33,29,33,20
46504,3413,1685,1728,1101,811,935,566
46506,10070,4978,5092,3141,2192,2740,1997
46507,9128,4599,4529,2605,2021,2741,1761
46508,217,99,118,75,48,54,40
46510,3631,1845,1786,1031,817,1089,694
46511,4435,2173,2262,1135,837,1329,1134
46514,40263,19371,20892,10967,9844,11250,8202
46516,33501,16537,16964,10739,9098,8804,4860
46517,23764,11876,11888,7244,6409,6089,4022
46524,2326,1163,1163,804,600,581,341
46526,30671,14824,15847,9285,8013,7174,6199
46528,26104,13291,12813,9086,6945,6682,3391
46530,30614,15182,15432,9629,5744,10276,4965
46531,1458,746,712,401,313,466,278
46532,1905,953,952,505,431,563,406
46534,11263,5467,5796,3131,2583,3222,2327
46536,3445,1761,1684,889,700,1077,779
46537,433,208,225,136,108,115,74
46538,3867,1925,1942,944,779,1175,969
46539,2298,1153,1145,668,595,646,389
46540,11702,5870,5832,4230,2678,3007,1787
46542,4198,2135,2063,1317,968,1145,768
46543,3654,1884,1770,1564,1016,708,366
46544,30759,14860,15899,8484,8079,8460,5736
46545,25082,11727,13355,6078,7765,6226,5013
46550,12311,6117,6194,4270,3108,2994,1939
46552,6834,3350,3484,1857,1425,2064,1488
46553,3428,1704,1724,1105,801,964,558
46554,4942,2458,2484,1414,1031,1557,940
46555,2835,1400,1435,726,644,823,642
46556,7314,3177,4137,2876,4012,79,347
46561,13343,6600,6743,4182,3199,3908,2054
46562,4788,2394,2394,1328,1111,1455,894
46563,23599,11646,11953,6787,5451,6538,4823
46565,7950,4051,3899,3359,1968,1640,983
46567,9405,4774,4631,2409,2009,2812,2175
46570,1060,544,516,290,232,329,209
46571,5532,2757,2775,2490,1424,968,650
46573,3565,1708,1857,1048,734,968,815
46574,8339,4180,4159,2212,1726,2548,1853
46580,21338,10507,10831,5914,5281,5940,4203
46582,12378,6217,6161,3622,3238,3424,2094
46590,4908,2288,2620,1525,1528,1035,820
46595,163,77,86,50,46,42,25
46601,6090,3259,2831,1764,1831,1605,890
46613,10893,5353,5540,3765,3198,2700,1230
46614,29573,14226,15347,7227,6949,8256,7141
46615,14609,7032,7577,3935,4552,3737,2385
46616,5667,2784,2883,1695,1662,1485,825
46617,9601,4687,4914,2295,3103,2251,1952
46619,21408,10390,11018,7183,5145,5425,3655
46628,25650,12396,13254,7455,6385,7009,4801
46635,6654,3104,3550,1592,1391,1731,1940
46637,15314,7509,7805,3276,4761,3859,3418
46701,7979,4165,3814,2091,1935,2387,1566
46702,2304,1188,1116,623,497,739,445
46703,18029,9092,8937,4927,4639,4851,3612
46704,60,32,28,12,11,24,13
46705,1583,803,780,485,364,490,244
46706,18630,9146,9484,5208,4296,5287,3839
46710,4679,2270,2409,1348,1062,1326,943
46711,7698,3743,3955,2852,1689,1569,1588
46714,14645,7118,7527,4005,3395,3976,3269
46721,5058,2552,2506,1513,1214,1459,872
46723,7692,3863,3829,2120,1680,2468,1424
46725,23080,11443,11637,6065,5296,6890,4829
46730,1381,695,686,368,313,422,278
46731,559,285,274,163,120,178,98
46732,3169,1612,1557,1063,810,870,426
46733,18777,9261,9516,5347,4339,5302,3789
46737,7068,3562,3506,1735,1411,2245,1677
46738,7918,3849,4069,2447,1990,2123,1358
46740,4060,2042,2018,1672,909,852,627
46741,4647,2298,2349,1862,1087,1077,621
46742,3488,1761,1727,892,659,1106,831
46743,1971,975,996,666,515,453,337
46745,1841,928,913,521,375,562,383
46746,4036,2118,1918,1278,900,1124,734
46747,2693,1386,1307,706,557,829,601
46748,5134,2515,2619,1665,1276,1479,714
46750,27221,13249,13972,7353,6909,7539,5420
46755,15062,7335,7727,4243,3745,4212,2862
46759,652,314,338,186,136,200,130
46760,1382,703,679,365,326,404,287
46761,12039,5954,6085,4385,2841,2710,2103
46763,1631,819,812,405,366,533,327
46764,1497,759,738,422,333,475,267
46765,5341,2666,2675,1816,922,1709,894
46766,685,360,325,199,161,206,119
46767,8564,4338,4226,3242,2307,1962,1053
46770,2716,1348,1368,719,559,852,586
46771,105,49,56,32,28,29,16
46772,3411,1729,1682,1632,806,582,391
46773,3662,1803,1859,1000,776,1111,775
46774,16008,7762,8246,4773,3738,4366,3131
46776,1484,760,724,361,311,461,351
46777,6259,3078,3181,1772,1391,1808,1288
46779,2166,1091,1075,574,450,657,485
46781,793,402,391,207,174,249,163
46783,6396,3177,3219,1758,1327,2155,1156
46784,2236,1102,1134,565,437,711,523
46785,1542,752,790,513,328,458,243
46786,102,46,56,20,25,31,26
46787,3893,1949,1944,1140,916,1078,759
46788,3260,1696,1564,1101,647,1027,485
46791,918,469,449,263,172,318,165
46792,3499,1786,1713,915,700,1037,847
46793,4292,2180,2112,1241,1075,1286,690
46794,1587,806,781,493,333,463,298
46795,5608,2814,2794,1519,1099,1655,1335
46797,3957,1995,1962,1229,943,1081,704
46798,1661,843,818,447,326,564,324
46799,212,104,108,62,53,49,48
46802,11086,6236,4850,2658,4143,3007,1278
46803,9758,4784,4974,3686,2684,2209,1179
46804,27245,13139,14106,7244,6412,7974,5615
46805,21306,10174,11132,5764,6534,5148,3860
46806,23560,11140,12420,8837,6250,5581,2892
46807,16072,7772,8300,5355,4614,4128,1975
46808,19309,9620,9689,5378,6184,4945,2802
46809,8947,4287,4660,2285,2285,2553,1824
46814,12281,6009,6272,4299,2102,4064,1816
46815,26522,12390,14132,7723,6483,6634,5682
46816,18116,8552,9564,5945,4524,4645,3002
46818,18790,9354,9436,5553,5112,5205,2920
46819,8765,4192,4573,2275,2021,2486,1983
46825,27931,13384,14547,7324,8269,7212,5126
46835,33604,16563,17041,8697,10080,8741,6086
46845,22117,10984,11133,7266,4441,6852,3558
46901,37633,18207,19426,9915,8769,10691,8258
46902,35697,16957,18740,9127,8434,9732,8404
46910,3360,1691,1669,1027,811,920,602
46911,1439,716,723,386,299,455,299
46913,1329,707,622,389,277,385,278
46914,4908,4013,895,515,2264,1607,522
46915,679,317,362,170,159,157,193
46917,1853,936,917,508,383,555,407
46919,2390,1192,1198,670,510,706,504
46920,1045,540,505,305,249,293,198
46922,61,30,31,19,17,16,9
46923,8048,3983,4065,2210,1790,2342,1706
46926,1708,842,866,499,367,488,354
46928,4951,2450,2501,1311,999,1471,1170
46929,3214,1546,1668,899,705,894,716
46930,133,69,64,30,21,44,38
46931,188,100,88,73,41,43,31
46932,3448,1692,1756,933,705,1048,762
46933,6414,3097,3317,1715,1500,1789,1410
46936,5922,2869,3053,1591,1116,1813,1402
46938,3200,1573,1627,865,670,917,748
46939,2101,1035,1066,562,435,594,510
46940,2548,1287,1261,640,491,753,664
46941,1125,590,535,283,260,353,229
46943,247,126,121,79,59,63,46
46946,136,74,62,42,34,32,28
46947,28866,14448,14418,8286,6975,7805,5800
46950,643,316,327,177,129,184,153
46951,2170,1093,1077,571,437,704,458
46952,20308,9710,10598,4864,4335,5786,5323
46953,24177,11483,12694,6401,6675,6152,4949
46957,558,270,288,159,119,150,130
46958,460,229,231,88,101,150,121
46959,231,111,120,57,37,85,52
46960,1218,638,580,312,285,338,283
46961,99,55,44,22,27,24,26
46962,9728,4652,5076,2593,2405,2372,2358
46967,98,50,48,34,27,19,18
46968,73,37,36,26,15,21,11
46970,23766,11580,12186,6452,5426,6706,5182
46974,1699,827,872,469,361,508,361
46975,14691,7269,7422,3978,3241,4092,3380
46978,2059,1040,1019,572,450,585,452
46979,4733,2380,2353,1358,945,1540,890
46982,2573,1293,1280,679,629,751,514
46984,224,110,114,36,40,71,77
46985,1441,762,679,374,309,465,293
46986,1915,947,968,495,407,571,442
46987,776,374,402,213,157,210,196
46988,823,411,412,239,165,235,184
46989,5195,2504,2691,1566,1833,1045,751
46990,801,415,386,216,169,229,187
46991,1797,892,905,508,388,536,365
46992,16759,8110,8649,4307,3646,4742,4064
46994,2684,1325,1359,765,577,764,578
46996,7139,3577,3562,1891,1518,2113,1617
46998,112,47,65,24,23,43,22
47001,10422,5189,5233,2697,2361,3250,2114
47003,1040,501,539,322,225,308,185
47006,11727,5769,5958,3582,2462,3385,2298
47010,306,162,144,78,66,105,57
47011,1277,665,612,429,266,336,246
47012,10188,5041,5147,2848,2272,2946,2122
47016,793,413,380,198,160,263,172
47017,507,258,249,133,111,145,118
47018,4275,2090,2185,1072,902,1300,1001
47020,1309,653,656,362,299,399,249
47022,3358,1718,1640,1001,663,1142,552
47023,1636,839,797,462,377,507,290
47024,3226,1644,1582,958,769,929,570
47025,22932,11274,11658,6326,5355,6923,4328
47030,1636,840,796,471,355,501,309
47031,5368,2621,2747,1586,1146,1512,1124
47032,3289,1706,1583,976,726,1022,565
47034,158,80,78,33,37,52,36
47035,233,113,120,59,63,65,46
47036,1023,466,557,269,182,293,279
47037,4333,2119,2214,1214,1004,1235,880
47038,1504,787,717,412,341,476,275
47040,5480,2717,2763,1338,1236,1665,1241
47041,6125,3112,3013,1865,1334,1853,1073
47042,4504,2213,2291,1184,1027,1285,1008
47043,5250,2642,2608,1415,1189,1454,1192
47060,6448,3232,3216,1741,1350,2130,1227
47102,7255,3592,3663,2025,1744,2133,1353
47104,41,23,18,10,4,20,7
47106,4718,2382,2336,1196,1062,1562,898
47108,2463,1273,1190,741,556,668,498
47110,350,177,173,96,96,89,69
47111,14533,7098,7435,4274,3712,4209,2338
47112,16722,8279,8443,4285,4164,4821,3452
47114,399,198,201,130,101,111,57
47115,2622,1326,1296,697,587,837,501
47116,805,424,381,187,166,256,196
47117,4429,2238,2191,1134,960,1420,915
47118,3502,1766,1736,918,734,1102,748
47119,10911,5414,5497,2955,2043,3748,2165
47120,938,466,472,259,224,278,177
47122,9979,4947,5032,2780,2207,3280,1712
47123,189,92,97,45,33,55,56
47124,4264,2148,2116,1242,910,1422,690
47125,1658,872,786,448,387,519,304
47126,4250,2227,2023,1118,1133,1299,700
47129,19527,9384,10143,4793,5478,5015,4241
47130,44722,21825,22897,11230,12662,12672,8158
47135,1372,708,664,321,300,436,315
47136,4178,2083,2095,1180,880,1349,769
47137,1421,707,714,351,306,396,368
47138,4373,2220,2153,1182,962,1357,872
47140,2669,1331,1338,725,648,760,536
47141,1668,838,830,458,353,546,311
47142,1174,592,582,327,287,350,210
47143,3015,1512,1503,801,820,919,475
47145,1998,1023,975,506,448,634,410
47147,945,465,480,221,219,290,215
47150,47472,22706,24766,12390,12679,13265,9138
47160,93,51,42,31,22,29,11
47161,3735,1871,1864,1040,883,1175,637
47162,829,398,431,220,194,246,169
47163,1746,896,850,439,380,558,369
47164,3779,1876,1903,1017,895,1153,714
47165,6438,3263,3175,1871,1531,2017,1019
47166,1302,649,653,350,325,359,268
47167,15014,7350,7664,4085,3529,4263,3137
47170,14795,7296,7499,3826,3691,4303,2975
47172,16059,7811,8248,4503,4172,4395,2989
47175,909,478,431,231,202,269,207
47177,1221,619,602,299,239,421,262
47201,41662,20887,20775,11650,11295,11408,7309
47203,25806,12406,13400,7055,5678,7135,5938
47220,5652,2888,2764,1487,1341,1582,1242
47223,1490,772,718,446,327,466,251
47224,636,346,290,227,139,145,125
47226,202,108,94,63,50,56,33
47227,1598,809,789,440,367,479,312
47229,3231,1617,1614,832,771,942,686
47230,2029,1018,1011,506,474,653,396
47231,1167,596,571,354,248,350,215
47232,2839,1424,1415,793,653,831,562
47234,1379,712,667,364,333,428,254
47235,1784,914,870,470,398,561,355
47240,20832,10288,10544,5721,5019,5869,4223
47243,5951,2883,3068,1687,1772,1418,1074
47244,786,381,405,224,179,224,159
47246,4342,2180,2162,1215,984,1311,832
47247,156,79,77,27,41,46,42
47250,21944,10429,11515,5486,5180,6471,4807
47260,1911,954,957,509,404,554,444
47263,236,117,119,69,58,73,36
47264,1428,736,692,359,274,445,350
47265,20911,10414,10497,6221,4934,5952,3804
47270,807,412,395,210,174,255,168
47272,2041,1015,1026,591,504,603,343
47273,1849,940,909,517,373,568,391
47274,28770,14174,14596,7827,7461,7963,5519
47280,813,409,404,210,174,232,197
47281,1324,699,625,334,275,432,283
47282,289,134,155,82,68,78,61
47283,3386,1697,1689,996,783,965,642
47302,27592,13307,14285,7397,6530,7898,5767
47303,25365,12337,13028,5550,9962,5366,4487
47304,30516,14381,16135,6483,9593,7036,7404
47305,4106,2179,1927,911,1520,1182,493
47306,6189,2663,3526,3771,2410,6,2
47320,4134,2019,2115,1015,815,1290,1014
47324,138,72,66,34,28,40,36
47325,667,349,318,164,131,233,139
47326,2295,1183,1112,999,497,475,324
47327,4597,2272,2325,1255,987,1292,1063
47330,5755,2838,2917,1638,1258,1751,1108
47331,23429,11470,11959,6174,5322,6501,5432
47334,3263,1613,1650,852,706,959,746
47335,761,360,401,190,169,208,194
47336,3807,1882,1925,1039,835,1104,829
47337,203,97,106,49,44,63,47
47338,2827,1440,1387,786,626,782,633
47339,669,346,323,210,157,181,121
47340,2914,1449,1465,783,644,828,659
47341,2283,1165,1118,685,511,666,421
47342,2693,1352,1341,697,576,850,570
47344,140,72,68,33,30,42,35
47345,1448,716,732,448,301,432,267
47346,4082,2032,2050,1088,901,1181,912
47348,9828,4818,5010,2422,2089,2826,2491
47351,471,241,230,156,128,111,76
47352,965,488,477,252,191,311,211
47353,5879,2893,2986,1649,1268,1700,1262
47354,1129,552,577,260,244,320,305
47355,2885,1408,1477,795,634,833,623
47356,5781,2824,2957,1551,1118,1778,1334
47357,1215,589,626,311,250,401,253
47358,996,519,477,273,196,285,242
47359,3143,1573,1570,889,703,926,625
47360,1546,774,772,395,291,499,361
47361,135,66,69,33,18,48,36
47362,30243,15619,14624,7134,7470,8861,6778
47367,191,95,96,60,43,37,51
47368,2845,1369,1476,754,575,834,682
47369,1343,650,693,356,289,419,279
47371,12226,5999,6227,3364,2739,3399,2724
47373,2226,1097,1129,606,481,583,556
47374,46875,22513,24362,11658,11639,12642,10936
47380,2004,1028,976,552,453,577,422
47381,145,73,72,58,34,39,14
47382,200,92,108,59,47,51,43
47383,2960,1446,1514,777,580,944,659
47384,2000,980,1020,525,432,656,387
47385,1612,806,806,431,362,424,395
47386,1231,606,625,328,229,389,285
47387,726,338,388,189,152,203,182
47388,384,187,197,118,84,101,81
47390,5310,2636,2674,1527,1202,1348,1233
47393,1704,864,840,534,344,509,317
47394,8470,4134,4336,2181,1865,2402,2022
47396,7030,3370,3660,1925,1481,2002,1622
47401,41011,20297,20714,8909,16209,9104,6789
47403,30955,15155,15800,7370,10898,7827,4860
47404,21026,10796,10230,4534,8503,4814,3175
47405,4427,2106,2321,2607,1819,1,0
47406,4730,2195,2535,3220,1507,2,1
47408,24776,12883,11893,4177,13870,3570,3159
47420,135,68,67,23,34,42,36
47421,27831,13574,14257,7075,6190,7906,6660
47424,9525,4833,4692,2446,2110,2926,2043
47427,1093,555,538,331,211,329,222
47429,7986,3837,4149,2198,2131,2287,1370
47431,1366,708,658,379,280,396,311
47432,4537,2238,2299,1177,998,1314,1048
47433,4025,1996,2029,1078,846,1265,836
47434,76,38,38,21,18,19,18
47436,1663,869,794,432,360,525,346
47437,123,62,61,28,28,37,30
47438,4798,2353,2445,1268,1090,1365,1075
47441,9269,4538,4731,2335,2167,2480,2287
47443,1233,625,608,307,249,348,329
47446,9990,4923,5067,2651,2141,2945,2253
47448,7505,3666,3839,1576,1266,2446,2217
47449,413,208,205,108,87,125,93
47451,1228,617,611,297,300,348,283
47452,5359,2630,2729,1606,1154,1495,1104
47453,498,251,247,137,114,152,95
47454,7688,3832,3856,2057,1663,2236,1732
47455,124,63,61,37,38,38,11
47456,1200,636,564,289,252,415,244
47457,134,65,69,36,30,34,34
47458,36,20,16,7,9,7,13
47459,3795,1912,1883,1099,873,1171,652
47460,11471,5751,5720,2904,2469,3557,2541
47462,4871,2521,2350,1315,1080,1598,878
47464,198,98,100,44,34,65,55
47465,750,381,369,204,159,207,180
47467,72,37,35,20,21,14,17
47468,1250,646,604,231,227,460,332
47469,1749,890,859,435,411,494,409
47470,1735,910,825,470,380,557,328
47471,2727,1345,1382,768,632,732,595
47501,17535,8654,8881,4814,4149,4788,3784
47512,3981,1952,2029,1037,914,1089,941
47513,1841,943,898,484,392,588,377
47514,1559,1463,96,94,1008,400,57
47515,965,489,476,253,228,295,189
47516,1249,611,638,320,263,411,255
47519,513,269,244,145,123,152,93
47520,3267,1664,1603,826,701,1048,692
47521,927,458,469,299,223,264,141
47522,246,124,122,60,71,69,46
47523,3435,1752,1683,933,753,997,752
47524,605,322,283,168,145,180,112
47525,382,194,188,76,82,112,112
47527,1897,951,946,531,445,563,358
47528,476,240,236,99,99,159,119
47529,1042,498,544,287,204,299,252
47531,1004,536,468,224,223,348,209
47532,4627,2220,2407,1194,923,1465,1045
47535,566,272,294,128,131,138,169
47536,40,23,17,8,9,13,10
47537,826,408,418,208,163,270,185
47541,1224,615,609,334,284,344,262
47542,9622,4710,4912,2763,2216,2863,1780
47546,21009,10385,10624,5683,4721,6231,4374
47550,854,433,421,248,197,290,119
47551,649,336,313,206,143,184,116
47552,182,90,92,55,28,69,30
47553,8495,4232,4263,2640,1909,2313,1633
47557,1432,729,703,404,344,384,300
47558,4406,2235,2171,1859,1099,918,530
47561,1588,762,826,397,364,448,379
47562,4658,2337,2321,1566,1071,1073,948
47564,1352,673,679,321,300,413,318
47567,6021,2996,3025,1458,1297,1783,1483
47568,834,439,395,253,195,221,165
47574,148,75,73,42,21,45,40
47575,976,483,493,269,208,324,175
47576,388,205,183,107,77,135,69
47577,1143,669,474,258,224,343,318
47578,776,390,386,177,165,226,208
47579,2659,1274,1385,789,541,758,571
47580,289,153,136,88,79,93,29
47581,3883,2011,1872,973,827,1151,932
47584,179,92,87,48,39,60,32
47585,592,294,298,129,129,186,148
47586,10932,5302,5630,2736,2457,3079,2660
47588,698,324,374,178,164,203,153
47590,713,381,332,206,167,228,112
47591,26770,13565,13205,7199,7019,6936,5616
47596,202,95,107,44,44,58,56
47597,1023,523,500,274,243,299,207
47598,3418,1693,1725,916,737,1005,760
47601,13896,6841,7055,3507,3032,4163,3194
47610,5195,2569,2626,1526,1288,1481,900
47611,1257,615,642,314,256,383,304
47612,861,431,430,225,175,282,179
47613,2679,1386,1293,745,588,821,525
47615,1611,767,844,449,377,497,288
47616,364,172,192,89,63,121,91
47619,1696,889,807,454,393,483,366
47620,13427,6669,6758,3592,2973,4125,2737
47630,34423,16805,17618,10110,7568,10280,6465
47631,2042,987,1055,415,381,654,592
47633,2542,1273,1269,657,492,838,555
47634,2382,1220,1162,621,529,721,511
47635,5671,2809,2862,1487,1169,1723,1292
47637,1507,766,741,427,319,484,277
47638,3577,1785,1792,989,822,1127,639
47639,4069,2053,2016,1154,885,1288,742
47640,1089,574,515,273,214,372,230
47648,4373,2183,2190,1203,1060,1264,846
47649,1402,706,696,344,293,469,296
47654,70,37,33,13,21,17,19
47660,4934,2395,2539,1229,1220,1352,1133
47665,3637,1804,1833,1014,814,1095,714
47666,1447,750,697,390,269,460,328
47670,12352,6001,6351,3316,2987,3359,2690
47683,210,107,103,63,50,56,41
47708,439,306,133,24,129,199,87
47710,19527,9380,10147,4897,4735,5371,4524
47711,31457,15584,15873,7821,8082,9393,6161
47712,26012,12548,13464,6896,8156,6498,4462
47713,11032,5321,5711,3196,2975,2875,1986
47714,34107,16142,17965,9250,10123,8613,6121
47715,27063,12642,14421,6140,7972,6928,6023
47720,17413,8513,8900,4265,3739,5367,4042
47725,15851,7873,7978,4477,3793,4797,2784
47802,34532,18351,16181,8265,10130,9517,6620
47803,21102,10527,10575,5173,6028,5494,4407
47804,11020,5274,5746,2866,2987,2867,2300
47805,12852,6352,6500,3430,2922,3871,2629
47807,13045,6782,6263,3306,5341,2931,1467
47809,2687,1187,1500,1268,1417,2,0
47832,1040,537,503,264,237,336,203
47833,1010,498,512,269,201,352,188
47834,19215,9457,9758,5071,4569,5524,4051
47836,47,21,26,14,8,13,12
47837,1231,641,590,323,278,394,236
47838,4081,3106,975,626,1720,1238,497
47840,1500,745,755,362,341,481,316
47841,2138,1017,1121,548,483,595,512
47842,10085,4964,5121,2616,2315,2794,2360
47846,638,317,321,155,144,190,149
47847,1077,517,560,272,227,328,250
47848,1691,836,855,428,370,478,415
47849,496,264,232,123,103,144,126
47850,2456,1236,1220,648,561,721,526
47853,134,60,74,40,37,35,22
47854,849,431,418,230,166,256,197
47855,546,282,264,171,136,151,88
47857,571,288,283,137,143,130,161
47858,698,342,356,183,149,236,130
47859,1066,529,537,367,238,275,186
47860,321,167,154,104,73,76,68
47861,616,311,305,172,118,192,134
47862,1610,828,782,484,335,441,350
47863,205,106,99,47,48,66,44
47865,79,30,49,11,15,22,31
47866,347,177,170,85,62,108,92
47868,2937,1491,1446,703,572,1023,639
47869,137,74,63,38,40,38,21
47871,220,112,108,66,66,49,39
47872,8890,3834,5056,1828,2413,2687,1962
47874,3414,1717,1697,865,730,1057,762
47876,394,7,387,74,145,6,169
47879,3302,1684,1618,880,770,948,704
47880,67,35,32,17,15,16,19
47881,465,238,227,144,120,123,78
47882,8430,4050,4380,2185,1897,2354,1994
47884,229,111,118,61,48,68,52
47885,9009,4408,4601,2358,1982,2657,2012
47901,3518,1931,1587,548,1850,765,355
47904,16277,8410,7867,3969,5870,3815,2623
47905,38910,18887,20023,10325,10888,10428,7269
47906,66972,35947,31025,17681,33159,9509,6623
47907,0,0,0,0,0,0,0
47909,39373,18958,20415,12014,12207,9863,5289
47916,64,29,35,19,21,16,8
47917,491,250,241,147,106,146,92
47918,6321,3165,3156,1741,1372,1856,1352
47920,2414,1215,1199,644,506,749,515
47921,1078,522,556,301,252,306,219
47922,1623,793,830,411,332,458,422
47923,3494,1708,1786,977,744,1105,668
47924,141,69,72,38,30,56,17
47925,203,94,109,49,38,55,61
47926,1097,554,543,312,234,331,220
47928,2047,1025,1022,495,389,658,505
47929,774,381,393,212,155,265,142
47930,1094,564,530,335,250,336,173
47932,5357,2623,2734,1348,1073,1524,1412
47933,27937,14091,13846,7426,6725,7725,6061
47940,1433,723,710,434,298,435,266
47941,1300,642,658,405,413,318,164
47942,660,351,309,161,132,223,144
47943,932,501,431,316,224,246,146
47944,3623,1782,1841,998,732,1050,843
47946,2044,1001,1043,564,391,565,524
47948,1359,680,679,331,286,431,311
47949,1332,654,678,369,289,399,275
47950,912,472,440,241,218,268,185
47951,2252,1113,1139,605,439,669,539
47952,2798,1409,1389,718,547,840,693
47954,2220,1125,1095,615,495,705,405
47955,1088,550,538,320,257,307,204
47957,1894,970,924,496,433,579,386
47958,209,98,111,52,45,48,64
47959,2822,1421,1401,873,618,734,597
47960,15003,7390,7613,3598,3029,4291,4085
47963,1949,986,963,468,426,582,473
47964,122,65,57,30,22,41,29
47965,646,316,330,214,140,158,134
47966,461,231,230,121,100,124,116
47967,772,401,371,221,189,217,145
47968,982,500,482,278,222,295,187
47969,145,83,62,49,38,34,24
47970,2034,1025,1009,638,519,541,336
47971,1865,924,941,525,381,527,432
47974,1186,592,594,299,239,357,291
47975,653,322,331,135,143,212,163
47977,2206,1093,1113,610,492,619,485
47978,11793,5882,5911,3358,2955,3127,2353
47980,1096,540,556,294,248,333,221
47981,849,425,424,251,194,275,129
47982,143,67,76,35,28,47,33
47983,347,182,165,116,82,99,50
47987,4049,2015,2034,1077,871,1169,932
47989,1281,638,643,381,257,359,284
47990,1627,804,823,454,379,466,328
47991,1070,544,526,312,233,297,228
47992,1465,755,710,417,319,461,268
47993,3918,1929,1989,994,819,1166,939
47994,476,241,235,121,97,154,104
47995,1743,868,875,537,353,509,344
47997,139,69,70,46,48,31,14
50001,680,344,336,194,114,234,138
50002,1297,633,664,324,291,387,295
50003,6594,3206,3388,1868,1330,2167,1229
50005,730,387,343,193,136,225,176
50006,1676,868,808,444,357,475,400
50007,474,238,236,146,78,181,69
50008,878,423,455,226,170,252,230
50009,16136,7878,8258,5140,4379,4299,2318
50010,29359,14869,14490,6077,12213,6184,4885
50011,1390,701,689,1233,157,0,0
50012,4062,2335,1727,2868,1185,7,2
50014,28094,15379,12715,5182,16088,4241,2583
50020,1407,698,709,324,251,449,383
50021,21595,10492,11103,6131,6460,5526,3478
50022,8494,4124,4370,2093,1741,2308,2352
50023,27986,13882,14104,8782,9110,6966,3128
50025,3325,1593,1732,811,550,945,1019
50026,584,303,281,148,113,189,134
50027,285,152,133,62,58,87,78
50028,1681,839,842,484,350,495,352
50029,691,371,320,179,140,206,166
50032,399,198,201,102,83,131,83
50033,44,28,16,11,12,16,5
50034,490,253,237,132,94,135,129
50035,5387,2729,2658,1829,1573,1363,622
50036,16287,8026,8261,4238,3918,4643,3488
50038,205,113,92,44,44,82,35
50039,329,174,155,70,63,129,67
50041,92,47,45,14,11,42,25
50042,309,164,145,75,60,101,73
50044,887,447,440,254,160,259,214
50046,1524,761,763,446,337,471,270
50047,5559,2724,2835,1644,1214,1587,1114
50048,861,441,420,230,136,296,199
50049,6493,3181,3312,1732,1230,1828,1703
50050,710,347,363,175,128,180,227
50051,283,159,124,65,54,89,75
50052,138,66,72,26,26,32,54
50054,3356,1689,1667,906,745,1032,673
50055,913,460,453,254,202,257,200
50056,1372,698,674,370,276,444,282
50057,238,121,117,75,52,70,41
50058,1927,942,985,520,400,502,505
50060,2507,1202,1305,634,463,682,728
50061,1701,859,842,481,301,625,294
50062,741,375,366,193,144,237,167
50063,2604,1288,1316,737,518,809,540
50064,126,68,58,40,28,47,11
50065,583,293,290,163,93,160,167
50066,262,139,123,80,43,77,62
50067,302,159,143,73,74,96,59
50068,366,182,184,117,60,107,82
50069,1118,571,547,339,308,291,180
50070,1489,769,720,399,336,467,287
50071,1007,501,506,211,183,286,327
50072,2671,1358,1313,847,541,818,465
50073,1195,623,572,382,310,337,166
50074,334,167,167,34,52,71,177
50075,862,440,422,249,200,242,171
50076,1502,706,796,341,275,419,467
50078,126,58,68,26,18,45,37
50101,66,33,33,22,10,18,16
50102,87,42,45,20,23,21,23
50103,452,235,217,108,95,141,108
50104,128,60,68,33,19,47,29
50105,1158,574,584,389,272,368,129
50106,1039,515,524,257,205,316,261
50107,1099,572,527,340,218,324,217
50108,471,242,229,108,94,123,146
50109,2762,1406,1356,868,669,840,385
50111,9407,4660,4747,3098,2978,2457,874
50112,11536,5566,5970,3009,2991,2833,2703
50115,2674,1293,1381,693,492,714,775
50116,299,160,139,75,65,95,64
50117,193,93,100,47,27,76,43
50118,1027,532,495,326,235,296,170
50119,498,257,241,128,116,148,106
50120,323,173,150,87,73,106,57
50122,1373,650,723,342,260,380,391
50123,818,395,423,199,141,208,270
50124,3750,1842,1908,1308,964,962,516
50125,19556,9312,10244,5579,4830,5286,3861
50126,6853,3372,3481,1825,1474,1752,1802
50127,29,15,14,8,8,6,7
50128,360,181,179,88,66,108,98
50129,5228,2521,2707,1266,925,1497,1540
50130,1648,828,820,493,310,518,327
50131,17499,8564,8935,5540,4152,5297,2510
50132,367,190,177,90,74,126,77
50133,567,298,269,157,119,152,139
50134,660,327,333,185,131,233,111
50135,1605,840,765,361,298,549,397
50136,445,219,226,116,94,117,118
50138,11720,5845,5875,3184,2498,3332,2706
50139,1288,659,629,366,252,396,274
50140,2969,1482,1487,863,979,547,580
50141,569,298,271,146,90,201,132
50142,931,455,476,272,173,282,204
50143,600,306,294,156,122,184,138
50144,2901,1427,1474,815,593,746,747
50146,438,234,204,106,92,142,98
50147,440,221,219,101,90,134,115
50148,432,212,220,118,95,125,94
50149,964,478,486,236,198,299,231
50150,984,497,487,299,233,258,194
50151,724,378,346,156,114,243,211
50153,734,384,350,207,139,221,167
50154,466,238,228,133,113,141,79
50155,255,134,121,59,55,77,64
50156,4412,2128,2284,1163,933,1321,995
50157,762,401,361,160,158,248,196
50158,31591,15780,15811,8936,7263,8211,7181
50160,465,239,226,141,120,128,76
50161,2047,1045,1002,560,473,647,367
50162,1233,622,611,346,308,372,207
50163,858,426,432,233,203,215,207
50164,652,331,321,165,131,218,138
50165,49,23,26,13,11,15,10
50166,1582,798,784,455,357,434,336
50167,748,371,377,180,157,243,168
50168,842,417,425,223,167,271,181
50169,3093,1237,1856,720,862,986,525
50170,2745,1382,1363,722,611,813,599
50171,2923,1453,1470,683,525,875,840
50173,696,341,355,191,117,233,155
50174,1429,714,715,420,305,416,288
50201,8199,4043,4156,2227,2033,2392,1547
50206,526,268,258,164,107,148,107
50207,2537,1275,1262,726,526,734,551
50208,20417,10491,9926,4788,4977,5861,4791
50210,1691,880,811,425,332,576,358
50211,11192,5439,5753,3486,2754,3265,1687
50212,3131,1574,1557,817,597,977,740
50213,6812,3377,3435,1891,1555,1813,1553
50214,850,446,404,291,174,262,123
50216,2824,1363,1461,704,416,846,858
50217,631,316,315,146,138,185,162
50218,139,71,68,34,28,41,36
50219,13939,6811,7128,4219,3553,3541,2626
50220,9020,4526,4494,2824,2216,2318,1662
50222,498,251,247,139,81,149,129
50223,480,258,222,116,75,163,126
50225,2940,1475,1465,841,674,821,604
50226,4724,2394,2330,1538,1129,1433,624
50227,40,20,20,6,17,9,8
50228,2417,1176,1241,743,578,666,430
50229,932,494,438,225,180,333,194
50230,1083,555,528,273,204,339,267
50231,173,90,83,41,36,60,36
50232,537,267,270,158,102,167,110
50233,1388,716,672,349,278,430,331
50234,613,303,310,160,111,211,131
50235,483,245,238,125,104,147,107
50236,1550,765,785,470,378,456,246
50237,3095,1580,1515,919,580,1043,553
50238,1182,605,577,320,209,348,305
50239,210,112,98,58,32,80,40
50240,2453,1256,1197,700,484,806,463
50242,439,232,207,105,94,140,100
50243,244,123,121,66,58,67,53
50244,1813,935,878,525,473,508,307
50246,735,372,363,153,148,253,181
50247,2515,1309,1206,707,582,700,526
50248,4420,2113,2307,1096,846,1347,1131
50249,1332,668,664,331,238,404,359
50250,2330,1137,1193,603,492,648,587
50251,1270,649,621,341,239,361,329
50252,243,116,127,78,38,74,53
50254,282,146,136,64,62,102,54
50255,65,30,35,15,14,23,13
50256,501,267,234,136,107,156,102
50257,992,491,501,332,213,271,176
50258,1002,507,495,252,156,329,265
50261,2211,1125,1086,710,461,741,299
50262,453,230,223,102,76,151,124
50263,16069,7799,8270,5173,5314,3712,1870
50264,466,248,218,104,86,155,121
50265,31653,15388,16265,8070,9735,8476,5372
50266,23625,11342,12283,6254,8261,5921,3189
50268,993,475,518,249,201,280,263
50271,628,312,316,149,138,168,173
50272,152,85,67,40,35,39,38
50273,8251,4009,4242,2356,1760,2338,1797
50274,398,208,190,98,72,127,101
50275,532,269,263,138,106,174,114
50276,2517,1406,1111,745,500,800,472
50277,483,233,250,130,87,140,126
50278,842,424,418,217,167,253,205
50309,5431,3026,2405,823,2363,1443,802
50310,30221,14583,15638,7456,9553,8068,5144
50311,15113,7371,7742,4151,6131,3321,1510
50312,15339,7390,7949,3306,4490,4270,3273
50313,17376,9120,8256,4528,5048,5080,2720
50314,12465,6100,6365,4195,3872,2802,1596
50315,35853,17603,18250,10081,10451,9470,5851
50316,16440,7955,8485,5296,4833,3813,2498
50317,36207,17824,18383,10033,9726,9910,6538
50319,0,0,0,0,0,0,0
50320,20027,9764,10263,6546,5924,5003,2554
50321,7846,3717,4129,2135,2349,1963,1399
50322,31530,15259,16271,7942,8102,9438,6048
50323,10201,4983,5218,3594,2685,2809,1113
50324,4903,2338,2565,1050,1224,1411,1218
50325,15448,7701,7747,4639,3569,4797,2443
50327,10467,4956,5511,3019,2755,2886,1807
50401,29837,14426,15411,7494,6897,8565,6881
50420,377,188,189,104,85,105,83
50421,3032,1482,1550,768,563,867,834
50423,2976,1442,1534,755,585,796,840
50424,1482,733,749,362,239,390,491
50426,56,31,25,19,11,18,8
50428,9384,4588,4796,2124,1752,2918,2590
50430,518,271,247,116,88,165,149
50431,273,151,122,89,66,77,41
50432,252,122,130,51,46,75,80
50433,256,131,125,62,49,90,55
50434,498,253,245,122,103,160,113
50435,721,373,348,174,134,235,178
50436,5848,2913,2935,1481,1392,1737,1238
50438,4159,2052,2107,1107,847,1225,980
50439,289,158,131,64,55,109,61
50440,422,218,204,99,86,145,92
50441,5776,2879,2897,1560,1235,1543,1438
50444,353,178,175,95,70,111,77
50446,548,288,260,144,98,184,122
50447,1081,541,540,263,206,288,324
50448,695,344,351,157,144,232,162
50449,724,357,367,199,152,219,154
50450,2897,1417,1480,693,567,830,807
50451,537,279,258,124,87,167,159
50452,804,390,414,202,179,226,197
50453,588,312,276,146,110,201,131
50454,127,69,58,34,24,38,31
50455,450,230,220,154,90,111,95
50456,1741,835,906,497,354,481,409
50457,441,236,205,94,104,125,118
50458,2097,1055,1042,566,427,618,486
50459,3018,1494,1524,731,584,860,843
50460,364,197,167,120,61,116,67
50461,5613,2708,2905,1474,1015,1585,1539
50464,673,354,319,156,156,223,138
50465,250,135,115,56,60,65,69
50466,1828,922,906,551,366,463,448
50467,94,51,43,19,29,30,16
50468,1615,818,797,440,306,499,370
50469,1574,782,792,403,316,473,382
50470,275,151,124,53,57,75,90
50471,689,354,335,178,141,210,160
50472,2394,1185,1209,646,438,641,669
50473,268,134,134,62,51,98,57
50475,1757,882,875,453,324,514,466
50476,804,398,406,198,132,233,241
50477,347,181,166,88,53,124,82
50478,775,394,381,164,150,249,212
50479,684,355,329,165,134,198,187
50480,880,431,449,193,131,263,293
50482,774,395,379,168,150,250,206
50483,781,404,377,225,150,226,180
50484,444,240,204,120,92,120,112
50501,29078,14931,14147,7581,7438,7627,6432
50510,1116,552,564,269,205,301,341
50511,7137,3459,3678,1696,1281,2072,2088
50514,1452,734,718,325,265,441,421
50515,279,145,134,71,47,88,73
50516,719,356,363,205,151,209,154
50517,1051,532,519,280,180,289,302
50518,381,204,177,112,75,110,84
50519,624,322,302,182,108,192,142
50520,144,81,63,27,24,56,37
50521,104,52,52,27,21,38,18
50522,857,418,439,234,183,223,217
50523,604,300,304,156,117,196,135
50524,521,271,250,126,92,184,119
50525,3583,1774,1809,939,722,961,961
50527,223,122,101,48,42,72,61
50528,383,212,171,96,69,124,94
50529,837,426,411,221,202,252,162
50530,1205,616,589,327,230,334,314
50531,242,122,120,49,47,80,66
50532,873,444,429,217,175,264,217
50533,4130,2040,2090,1112,856,1135,1027
50535,885,451,434,230,171,259,225
50536,4541,2224,2317,1155,1025,1159,1202
50538,503,245,258,106,112,132,153
50539,566,287,279,154,92,169,151
50540,1022,513,509,251,194,312,265
50541,872,437,435,223,172,268,209
50542,933,481,452,217,170,293,253
50543,1492,720,772,410,262,444,376
50544,515,267,248,121,115,153,126
50545,205,103,102,67,32,76,30
50546,346,179,167,68,56,134,88
50548,5869,2836,3033,1474,1175,1521,1699
50551,158,84,74,32,24,55,47
50554,1625,813,812,376,302,500,447
50556,292,147,145,66,35,92,99
50557,750,386,364,156,129,269,196
50558,618,314,304,153,134,203,128
50559,348,179,169,74,55,117,102
50560,590,296,294,120,118,183,169
50561,520,263,257,123,101,162,134
50562,527,274,253,139,100,161,127
50563,2500,1200,1300,573,446,718,763
50565,468,234,234,104,77,169,118
50566,433,235,198,103,69,141,120
50567,226,124,102,57,41,80,48
50568,1398,683,715,373,268,429,328
50569,836,422,414,193,181,275,187
50570,248,123,125,80,43,85,40
50571,394,206,188,93,82,103,116
50573,68,35,33,18,13,17,20
50574,2181,1033,1148,456,322,674,729
50575,969,476,493,237,178,255,299
50576,423,215,208,123,80,141,79
50577,410,215,195,101,74,123,112
50578,646,310,336,158,120,185,183
50579,2405,1156,1249,568,412,682,743
50581,996,495,501,273,187,269,267
50582,234,116,118,46,48,81,59
50583,2855,1352,1503,659,472,846,878
50585,1176,604,572,319,232,327,298
50586,307,157,150,76,48,114,69
50588,12756,6408,6348,3851,3397,3263,2245
50590,879,434,445,218,128,276,257
50591,320,173,147,82,85,86,67
50593,64,35,29,22,11,13,18
50594,298,159,139,67,62,97,72
50595,9165,4483,4682,2374,2015,2464,2312
50597,1293,641,652,324,220,358,391
50598,912,471,441,266,191,269,186
50599,380,200,180,74,67,120,119
50601,2464,1197,1267,567,424,717,756
50602,1603,769,834,397,299,419,488
50603,625,313,312,208,124,151,142
50604,1850,891,959,476,333,511,530
50605,168,93,75,40,40,52,36
50606,885,460,425,214,160,288,223
50607,481,255,226,124,89,148,120
50609,446,230,216,121,93,156,76
50611,392,208,184,106,91,119,76
50612,335,173,162,85,55,113,82
50613,42031,20283,21748,10543,15492,8662,7334
50616,10344,4972,5372,2712,2100,2661,2871
50619,2410,1204,1206,635,494,679,602
50620,54,27,27,18,8,18,10
50621,1530,748,782,418,291,402,419
50622,3206,1581,1625,888,682,933,703
50624,1743,873,870,507,322,531,383
50625,1004,469,535,244,182,271,307
50626,1804,896,908,560,406,536,302
50627,3456,1799,1657,964,625,969,898
50628,1374,687,687,377,254,341,402
50629,2418,1213,1205,790,510,643,475
50630,1728,883,845,430,333,528,437
50632,1107,571,536,290,213,335,269
50633,373,194,179,92,83,112,86
50634,713,353,360,176,155,211,171
50635,1602,774,828,384,292,451,475
50636,1982,987,995,425,363,563,631
50638,3313,1571,1742,808,703,876,926
50641,2017,1032,985,796,462,443,316
50642,581,304,277,182,142,148,109
50643,2747,1368,1379,742,529,890,586
50644,8648,4167,4481,2316,1844,2432,2056
50645,1204,610,594,358,231,362,253
50647,1894,958,936,462,379,568,485
50648,4054,1988,2066,1182,924,1187,761
50650,737,376,361,221,159,199,158
50651,3578,1715,1863,1034,709,1042,793
50652,128,62,66,41,23,41,23
50653,639,327,312,166,120,181,172
50654,499,256,243,139,93,157,110
50655,873,446,427,250,160,286,177
50658,2518,1263,1255,677,565,641,635
50659,5488,2718,2770,1391,1034,1634,1429
50660,1333,672,661,379,287,387,280
50662,7238,3477,3761,1836,1487,1952,1963
50664,53,32,21,11,11,15,16
50665,2841,1405,1436,774,624,772,671
50666,1027,528,499,274,234,312,207
50667,795,390,405,199,190,246,160
50668,1249,633,616,350,280,310,309
50669,2436,1206,1230,573,484,708,671
50670,2024,1019,1005,478,434,586,526
50671,269,132,137,92,43,75,59
50672,594,304,290,132,124,182,156
50673,219,114,105,64,59,65,31
50674,3555,1733,1822,900,669,1009,977
50675,2456,1209,1247,622,461,658,715
50676,2105,1036,1069,576,423,586,520
50677,12131,5859,6272,3267,3297,2865,2702
50680,1095,558,537,251,222,327,295
50681,457,238,219,123,78,156,100
50682,1572,826,746,475,337,435,325
50701,30324,14779,15545,7440,8521,7944,6419
50702,19970,9598,10372,5091,5820,4932,4127
50703,19863,9709,10154,5749,5094,5546,3474
50707,8509,4205,4304,2254,2263,2373,1619
50801,9590,4662,4928,2573,2196,2523,2298
50830,1743,852,891,475,359,453,456
50833,2305,1124,1181,577,446,651,631
50835,92,51,41,16,15,27,34
50836,457,248,209,123,80,123,131
50837,376,199,177,84,69,107,116
50839,34,19,15,7,5,13,9
50840,560,269,291,137,108,137,178
50841,2824,1378,1446,643,541,808,832
50842,105,58,47,26,31,28,20
50843,596,305,291,167,125,161,143
50845,811,391,420,215,161,218,217
50846,1123,556,567,260,225,293,345
50847,87,44,43,14,13,32,28
50848,378,196,182,79,65,140,94
50849,2740,1351,1389,669,493,807,771
50851,2087,1046,1041,560,431,552,544
50853,702,353,349,168,140,198,196
50854,2303,1073,1230,540,411,591,761
50857,272,140,132,71,54,68,79
50858,796,413,383,196,182,223,195
50859,584,277,307,146,102,183,153
50860,474,237,237,223,73,101,77
50861,274,146,128,67,50,75,82
50862,148,83,65,42,26,48,32
50863,293,132,161,90,52,66,85
50864,2057,1025,1032,521,406,602,528
51001,2190,1058,1132,592,428,569,601
51002,2741,1350,1391,758,619,777,587
51003,1700,853,847,527,369,528,276
51004,1033,499,534,263,174,325,271
51005,1491,758,733,356,280,477,378
51006,1075,540,535,266,219,268,322
51007,730,379,351,216,151,224,139
51008,151,76,75,36,31,53,31
51009,164,86,78,41,39,42,42
51010,456,237,219,124,83,142,107
51011,79,44,35,22,16,26,15
51012,6642,3254,3388,1491,1312,1946,1893
51014,528,268,260,120,97,176,135
51016,1378,708,670,339,283,385,371
51018,404,218,186,99,76,121,108
51019,773,389,384,204,154,221,194
51020,658,326,332,184,135,193,146
51022,789,414,375,237,160,226,166
51023,3111,1553,1558,893,698,795,725
51024,2070,1051,1019,556,408,658,448
51025,1989,993,996,510,408,548,523
51026,862,442,420,228,163,295,176
51027,1260,618,642,397,292,336,235
51028,2065,1003,1062,565,396,555,549
51029,251,131,120,62,48,81,60
51030,1737,885,852,510,361,529,337
51031,12336,6094,6242,3537,2718,3552,2529
51033,428,220,208,95,75,164,94
51034,1820,874,946,479,279,471,591
51035,1685,821,864,429,283,502,471
51036,726,374,352,235,168,209,114
51037,322,161,161,58,59,110,95
51038,1535,787,748,424,312,472,327
51039,2475,1241,1234,738,523,691,523
51040,3712,1799,1913,922,707,995,1088
51041,6976,3337,3639,2149,1953,1567,1307
51044,253,126,127,62,47,66,78
51046,1660,824,836,392,280,487,501
51047,646,328,318,141,103,208,194
51048,554,280,274,165,113,148,128
51049,506,258,248,121,94,146,145
51050,2631,1294,1337,784,479,748,620
51051,90,47,43,27,9,28,26
51052,1027,504,523,285,196,342,204
51053,1161,586,575,323,248,334,256
51054,5110,2529,2581,1749,1104,1494,763
51055,1319,639,680,326,287,402,304
51056,478,247,231,112,84,137,145
51058,1007,496,511,230,164,319,294
51060,615,303,312,139,93,191,192
51061,510,243,267,124,89,142,155
51062,526,272,254,142,98,179,107
51063,1100,508,592,260,202,318,320
51101,809,441,368,111,278,252,168
51103,17453,8706,8747,5734,4723,4316,2680
51104,22104,10682,11422,6557,5852,5524,4171
51105,10216,5224,4992,3460,3066,2491,1199
51106,26544,12848,13696,7405,7442,6617,5080
51108,5566,2767,2799,1585,1147,1754,1080
51109,3098,1526,1572,801,747,907,643
51111,94,49,45,19,26,34,15
51201,6193,3149,3044,1687,1435,1661,1410
51230,462,233,229,161,110,118,73
51231,282,142,140,67,53,86,76
51232,875,445,430,249,189,262,175
51234,1268,663,605,414,285,337,232
51235,1079,574,505,374,254,271,180
51237,1703,851,852,422,329,471,481
51238,1184,609,575,355,256,324,249
51239,3123,1588,1535,1087,749,723,564
51240,1746,902,844,536,394,435,381
51241,1737,869,868,541,405,463,328
51242,212,102,110,71,53,42,46
51243,807,396,411,234,176,223,174
51244,79,43,36,21,15,26,17
51245,1359,677,682,345,259,391,364
51246,3844,1863,1981,1149,777,1024,894
51247,4870,2434,2436,1553,1190,1138,989
51248,1857,904,953,482,371,481,523
51249,3593,1769,1824,928,726,980,959
51250,8249,4112,4137,2668,2489,1754,1338
51301,12691,6107,6584,3216,2869,3475,3131
51331,1140,586,554,131,196,320,493
51333,522,276,246,135,101,174,112
51334,7661,3882,3779,2107,1781,1969,1804
51338,1000,524,476,255,216,318,211
51341,49,25,24,11,12,14,12
51342,1249,610,639,345,287,298,319
51343,238,127,111,58,47,90,43
51345,403,210,193,94,76,149,84
51346,2451,1222,1229,611,462,740,638
51347,1431,715,716,342,264,414,411
51350,411,205,206,89,83,143,96
51351,4365,2206,2159,989,917,1284,1175
51354,1096,572,524,267,216,336,277
51355,874,429,445,109,163,254,348
51357,728,370,358,210,167,216,135
51358,1310,637,673,307,268,344,391
51360,7938,3839,4099,1721,1459,2370,2388
51363,130,69,61,32,25,44,29
51364,690,362,328,165,167,212,146
51365,453,184,269,181,78,111,83
51366,379,196,183,93,65,109,112
51401,12373,5953,6420,3280,2614,3566,2913
51430,761,396,365,240,151,216,154
51431,394,202,192,87,66,131,110
51433,676,352,324,180,145,197,154
51436,904,483,421,251,205,275,173
51439,1047,520,527,297,201,263,286
51440,400,196,204,129,94,103,74
51441,353,172,181,92,75,98,88
51442,9838,5028,4810,3174,2445,2341,1878
51443,1798,911,887,460,339,621,378
51444,246,118,128,86,55,61,44
51445,2867,1414,1453,746,489,834,798
51446,511,251,260,106,89,138,178
51447,228,125,103,45,40,70,73
51448,611,310,301,153,122,176,160
51449,2128,1024,1104,500,363,611,654
51450,1583,768,815,315,228,477,563
51451,116,61,55,20,24,39,33
51453,695,353,342,183,139,210,163
51454,1346,669,677,323,219,419,385
51455,2306,1116,1190,598,421,664,623
51458,1467,715,752,384,265,428,390
51459,75,35,40,22,17,20,16
51461,1165,576,589,324,220,341,280
51462,1013,517,496,242,176,314,281
51463,552,270,282,148,100,169,135
51465,733,366,367,210,122,229,172
51466,1092,516,576,281,190,282,339
51467,615,321,294,135,116,190,174
51501,35406,17384,18022,9828,10119,9533,5926
51503,36376,17648,18728,9663,8398,10264,8051
51510,3785,1870,1915,1175,920,1023,667
51520,233,126,107,64,44,72,53
51521,2036,1002,1034,528,396,615,497
51523,357,171,186,74,72,93,118
51525,1184,560,624,300,256,346,282
51526,1753,885,868,365,311,642,435
51527,530,282,248,145,80,200,105
51528,931,467,464,242,184,262,243
51529,1671,844,827,400,316,470,485
51530,854,443,411,209,137,259,249
51531,914,450,464,203,137,248,326
51532,622,308,314,166,114,193,149
51533,895,445,450,214,149,314,218
51534,9236,4626,4610,2674,1965,2875,1722
51535,1923,914,1009,496,348,565,514
51536,448,218,230,93,84,148,123
51537,6703,3180,3523,1764,1238,1946,1755
51540,449,229,220,109,84,134,122
51541,363,178,185,87,69,111,96
51542,1011,527,484,236,163,372,240
51543,445,218,227,106,72,147,120
51544,721,370,351,182,123,244,172
51545,378,194,184,94,74,101,109
51546,2915,1437,1478,844,606,871,594
51548,433,211,222,125,92,139,77
51549,465,235,230,122,96,153,94
51550,181,101,80,32,33,68,48
51551,1828,899,929,512,376,532,408
51552,301,144,157,75,60,96,70
51553,1013,532,481,297,206,288,222
51554,187,101,86,59,44,54,30
51555,5245,2574,2671,1363,1137,1548,1197
51556,437,217,220,119,87,133,98
51557,833,421,412,204,151,281,197
51558,560,286,274,125,82,196,157
51559,1788,892,896,512,382,525,369
51560,2099,1012,1087,546,453,573,527
51561,1455,760,695,346,292,513,304
51562,449,218,231,132,78,133,106
51563,779,382,397,214,162,233,170
51564,501,237,264,122,83,149,147
51565,501,270,231,119,79,165,138
51566,7035,3403,3632,1839,1376,1961,1859
51570,1039,508,531,264,207,331,237
51571,649,335,314,157,134,204,154
51572,398,208,190,82,72,132,112
51573,1093,519,574,257,174,346,316
51575,1616,815,801,482,310,502,322
51576,2110,1063,1047,696,431,663,320
51577,1184,577,607,291,211,355,327
51578,79,41,38,18,17,23,21
51579,2340,1159,1181,628,443,657,612
51601,6025,2846,3179,1456,1219,1574,1776
51630,173,90,83,36,32,54,51
51631,306,171,135,58,48,103,97
51632,7297,4070,3227,1733,1764,2086,1714
51636,405,196,209,94,66,137,108
51637,214,103,111,61,46,58,49
51638,1299,660,639,332,237,382,348
51639,795,369,426,174,131,286,204
51640,1737,879,858,437,359,448,493
51645,262,143,119,61,47,78,76
51646,763,390,373,181,171,206,205
51647,141,76,65,29,29,53,30
51648,255,127,128,53,54,70,78
51649,328,166,162,74,51,110,93
51650,370,193,177,100,78,98,94
51652,1783,876,907,458,368,495,462
51653,1379,667,712,381,261,370,367
51654,526,271,255,149,96,168,113
51656,71,41,30,21,11,23,16
52001,43173,21109,22064,11071,12244,10974,8884
52002,14559,7146,7413,4211,3219,4204,2925
52003,13436,6475,6961,3455,2553,4168,3260
52030,434,228,206,146,122,102,64
52031,5120,2568,2552,1280,943,1541,1356
52032,1456,768,688,378,283,509,286
52033,3202,1602,1600,928,686,886,702
52035,1010,515,495,236,174,349,251
52037,1223,625,598,325,238,381,279
52038,491,255,236,143,108,152,88
52039,1158,602,556,325,223,386,224
52040,5526,2715,2811,1532,1175,1555,1264
52041,1608,846,762,471,360,495,282
52042,1999,999,1000,715,395,466,423
52043,2321,1131,1190,482,405,727,707
52044,153,83,70,45,29,46,33
52045,2589,1337,1252,807,693,714,375
52046,2127,1072,1055,635,506,632,354
52047,567,287,280,154,114,181,118
52048,333,169,164,76,75,97,85
52049,1270,644,626,258,229,365,418
52050,515,248,267,138,115,171,91
52052,3136,1550,1586,670,515,949,1002
52053,1163,610,553,355,238,360,210
52054,940,492,448,259,183,318,180
52057,8222,4023,4199,2200,1663,2418,1941
52060,8658,4192,4466,2226,1729,2516,2187
52064,847,429,418,227,148,281,191
52065,1130,590,540,316,224,313,277
52066,80,47,33,9,13,30,28
52068,3924,1980,1944,1339,847,1123,615
52069,1609,801,808,427,338,464,380
52070,1128,566,562,267,176,349,336
52072,381,185,196,103,81,118,79
52073,1414,742,672,384,265,455,310
52074,310,159,151,90,57,95,68
52076,2295,1155,1140,608,471,643,573
52077,398,204,194,116,84,116,82
52078,914,470,444,274,190,281,169
52079,782,428,354,189,167,272,154
52101,13864,6731,7133,3571,3660,3463,3170
52132,1938,1007,931,526,430,579,403
52133,558,297,261,144,104,187,123
52134,285,152,133,53,46,105,81
52135,864,421,443,224,141,270,229
52136,5967,2941,3026,1614,1255,1723,1375
52140,532,283,249,121,100,172,139
52141,1435,740,695,392,269,420,354
52142,1871,979,892,482,588,445,356
52144,1261,648,613,355,209,412,285
52146,1039,580,459,162,163,335,379
52147,1050,535,515,259,197,326,268
52151,2138,1105,1033,445,333,656,704
52154,995,512,483,249,188,320,238
52155,1323,679,644,376,250,390,307
52156,659,331,328,183,145,207,124
52157,1828,917,911,416,356,533,523
52158,314,156,158,62,72,89,91
52159,2330,1164,1166,615,486,698,531
52160,867,450,417,225,161,258,223
52161,1505,759,746,412,309,456,328
52162,3285,1670,1615,1066,780,856,583
52163,276,134,142,56,66,78,76
52164,212,108,104,48,38,74,52
52165,1004,531,473,282,208,321,193
52166,104,56,48,12,17,38,37
52168,188,98,90,45,47,50,46
52169,432,220,212,108,84,128,112
52170,599,329,270,164,118,183,134
52171,1048,545,503,276,191,304,277
52172,6303,3085,3218,1624,1306,1732,1641
52175,3492,1762,1730,871,737,971,913
52201,1267,650,617,366,257,396,248
52202,1152,584,568,365,233,340,214
52203,1932,943,989,448,341,594,549
52205,8682,4744,3938,1973,2111,2644,1954
52206,2303,1174,1129,726,536,719,322
52207,383,189,194,83,71,129,100
52208,3153,1562,1591,810,635,967,741
52209,1074,538,536,296,223,338,217
52210,697,353,344,189,146,218,144
52211,2624,1283,1341,691,555,768,610
52212,285,149,136,57,63,92,73
52213,4340,2199,2141,1332,951,1347,710
52214,3090,1558,1532,774,597,983,736
52215,843,435,408,226,170,253,194
52216,1428,685,743,353,255,426,394
52217,590,296,294,159,108,175,148
52218,1788,891,897,522,380,496,390
52219,178,86,92,42,32,60,44
52220,237,117,120,68,59,76,34
52221,221,120,101,51,39,68,63
52222,709,370,339,180,133,218,178
52223,1351,680,671,312,217,490,332
52224,2016,1004,1012,544,376,573,523
52225,447,239,208,107,80,138,122
52227,2461,1241,1220,789,608,731,333
52228,2772,1387,1385,833,623,829,487
52229,721,361,360,196,130,242,153
52231,328,163,165,93,74,89,72
52232,178,88,90,41,42,55,40
52233,6981,3412,3569,1804,1950,1938,1289
52235,698,330,368,149,162,220,167
52236,592,295,297,167,118,192,115
52237,1522,775,747,446,280,490,306
52240,32230,16454,15776,6484,14658,6935,4153
52241,18911,9741,9170,4594,7370,4757,2190
52242,1592,746,846,1271,285,17,19
52245,22573,10940,11633,6092,8483,4681,3317
52246,21114,10471,10643,4628,9945,3958,2583
52247,5645,2673,2972,1810,1186,1428,1221
52248,1815,912,903,487,377,537,414
52249,965,462,503,247,171,277,270
52251,590,301,289,166,134,200,90
52253,3192,1601,1591,981,705,992,514
52254,895,447,448,238,167,251,239
52255,1208,599,609,323,210,344,331
52257,210,114,96,53,42,75,40
52301,3873,1893,1980,992,790,1183,908
52302,36980,17944,19036,10488,9754,9903,6835
52305,629,327,302,150,121,223,135
52306,1754,865,889,462,360,537,395
52307,90,50,40,13,16,29,32
52308,132,61,71,30,23,51,28
52309,397,202,195,77,75,150,95
52310,6431,3137,3294,1674,1340,1859,1558
52312,115,62,53,39,18,38,20
52313,397,212,185,98,87,140,72
52314,5865,2872,2993,1856,1678,1440,891
52315,1222,609,613,349,254,325,294
52316,1659,783,876,439,314,468,438
52317,14775,7273,7502,4237,6305,3145,1088
52318,1033,539,494,268,204,336,225
52320,1203,608,595,294,257,377,275
52321,404,204,200,97,81,130,96
52322,2436,1211,1225,653,516,800,467
52323,867,446,421,206,172,248,241
52324,1890,969,921,564,451,583,292
52325,873,459,414,263,155,318,137
52326,547,283,264,130,139,155,123
52327,3012,1541,1471,859,698,950,505
52328,2826,1431,1395,949,498,989,390
52329,803,417,386,205,172,266,160
52330,900,470,430,275,205,257,163
52332,2006,992,1014,486,404,668,448
52333,6168,3075,3093,1741,1063,2134,1230
52334,311,158,153,94,74,92,51
52335,709,380,329,200,137,218,154
52336,2363,1188,1175,612,490,759,502
52337,845,423,422,242,172,243,188
52338,3283,1675,1608,938,547,1240,558
52339,4504,2200,2304,1413,1046,1121,924
52340,2180,1073,1107,622,761,546,251
52341,1093,550,543,258,172,432,231
52342,3274,1575,1699,942,644,955,733
52345,1468,742,726,500,427,380,161
52346,1085,551,534,314,238,308,225
52347,1410,734,676,373,278,454,305
52348,51,27,24,10,10,22,9
52349,7643,3736,3907,2045,1567,2206,1825
52351,1455,746,709,521,335,474,125
52352,2025,1021,1004,671,423,564,367
52353,9173,4485,4688,2433,1880,2510,2350
52354,379,188,191,90,66,144,79
52355,277,150,127,57,56,113,51
52356,2656,1283,1373,775,521,758,602
52358,3733,1838,1895,1034,830,1133,736
52359,279,147,132,73,52,83,71
52361,4527,2204,2323,1265,999,1282,981
52362,1041,535,506,238,222,304,277
52401,2017,1178,839,355,757,597,308
52402,40149,19623,20526,10758,12046,10169,7176
52403,23673,11587,12086,6083,5639,6918,5033
52404,37796,18797,18999,10769,11699,9145,6183
52405,23621,11394,12227,6050,6224,6355,4992
52411,6896,3449,3447,2180,1014,2602,1100
52501,30220,14765,15455,7893,7543,8151,6633
52530,1005,495,510,217,202,303,283
52531,5976,2934,3042,1591,1253,1656,1476
52533,1215,612,603,291,267,388,269
52534,284,143,141,75,73,83,53
52535,888,455,433,198,163,278,249
52536,967,488,479,213,195,319,240
52537,7098,3496,3602,2206,1437,1851,1604
52540,1420,746,674,354,307,445,314
52542,395,209,186,104,70,106,115
52543,291,157,134,95,67,89,40
52544,7847,3749,4098,1988,1655,2146,2058
52548,97,47,50,32,23,24,18
52549,762,396,366,225,156,218,163
52550,585,289,296,137,139,154,155
52551,688,353,335,168,151,173,196
52552,830,404,426,284,158,196,192
52553,1745,858,887,485,379,526,355
52554,1373,674,699,354,294,406,319
52555,344,181,163,77,53,111,103
52556,13247,7131,6116,2489,3687,3792,3279
52557,85,57,28,12,19,24,30
52560,430,225,205,104,77,138,111
52561,962,498,464,263,228,271,200
52563,1583,784,799,422,349,449,363
52565,2027,980,1047,438,351,610,628
52566,168,89,79,41,30,71,26
52567,615,319,296,152,139,188,136
52569,610,339,271,107,87,182,234
52570,954,498,456,372,201,212,169
52571,1407,692,715,341,276,375,415
52572,1132,555,577,315,215,293,309
52573,137,73,64,30,20,41,46
52574,826,415,411,188,184,249,205
52576,568,286,282,143,95,178,152
52577,15055,7471,7584,4035,3761,3971,3288
52580,460,220,240,130,91,133,106
52581,305,156,149,50,51,96,108
52583,342,180,162,74,58,118,92
52584,438,227,211,156,79,122,81
52585,988,492,496,272,210,271,235
52586,521,284,237,103,118,189,111
52588,134,68,66,28,34,35,37
52590,1246,615,631,414,269,277,286
52591,3028,1486,1542,730,573,866,859
52593,142,75,67,37,31,43,31
52594,399,196,203,76,77,129,117
52595,416,215,201,115,140,91,70
52601,29723,14388,15335,7626,6899,8132,7066
52619,594,312,282,169,119,194,112
52620,938,468,470,279,222,252,185
52621,668,329,339,174,103,243,148
52623,1993,998,995,550,391,573,479
52624,290,137,153,70,67,81,72
52625,2802,1436,1366,689,575,886,652
52626,1245,631,614,310,236,367,332
52627,13105,6890,6215,3032,3267,3857,2949
52630,445,232,213,131,86,113,115
52632,13086,6306,6780,3496,2870,3611,3109
52635,675,356,319,198,141,201,135
52637,2449,1227,1222,657,518,712,562
52638,514,257,257,145,125,143,101
52639,2002,1015,987,449,385,663,505
52640,1447,745,702,415,328,370,334
52641,12357,6433,5924,3114,3207,3421,2615
52644,412,207,205,112,80,109,111
52645,3176,1596,1580,858,697,892,729
52646,376,193,183,135,78,98,65
52647,229,122,107,72,47,66,44
52649,887,428,459,213,170,283,221
52650,826,420,406,194,156,291,185
52651,646,332,314,176,150,162,158
52653,3570,1781,1789,941,764,1062,803
52654,1728,840,888,445,345,476,462
52655,4219,2011,2208,974,879,1237,1129
52656,2359,1207,1152,533,442,773,611
52657,95,46,49,23,26,24,22
52658,1071,536,535,251,167,361,292
52659,1553,775,778,442,322,435,354
52660,226,119,107,57,38,67,64
52701,108,48,60,33,34,17,24
52720,861,434,427,209,176,296,180
52721,798,413,385,210,163,231,194
52722,34754,16920,17834,9488,7449,10457,7360
52726,4468,2318,2150,1104,833,1516,1015
52727,409,221,188,117,67,144,81
52728,1110,560,550,311,294,310,195
52729,874,448,426,234,169,285,186
52730,4950,2453,2497,1208,1048,1440,1254
52731,894,455,439,251,172,290,181
52732,28293,13775,14518,7313,6601,7894,6485
52737,384,192,192,114,89,104,77
52738,3567,1843,1724,1027,806,1057,677
52739,745,385,360,242,197,196,110
52742,7618,3708,3910,2104,1580,2314,1620
52745,633,322,311,168,116,230,119
52746,967,501,466,258,169,350,190
52747,2106,1009,1097,587,451,619,449
52748,8850,4311,4539,2799,2149,2584,1318
52749,925,456,469,296,226,278,125
52750,619,324,295,200,120,189,110
52751,1054,547,507,277,230,325,222
52752,515,245,270,154,135,136,90
52753,5153,2608,2545,1308,1106,1686,1053
52754,1274,662,612,306,228,437,303
52755,1928,979,949,520,429,582,397
52756,2133,1088,1045,597,371,784,381
52757,201,108,93,43,52,56,50
52758,199,99,100,50,57,56,36
52760,533,261,272,116,103,168,146
52761,30678,15146,15532,8769,7293,8558,6058
52765,453,232,221,128,94,142,89
52766,820,423,397,209,164,281,166
52767,349,169,180,72,62,104,111
52768,1426,740,686,355,274,465,332
52769,671,349,322,170,130,226,145
52772,5029,2486,2543,1292,1021,1486,1230
52773,2380,1184,1196,601,506,739,534
52774,136,64,72,41,33,41,21
52776,4947,2475,2472,1551,1222,1329,845
52777,1357,683,674,368,254,376,359
52778,4043,2044,1999,1146,939,1221,737
52801,1122,706,416,107,535,281,199
52802,10868,5528,5340,3129,2939,3178,1622
52803,22174,10880,11294,6040,6932,5846,3356
52804,27379,13177,14202,7436,7372,7120,5451
52806,27503,13210,14293,7531,7579,7184,5209
52807,13470,6513,6957,3389,3868,3661,2552
56027,67,35,32,13,8,22,24
66002,13755,6604,7151,4059,3567,3369,2760
66006,7459,3673,3786,2190,1852,2048,1369
66007,5614,2729,2885,1541,1281,1714,1078
66008,286,143,143,72,53,92,69
66010,606,311,295,155,134,157,160
66012,11210,5460,5750,3160,2617,3374,2059
66013,1839,903,936,519,301,687,332
66014,349,185,164,70,66,103,110
66015,782,393,389,206,146,236,194
66016,519,268,251,142,110,163,104
66017,304,153,151,70,60,98,76
66018,5760,2892,2868,1797,1338,1739,886
66019,246,126,120,90,94,46,16
66020,1442,708,734,374,259,481,328
66021,2612,1350,1262,796,621,831,364
66023,1124,574,550,309,217,315,283
66024,927,454,473,276,232,263,156
66025,7704,3828,3876,2434,2113,2081,1076
66026,698,364,334,204,143,217,134
66027,5742,3126,2616,2561,2310,843,28
66030,20961,10479,10482,7123,7064,4808,1966
66031,1072,896,176,64,697,303,8
66032,5115,2502,2613,1427,1063,1274,1351
66033,767,393,374,209,149,230,179
66035,1311,691,620,461,318,254,278
66039,628,313,315,158,104,198,168
66040,3404,1721,1683,854,619,1027,904
66041,725,378,347,197,144,240,144
66042,657,335,322,156,105,257,139
66043,10787,6451,4336,2684,3196,3532,1375
66044,28417,14863,13554,6729,14472,4647,2569
66045,2023,746,1277,1323,697,3,0
66046,19452,9993,9459,4796,8401,4101,2154
66047,18268,8990,9278,4111,7002,4136,3019
66048,35475,18886,16589,8867,9587,10541,6480
66049,25957,12715,13242,6297,9023,6606,4031
66050,1822,930,892,472,302,651,397
66052,2031,1043,988,545,392,698,396
66053,7524,3720,3804,2303,1635,2351,1235
66054,2860,1452,1408,789,572,941,558
66056,1694,845,849,373,302,469,550
66058,393,203,190,112,77,106,98
66060,1122,570,552,322,216,303,281
66061,55805,27721,28084,17431,16564,14725,7085
66062,74411,36927,37484,24636,21488,20698,7589
66064,6098,2958,3140,1822,1444,1725,1107
66066,2636,1343,1293,674,502,836,624
66067,16170,7937,8233,4798,4071,4244,3057
66070,2661,1395,1266,713,542,862,544
66071,12360,6088,6272,3404,2498,3886,2572
66072,1054,541,513,298,231,299,226
66073,2537,1267,1270,716,541,768,512
66075,2103,1017,1086,576,423,589,515
66076,2200,1124,1076,588,444,714,454
66078,961,463,498,273,184,288,216
66079,781,398,383,212,161,265,143
66080,1065,547,518,298,210,318,239
66083,8910,4484,4426,2818,2142,2606,1344
66085,7779,3917,3862,2469,1164,2833,1313
66086,9759,4792,4967,2933,2398,2782,1646
66087,2042,1026,1016,558,460,580,444
66088,2457,1204,1253,679,469,774,535
66090,2520,1255,1265,627,562,730,601
66091,352,177,175,97,62,100,93
66092,4084,2031,2053,1183,884,1277,740
66093,609,306,303,174,105,169,161
66094,416,215,201,114,76,125,101
66095,896,466,430,242,182,264,208
66097,1071,521,550,266,203,311,291
66101,13220,6681,6539,4618,3929,3023,1650
66102,29282,14786,14496,10226,8875,6761,3420
66103,13934,7257,6677,3703,5740,3134,1357
66104,25401,12118,13283,7966,6286,6677,4472
66105,2924,1527,1397,1059,885,645,335
66106,23367,11520,11847,7412,6545,5865,3545
66109,20480,9971,10509,5589,5126,5975,3790
66111,10155,5009,5146,2866,2589,2843,1857
66112,11458,5338,6120,3139,3094,2838,2387
66115,0,0,0,0,0,0,0
66118,3,3,0,0,1,1,1
66202,16173,7803,8370,3253,5935,4163,2822
66203,19156,9231,9925,4559,5505,5123,3969
66204,18832,8951,9881,4181,6724,4529,3398
66205,13216,6300,6916,2878,4123,3607,2608
66206,9693,4681,5012,2589,1438,3143,2523
66207,13004,6179,6825,3020,2185,3783,4016
66208,20945,9756,11189,4883,5262,5911,4889
66209,19561,9244,10317,4829,3207,6495,5030
66210,18102,8729,9373,3935,5715,5215,3237
66211,4276,1960,2316,758,867,1196,1455
66212,32096,15369,16727,7181,9487,8279,7149
66213,27322,13302,14020,8050,6470,9093,3709
66214,11691,5701,5990,2840,3864,2877,2110
66215,24770,11825,12945,5782,6494,6872,5622
66216,24368,11875,12493,6742,5169,7962,4495
66217,5319,2493,2826,1224,1280,1523,1292
66218,7754,3902,3852,2849,2097,2221,587
66219,10486,5091,5395,2927,3512,3149,898
66220,7133,3586,3547,2333,1489,2370,941
66221,15219,7558,7661,5681,3119,5175,1244
66223,21759,10688,11071,7101,5591,6637,2430
66224,11917,5845,6072,4496,1807,4044,1570
66226,12877,6478,6399,4941,3290,3728,918
66227,4543,2215,2328,1283,1139,1310,811
66401,1721,850,871,403,335,527,456
66402,2955,1454,1501,872,553,959,571
66403,757,393,364,225,146,209,177
66404,530,285,245,158,95,167,110
66406,421,211,210,76,91,140,114
66407,479,249,230,158,85,161,75
66408,434,222,212,125,86,117,106
66409,2997,1550,1447,697,427,1168,705
66411,1292,619,673,342,246,342,362
66412,287,149,138,69,55,104,59
66413,1802,905,897,493,356,543,410
66414,2914,1460,1454,772,613,962,567
66415,885,457,428,256,182,229,218
66416,489,256,233,151,89,148,101
66417,310,169,141,104,58,97,51
66418,707,358,349,270,143,192,102
66419,442,216,226,148,87,118,89
66422,487,259,228,185,98,130,74
66423,985,491,494,256,170,333,226
66424,610,305,305,165,124,191,130
66425,465,237,228,94,78,153,140
66427,1281,645,636,311,254,351,365
66428,415,244,171,111,81,116,107
66429,579,291,288,137,98,193,151
66431,671,338,333,180,131,189,171
66432,396,216,180,92,61,144,99
66434,4828,2304,2524,1280,960,1379,1209
66436,5879,2857,3022,1583,1235,1648,1413
66438,149,76,73,42,22,55,30
66439,2747,1347,1400,843,572,672,660
66440,2063,1051,1012,584,436,657,386
66441,26746,13163,13583,8292,9033,6035,3386
66442,14283,8173,6110,5889,7583,773,38
66449,846,398,448,204,173,243,226
66451,1793,912,881,491,379,536,387
66501,260,142,118,63,65,81,51
66502,43850,22599,21251,9320,23004,6695,4831
66503,13428,6664,6764,3498,4255,3382,2293
66506,3614,1673,1941,2541,1071,2,0
66507,1247,637,610,438,254,317,238
66508,4375,2146,2229,1100,909,1229,1137
66509,2596,1321,1275,782,515,808,491
66510,779,394,385,205,154,219,201
66512,3361,1749,1612,890,639,1136,696
66514,1657,845,812,431,369,564,293
66515,425,213,212,120,82,130,93
66516,378,212,166,104,71,122,81
66517,2087,1059,1028,693,850,407,137
66518,189,101,88,40,25,68,56
66520,577,298,279,153,124,186,114
66521,1532,766,766,427,298,416,391
66522,49,22,27,19,6,17,7
66523,3833,1873,1960,1039,781,1077,936
66524,2499,1243,1256,654,455,755,635
66526,801,405,396,250,153,260,138
66527,267,125,142,86,51,70,60
66528,945,479,466,303,195,292,155
66531,1380,672,708,418,340,408,214
66532,668,347,321,175,136,205,152
66533,1832,881,951,618,371,454,389
66534,3725,1812,1913,1082,723,963,957
66535,2616,1313,1303,762,719,731,404
66536,3922,1938,1984,1738,784,820,580
66537,1448,713,735,418,270,442,318
66538,3264,1631,1633,828,563,956,917
66539,2806,1419,1387,886,568,821,531
66540,540,287,253,151,89,166,134
66541,236,116,120,52,31,86,67
66542,3335,1674,1661,802,556,1193,784
66543,725,348,377,169,129,206,221
66544,337,171,166,64,51,110,112
66546,1012,519,493,208,143,409,252
66547,7617,3734,3883,2248,1934,2119,1316
66548,961,469,492,252,186,262,261
66549,1646,816,830,456,327,473,390
66550,607,315,292,186,147,154,120
66552,396,201,195,93,92,123,88
66554,567,276,291,125,112,202,128
66603,2001,1104,897,596,661,576,168
66604,23344,11057,12287,5746,6795,5834,4969
66605,19919,9439,10480,6409,4838,5074,3598
66606,11284,5350,5934,2555,3181,3133,2415
66607,10498,5098,5400,3514,3145,2473,1366
66608,5991,3013,2978,1609,1509,1786,1087
66609,7068,3413,3655,2044,1888,1871,1265
66610,9080,4440,4640,2554,1518,3089,1919
66611,9832,4620,5212,2210,2899,2280,2443
66612,2477,1310,1167,620,617,865,375
66614,31354,14716,16638,7584,8033,8260,7477
66615,2814,1387,1427,760,654,816,584
66616,5874,2892,2982,1578,1488,1598,1210
66617,8688,4332,4356,2345,1619,2792,1932
66618,9402,4742,4660,2877,1821,2829,1875
66619,3070,1497,1573,1222,921,675,252
66621,643,221,422,327,312,3,1
66622,76,72,4,0,10,33,33
66701,12325,5994,6331,3657,2846,2984,2838
66710,746,364,382,184,158,222,182
66711,610,310,300,157,126,205,122
66712,1939,939,1000,474,441,534,490
66713,5836,2867,2969,1661,1331,1553,1291
66714,177,93,84,29,28,55,65
66716,567,274,293,152,104,158,153
66717,497,257,240,121,90,162,124
66720,11299,5464,5835,3174,2550,2956,2619
66724,1065,552,513,307,228,322,208
66725,5739,2801,2938,1499,1283,1566,1391
66728,91,40,51,31,22,19,19
66732,291,146,145,74,44,92,81
66733,2215,1120,1095,564,446,645,560
66734,332,177,155,86,64,102,80
66735,421,211,210,122,93,124,82
66736,3954,1952,2002,1027,816,1014,1097
66738,376,186,190,82,91,120,83
66739,5453,2760,2693,1514,1147,1644,1148
66740,477,249,228,171,86,128,92
66741,237,118,119,77,50,73,37
66743,4373,2135,2238,1159,983,1206,1025
66746,261,136,125,74,51,96,40
66748,2750,1313,1437,737,579,765,669
66749,7974,3876,4098,2235,1882,2000,1857
66751,849,443,406,199,186,265,199
66753,1077,557,520,274,223,336,244
66754,451,242,209,113,63,142,133
66755,1178,573,605,293,202,348,335
66756,1007,517,490,261,213,331,202
66757,3560,1712,1848,995,768,970,827
66758,216,112,104,54,39,63,60
66760,98,54,44,20,16,32,30
66761,238,128,110,49,48,87,54
66762,24786,12399,12387,6747,8881,5060,4098
66763,3369,1560,1809,861,794,840,874
66767,511,250,261,102,89,149,171
66769,557,273,284,183,108,137,129
66770,1158,581,577,343,248,314,253
66771,1028,512,516,286,210,281,251
66772,253,136,117,79,45,61,68
66773,866,433,433,228,178,292,168
66775,191,106,85,32,34,49,76
66776,1288,685,603,384,272,365,267
66777,639,339,300,108,74,203,254
66778,139,76,63,31,35,50,23
66779,650,330,320,192,149,150,159
66780,589,302,287,160,131,154,144
66781,1347,683,664,379,285,417,266
66782,178,87,91,48,39,56,35
66783,2230,1092,1138,495,435,665,635
66801,28492,13845,14647,7945,9166,6616,4765
66830,262,126,136,71,55,73,63
66833,536,273,263,138,89,170,139
66834,848,439,409,192,161,262,233
66835,1360,662,698,398,289,411,262
66838,182,85,97,43,18,53,68
66839,4007,1950,2057,1074,837,1224,872
66840,777,407,370,235,162,212,168
66842,324,167,157,82,53,99,90
66843,205,113,92,43,31,61,70
66845,1232,618,614,293,267,310,362
66846,3504,1726,1778,770,617,1044,1073
66849,485,246,239,107,88,155,135
66850,228,121,107,60,42,69,57
66851,583,296,287,132,103,176,172
66852,631,310,321,161,125,176,169
66853,429,218,211,106,77,125,121
66854,816,429,387,216,136,274,190
66856,1613,849,764,447,286,500,380
66857,943,478,465,253,154,263,273
66858,456,235,221,131,71,143,111
66859,178,93,85,31,29,57,61
66860,1258,627,631,323,227,392,316
66861,3204,1579,1625,813,505,911,975
66862,116,60,56,17,13,35,51
66863,63,30,33,13,11,17,22
66864,456,228,228,123,89,142,102
66865,1124,578,546,320,208,355,241
66866,1789,918,871,453,305,553,478
66868,764,399,365,198,164,242,160
66869,748,380,368,197,161,225,165
66870,166,87,79,27,16,49,74
66871,1346,639,707,340,274,389,343
66872,1134,581,553,307,236,331,260
66873,319,163,156,96,56,92,75
66901,6605,3187,3418,1811,1456,1627,1711
66930,186,95,91,36,27,53,70
66932,157,83,74,32,23,50,52
66933,298,154,144,57,65,83,93
66935,2563,1221,1342,526,393,710,934
66936,344,171,173,57,42,120,125
66937,893,449,444,235,159,248,251
66938,1005,498,507,252,184,249,320
66939,537,269,268,128,93,154,162
66940,339,178,161,71,46,102,120
66941,242,129,113,46,31,75,90
66942,247,142,105,51,33,58,105
66943,505,265,240,114,88,143,160
66944,195,95,100,38,25,61,71
66945,1096,559,537,310,213,302,271
66946,126,66,60,29,16,43,38
66948,494,258,236,115,109,149,121
66949,668,352,316,155,111,186,216
66951,764,372,392,193,127,216,228
66952,499,254,245,97,61,164,177
66953,703,338,365,176,136,168,223
66955,114,65,49,32,21,36,25
66956,1157,570,587,225,180,327,425
66958,314,168,146,80,64,84,86
66959,203,105,98,37,33,65,68
66960,167,95,72,35,30,56,46
66962,264,141,123,53,57,80,74
66963,135,68,67,25,22,46,42
66964,204,103,101,28,31,72,73
66966,624,297,327,131,111,202,180
66967,2096,1007,1089,470,339,602,685
66968,1626,795,831,383,273,443,527
66970,97,49,48,13,14,35,35
67001,1676,836,840,706,329,463,178
67002,13764,6714,7050,4751,3126,4039,1848
67003,2626,1271,1355,653,519,684,770
67004,827,414,413,240,159,245,183
67005,16535,8102,8433,4907,3946,4212,3470
67008,556,279,277,137,82,193,144
67009,856,417,439,223,159,200,274
67010,13890,6792,7098,4049,3167,3942,2732
67012,61,29,32,11,8,20,22
67013,3145,1629,1516,919,668,1019,539
67016,530,282,248,155,150,140,85
67017,2294,1147,1147,701,456,712,425
67018,149,79,70,30,27,42,50
67019,945,490,455,263,196,246,240
67020,1689,828,861,481,350,501,357
67021,65,33,32,17,13,16,19
67022,1461,707,754,328,274,427,432
67023,230,120,110,60,45,62,63
67024,849,443,406,216,147,226,260
67025,3884,1965,1919,1257,777,1160,690
67026,4845,2375,2470,1509,967,1413,956
67028,225,112,113,62,54,59,50
67029,1063,508,555,268,189,269,337
67030,2659,1351,1308,1019,498,774,368
67031,2308,1144,1164,813,438,630,427
67035,970,477,493,201,165,294,310
67036,151,75,76,36,20,57,38
67037,26577,13053,13524,7991,6560,7604,4422
67038,602,302,300,171,104,160,167
67039,3395,1700,1695,1026,720,1037,612
67041,229,119,110,86,43,54,46
67042,17969,9490,8479,4960,5013,4633,3363
67045,3644,1761,1883,896,737,993,1018
67047,731,369,362,135,115,250,231
67049,79,45,34,19,15,23,22
67050,1844,923,921,626,370,527,321
67051,456,240,216,123,91,138,104
67052,8325,4198,4127,2912,1989,2373,1051
67053,539,247,292,132,94,131,182
67054,1167,570,597,284,231,356,296
67055,71,37,34,12,10,25,24
67056,2935,1428,1507,853,600,834,648
67057,241,127,114,49,36,77,79
67058,2093,1058,1035,561,438,572,522
67059,1042,514,528,286,247,270,239
67060,13733,6673,7060,4352,3318,3699,2364
67061,171,94,77,32,27,57,55
67062,4156,2042,2114,1222,929,964,1041
67063,3942,1952,1990,1012,952,989,989
67065,228,109,119,50,61,61,56
67066,302,154,148,65,55,93,89
67067,1541,769,772,406,330,549,256
67068,4354,2138,2216,1182,874,1173,1125
67070,1169,575,594,276,223,323,347
67071,94,47,47,19,7,41,27
67072,244,126,118,52,43,85,64
67073,309,152,157,94,78,80,57
67074,1741,891,850,474,337,576,354
67101,3604,1753,1851,1305,1028,831,440
67103,326,158,168,102,61,104,59
67104,2506,1278,1228,658,528,706,614
67105,190,99,91,40,40,53,57
67106,388,194,194,116,75,128,69
67107,2979,1408,1571,714,553,788,924
67108,1696,852,844,517,333,508,338
67109,418,210,208,124,88,96,110
67110,8415,4129,4286,2591,1912,2408,1504
67111,352,181,171,102,50,118,82
67112,227,126,101,35,39,80,73
67114,21852,10694,11158,6211,5184,5810,4647
67117,1769,808,961,381,374,339,675
67118,810,377,433,261,136,247,166
67119,1457,717,740,358,289,459,351
67120,1358,706,652,326,255,523,254
67122,221,125,96,54,39,64,64
67123,741,377,364,208,151,227,155
67124,8203,4013,4190,2166,1867,2155,2015
67127,701,338,363,165,129,180,227
67131,258,126,132,76,43,87,52
67132,410,215,195,133,78,126,73
67133,6379,3169,3210,1967,1313,2053,1046
67134,420,213,207,143,98,109,70
67135,3493,1752,1741,1083,676,1087,647
67137,634,310,324,130,94,191,219
67138,397,197,200,106,71,110,110
67140,802,411,391,228,151,238,185
67142,445,246,199,82,77,143,143
67143,58,31,27,8,9,25,16
67144,2716,1362,1354,817,547,835,517
67146,1830,899,931,528,377,556,369
67147,9908,4949,4959,3292,2182,2832,1602
67149,988,510,478,277,186,349,176
67150,12,6,6,0,1,5,6
67151,479,259,220,119,101,153,106
67152,9541,4678,4863,2728,2162,2589,2062
67154,1510,759,751,455,255,468,332
67155,166,86,80,31,29,61,45
67156,15269,7761,7508,4017,3815,4136,3301
67159,169,87,82,27,27,54,61
67202,1393,991,402,67,678,527,121
67203,31287,15736,15551,8115,9642,7883,5647
67204,21194,10613,10581,6335,4865,5608,4386
67205,16811,8333,8478,5785,3800,5000,2226
67206,15186,7265,7921,3534,3369,4420,3863
67207,26978,13188,13790,7485,9227,6467,3799
67208,18161,8822,9339,5056,5878,4303,2924
67209,13654,6728,6926,3923,3603,3682,2446
67210,10339,5394,4945,3859,3587,2132,761
67211,20644,10430,10214,6146,6204,5447,2847
67212,44707,21767,22940,11896,11616,12441,8754
67213,21368,10667,10701,6155,6640,5372,3201
67214,16542,8215,8327,5687,4491,4138,2226
67215,5708,2843,2865,1834,1512,1684,678
67216,24041,11914,12127,7898,6923,5867,3353
67217,30186,14845,15341,9271,8435,7476,5004
67218,22772,10891,11881,6522,6975,5404,3871
67219,12121,5847,6274,4343,3549,2634,1595
67220,14214,6884,7330,3864,4693,3499,2158
67223,513,262,251,154,84,186,89
67226,17757,8590,9167,4495,5087,4758,3417
67227,344,182,162,89,58,127,70
67228,2033,1024,1009,803,529,554,147
67230,9959,4946,5013,3077,1588,3419,1875
67232,298,154,144,50,49,120,79
67235,11446,5672,5774,3787,2604,3552,1503
67260,0,0,0,0,0,0,0
67301,13556,6675,6881,3800,3107,3689,2960
67330,1535,746,789,478,324,424,309
67332,207,109,98,58,41,63,45
67333,3089,1501,1588,862,697,861,669
67334,104,50,54,19,16,30,39
67335,3671,1836,1835,1027,789,1008,847
67336,1683,839,844,417,308,464,494
67337,13493,6533,6960,3590,3190,3398,3315
67340,355,177,178,79,78,116,82
67341,373,198,175,119,76,105,73
67342,969,469,500,259,195,281,234
67344,877,462,415,196,152,271,258
67345,161,78,83,29,11,55,66
67346,372,180,192,86,60,97,129
67347,431,223,208,101,83,117,130
67349,1034,500,534,220,172,280,362
67351,391,199,192,84,70,128,109
67352,593,297,296,171,103,164,155
67353,582,297,285,116,98,162,206
67354,825,404,421,239,165,225,196
67355,213,117,96,57,42,54,60
67356,2834,1445,1389,752,613,764,705
67357,13006,6399,6607,3553,3022,3615,2816
67360,409,225,184,91,79,134,105
67361,1841,904,937,405,323,485,628
67363,78,39,39,11,10,27,30
67364,311,155,156,87,58,100,66
67401,51499,25558,25941,14318,13068,13895,10218
67410,10141,4976,5165,2704,2121,2813,2503
67416,1146,595,551,325,206,366,249
67417,179,96,83,47,35,56,41
67418,246,142,104,57,52,74,63
67420,4721,2371,2350,1212,947,1264,1298
67422,1366,705,661,401,255,461,249
67423,316,150,166,70,47,119,80
67425,689,368,321,190,138,220,141
67427,408,214,194,103,74,124,107
67428,1465,744,721,397,302,449,317
67430,611,316,295,125,109,165,212
67431,2471,1214,1257,672,561,695,543
67432,6019,2966,3053,1503,1202,1600,1714
67436,636,327,309,152,131,179,174
67437,1161,567,594,267,214,336,344
67438,300,158,142,75,55,90,80
67439,3674,2233,1441,724,1123,1045,782
67441,1115,534,581,343,254,285,233
67442,266,140,126,71,45,109,41
67443,1794,897,897,525,448,509,312
67444,527,286,241,100,90,173,164
67445,680,333,347,151,105,199,225
67446,617,311,306,150,114,199,154
67447,320,161,159,73,63,106,78
67448,1374,693,681,373,256,442,303
67449,3351,1627,1724,885,712,915,839
67450,555,272,283,123,77,180,175
67451,948,491,457,210,155,327,256
67452,201,102,99,35,37,52,77
67454,563,295,268,102,113,183,165
67455,1980,961,1019,529,358,551,542
67456,4736,2288,2448,1260,1085,1269,1122
67457,878,417,461,280,170,216,212
67458,261,139,122,77,40,74,70
67459,251,127,124,75,46,75,55
67460,15168,7543,7625,3970,3628,4209,3361
67464,1090,526,564,257,183,345,305
67466,774,387,387,215,157,195,207
67467,2904,1503,1401,786,616,787,715
67468,307,162,145,78,61,98,70
67470,456,235,221,112,66,174,104
67473,1728,845,883,401,274,513,540
67474,224,111,113,52,35,62,75
67475,283,156,127,92,56,86,49
67478,89,46,43,23,16,34,16
67480,1805,917,888,516,373,577,339
67481,590,311,279,143,90,189,168
67482,99,53,46,26,22,34,17
67483,338,180,158,100,54,89,95
67484,891,461,430,246,163,279,203
67485,339,181,158,92,42,101,104
67487,1422,704,718,415,326,383,298
67490,1055,521,534,223,172,334,326
67491,399,199,200,126,64,121,88
67492,166,88,78,45,45,46,30
67501,27212,14459,12753,7667,8141,7085,4319
67502,23739,11186,12553,5818,4391,6532,6998
67505,2457,1121,1336,576,465,617,799
67510,281,139,142,56,49,87,89
67511,318,158,160,62,53,95,108
67512,234,124,110,58,45,70,61
67513,93,39,54,20,12,31,30
67514,765,389,376,223,147,215,180
67515,63,37,26,10,7,26,20
67516,447,226,221,119,90,111,127
67518,69,38,31,16,9,22,22
67519,193,97,96,54,32,51,56
67520,415,209,206,101,69,141,104
67521,155,83,72,29,18,64,44
67522,2049,1004,1045,568,372,579,530
67523,373,192,181,96,58,112,107
67524,630,326,304,182,135,165,148
67525,1119,557,562,286,191,384,258
67526,2759,1361,1398,682,589,792,696
67529,365,182,183,87,66,116,96
67530,19699,9654,10045,5579,4681,5159,4280
67543,2125,1025,1100,616,477,572,460
67544,3216,1555,1661,876,678,901,761
67545,215,115,100,48,23,86,58
67546,2597,1267,1330,687,443,736,731
67547,1769,859,910,431,346,520,472
67548,1467,702,765,314,284,409,460
67550,5905,3325,2580,1457,1354,1721,1373
67552,720,386,334,187,135,236,162
67553,114,58,56,19,23,39,33
67554,4334,2128,2206,1203,965,1132,1034
67556,320,159,161,65,44,109,102
67557,723,351,372,230,165,202,126
67559,52,31,21,9,7,16,20
67560,1740,869,871,426,316,500,498
67561,1538,788,750,442,326,425,345
67563,371,181,190,92,63,120,96
67564,308,161,147,78,49,101,80
67565,429,227,202,89,71,137,132
67566,650,324,326,215,120,189,126
67567,526,284,242,130,86,213,97
67568,309,152,157,76,47,87,99
67570,1338,676,662,336,244,406,352
67572,456,222,234,91,59,134,172
67573,170,92,78,40,39,53,38
67574,252,127,125,56,35,94,67
67575,465,238,227,103,73,136,153
67576,1915,962,953,475,348,584,508
67578,1405,681,724,323,257,382,443
67579,3095,1578,1517,889,827,743,636
67581,416,217,199,104,79,124,109
67583,1022,506,516,266,199,294,263
67584,269,133,136,53,45,77,94
67601,23797,11831,11966,6050,8138,5511,4098
67621,393,200,193,102,51,122,118
67622,599,316,283,172,105,162,160
67623,270,140,130,59,45,80,86
67625,257,127,130,40,43,75,99
67626,145,76,69,26,15,52,52
67628,78,42,36,13,9,22,34
67629,143,74,69,26,26,46,45
67631,249,129,120,58,42,90,59
67632,227,112,115,64,40,63,60
67634,301,156,145,53,58,87,103
67635,169,88,81,35,25,61,48
67637,2651,1284,1367,715,597,761,578
67638,230,119,111,44,30,75,81
67639,193,97,96,52,31,60,50
67640,505,252,253,122,119,152,112
67642,1729,831,898,378,321,527,503
67643,195,105,90,15,27,69,84
67644,264,138,126,58,47,76,83
67645,546,299,247,111,96,162,177
67646,718,337,381,201,122,188,207
67647,256,139,117,68,50,70,68
67648,549,269,280,122,89,133,205
67649,297,150,147,56,53,93,95
67650,258,129,129,39,38,78,103
67651,507,275,232,119,96,128,164
67653,298,164,134,61,55,87,95
67654,4362,2469,1893,912,1128,1307,1015
67656,156,81,75,36,27,58,35
67657,429,205,224,130,90,105,104
67658,120,60,60,27,15,42,36
67659,154,78,76,33,15,52,54
67660,81,45,36,21,16,24,20
67661,3483,1706,1777,893,674,973,943
67663,2615,1283,1332,694,548,725,648
67664,305,162,143,88,52,81,84
67665,5162,2534,2628,1234,1046,1410,1472
67667,204,106,98,62,54,56,32
67669,1725,833,892,407,311,515,492
67671,1714,878,836,424,384,467,439
67672,2359,1144,1215,533,387,725,714
67673,108,55,53,32,12,40,24
67674,55,29,26,6,13,16,20
67675,217,119,98,51,38,61,67
67701,6502,3167,3335,1843,1699,1662,1298
67730,1612,788,824,342,253,459,558
67731,675,337,338,181,108,179,207
67732,543,278,265,153,95,158,137
67733,149,85,64,36,20,49,44
67734,182,97,85,51,38,56,37
67735,5476,2736,2740,1395,1266,1448,1367
67736,228,114,114,48,35,72,73
67737,444,213,231,108,77,131,128
67738,520,275,245,107,92,146,175
67739,258,138,120,43,37,87,91
67740,1724,854,870,406,316,489,513
67741,326,159,167,78,57,104,87
67743,158,81,77,47,39,44,28
67744,185,93,92,32,28,69,56
67745,322,157,165,74,48,88,112
67747,158,77,81,47,31,42,38
67748,2544,1255,1289,632,512,731,669
67749,2317,1135,1182,503,370,656,788
67751,259,140,119,59,41,84,75
67752,1399,687,712,373,254,341,431
67753,530,265,265,173,105,143,109
67756,2016,1021,995,432,323,558,703
67757,482,269,213,125,82,150,125
67758,1016,498,518,273,168,286,289
67761,249,131,118,68,33,83,65
67762,288,153,135,87,71,75,55
67764,345,179,166,87,71,111,76
67801,30559,15742,14817,10776,8888,7004,3891
67831,1117,558,559,306,198,314,299
67834,964,481,483,282,212,238,232
67835,2954,1444,1510,1014,697,770,473
67836,147,76,71,36,28,48,35
67837,903,459,444,325,200,232,146
67838,982,490,492,324,228,267,163
67839,1416,689,727,323,256,427,410
67840,103,61,42,19,11,29,44
67841,339,173,166,93,68,104,74
67842,427,227,200,103,105,125,94
67843,165,129,36,0,5,29,131
67844,894,439,455,262,163,234,235
67846,33696,16910,16786,11892,9017,8530,4257
67849,380,186,194,93,56,125,106
67850,335,168,167,105,56,91,83
67851,2691,1346,1345,1075,660,726,230
67853,860,437,423,267,206,265,122
67854,1407,703,704,395,253,410,349
67855,1976,1005,971,636,471,482,387
67857,174,86,88,46,29,39,60
67859,735,394,341,272,175,181,107
67860,2878,1478,1400,950,646,729,553
67861,1962,991,971,576,414,524,448
67862,302,158,144,83,59,82,78
67863,305,170,135,75,61,86,83
67864,2227,1124,1103,641,422,607,557
67865,1081,505,576,312,209,260,300
67867,1578,757,821,480,387,379,332
67868,198,103,95,77,52,38,31
67869,1492,782,710,540,350,388,214
67870,1765,877,888,581,395,475,314
67871,4973,2504,2469,1343,1044,1398,1188
67876,1156,581,575,335,216,358,247
67877,2255,1131,1124,777,518,611,349
67878,2436,1233,1203,772,659,582,423
67879,1247,595,652,297,237,376,337
67880,7878,4024,3854,2659,1995,2003,1221
67882,346,185,161,90,75,107,74
67901,22073,11352,10721,7902,6502,5033,2636
67950,2412,1157,1255,715,539,618,540
67951,4981,2485,2496,1649,1172,1294,866
67952,710,345,365,244,170,191,105
67953,144,71,73,30,24,49,41
67954,661,334,327,216,134,183,128
68325,34,20,14,7,2,14,11
68978,70,29,41,15,6,26,23
38079,18,10,8,5,5,4,4
40003,1902,985,917,539,378,634,351
40004,28245,13651,14594,8241,7247,8025,4732
40006,5084,2573,2511,1412,1203,1531,938
40007,166,85,81,43,36,45,42
40008,3476,1766,1710,1002,798,1026,650
40009,1051,536,515,268,248,326,209
40010,587,305,282,223,111,201,52
40011,2549,1238,1311,688,567,756,538
40012,589,286,303,144,123,177,145
40013,5369,2766,2603,1507,1279,1719,864
40014,19986,9845,10141,6333,3803,6817,3033
40019,3789,1837,1952,1117,887,1058,727
40020,109,58,51,23,27,17,42
40022,834,429,405,218,129,322,165
40023,4118,2129,1989,1150,884,1444,640
40025,59,28,31,7,8,11,33
40026,5458,2669,2789,1875,960,1926,697
40031,22863,13241,9622,5707,6368,7232,3556
40033,12355,6073,6282,3406,2976,3509,2464
40036,223,118,105,52,44,75,52
40037,2864,1491,1373,872,731,789,472
40040,531,264,267,159,107,151,114
40041,286,74,212,0,5,13,268
40045,3451,1766,1685,902,819,1024,706
40046,1741,899,842,480,398,589,274
40047,19345,9463,9882,5630,4917,5685,3113
40048,113,0,113,0,0,2,111
40049,115,6,109,0,2,3,110
40050,1389,633,756,366,294,365,364
40051,4799,2485,2314,1328,1106,1537,828
40052,515,262,253,124,126,167,98
40055,1752,887,865,437,381,626,308
40056,3263,1572,1691,926,674,975,688
40057,3354,1692,1662,887,753,996,718
40058,64,30,34,14,10,15,25
40059,16708,8257,8451,5044,2474,5899,3291
40060,1184,636,548,329,253,390,212
40062,301,155,146,79,76,90,56
40063,789,785,4,2,563,210,14
40065,28025,13536,14489,7869,7389,7780,4987
40067,5114,2499,2615,1437,1247,1491,939
40068,2131,1067,1064,523,430,759,419
40069,8276,4024,4252,2210,1863,2363,1840
40070,582,311,271,167,138,170,107
40071,14292,7200,7092,4019,3323,4587,2363
40075,1323,701,622,383,279,404,257
40076,2516,1293,1223,624,544,826,522
40077,564,287,277,136,103,202,123
40078,2200,1095,1105,536,506,703,455
40104,1336,664,672,378,288,415,255
40107,2067,1051,1016,511,435,722,399
40108,11583,5724,5859,3245,2770,3393,2175
40109,1990,995,995,444,394,722,430
40110,60,31,29,15,14,20,11
40111,1682,851,831,425,362,481,414
40115,727,365,362,179,158,239,151
40117,2299,1145,1154,630,511,755,403
40118,9724,4788,4936,2712,2646,2740,1626
40119,1797,912,885,402,298,586,511
40121,10124,5898,4226,4025,5148,924,27
40140,787,408,379,259,174,218,136
40142,2304,1195,1109,625,556,699,424
40143,5939,2913,3026,1492,1386,1656,1405
40144,1866,922,944,510,369,574,413
40145,908,453,455,286,186,256,180
40146,3745,1846,1899,1050,833,1085,777
40150,4103,2050,2053,1059,909,1390,745
40152,604,317,287,103,87,226,188
40155,947,487,460,243,346,246,112
40157,876,447,429,220,221,258,177
40160,23574,11483,12091,6837,6892,6349,3496
40161,178,97,81,48,46,54,30
40162,6056,3071,2985,1888,1430,1941,797
40165,32726,16280,16446,8967,8207,9973,5579
40170,344,188,156,127,74,76,67
40171,243,129,114,55,44,80,64
40175,13070,6498,6572,3801,3365,4013,1891
40176,931,484,447,264,218,269,180
40177,1463,722,741,344,353,480,286
40178,468,245,223,112,81,154,121
40202,6772,4329,2443,867,3048,2151,706
40203,19694,9415,10279,5805,5767,4947,3175
40204,14236,7264,6972,2218,5649,3991,2378
40205,23678,11215,12463,4948,6246,7028,5456
40206,18865,9150,9715,3319,6539,5285,3722
40207,29745,14060,15685,6408,7710,8132,7495
40208,13227,6875,6352,3580,5430,2885,1332
40209,360,193,167,90,107,108,55
40210,14822,6713,8109,4743,3561,4045,2473
40211,22612,10112,12500,7300,5181,6181,3950
40212,17685,8411,9274,5436,4262,5045,2942
40213,16796,8351,8445,4049,4915,4694,3138
40214,45291,22167,23124,11916,13078,12447,7850
40215,22287,10618,11669,6920,6220,6103,3044
40216,40746,19301,21445,10713,9927,12132,7974
40217,12507,6288,6219,2247,4669,3388,2203
40218,31658,15058,16600,8631,9368,8332,5327
40219,38032,18406,19626,10189,10562,10157,7124
40220,33109,15735,17374,7411,9022,9106,7570
40222,21359,10111,11248,4319,5931,5326,5783
40223,22011,10427,11584,5561,4866,6612,4972
40228,15743,7533,8210,4172,4051,4480,3040
40229,36852,18248,18604,10804,10820,9864,5364
40231,0,0,0,0,0,0,0
40241,28988,13907,15081,7263,7008,8552,6165
40242,10930,5225,5705,2636,2982,2907,2405
40243,10210,4737,5473,2293,2126,2793,2998
40245,30109,14307,15802,8934,7285,9463,4427
40258,26465,12748,13717,7249,6897,7428,4891
40272,37394,18142,19252,10212,9333,10673,7176
40280,303,205,98,65,187,32,19
40291,35427,17075,18352,9293,9629,10215,6290
40299,38371,18745,19626,10139,9491,11486,7255
40310,526,264,262,140,135,138,113
40311,7153,3539,3614,1872,1604,2068,1609
40312,5898,2957,2941,1660,1500,1719,1019
40313,3143,1526,1617,796,1031,791,525
40316,309,150,159,93,85,79,52
40322,3328,1655,1673,911,761,880,776
40324,41342,20237,21105,12529,11972,11295,5546
40328,1065,522,543,294,240,335,196
40330,19334,9406,9928,5044,4272,5644,4374
40334,76,18,58,48,6,15,7
40336,13061,6420,6641,3326,3016,3924,2795
40337,5501,2755,2746,1542,1366,1622,971
40339,46,25,21,6,10,17,13
40342,21125,10312,10813,5867,5258,6263,3737
40346,686,344,342,187,174,190,135
40347,2767,1226,1541,746,637,860,524
40348,600,316,284,168,114,190,128
40350,228,120,108,60,56,65,47
40351,20329,9886,10443,5510,6525,4785,3509
40353,20779,10090,10689,5515,5513,5760,3991
40356,40503,19655,20848,11788,10594,11530,6591
40358,904,475,429,251,219,265,169
40359,7080,3480,3600,1930,1649,2039,1462
40360,6564,3237,3327,1822,1512,1846,1384
40361,18220,8843,9377,4817,4193,5304,3906
40363,22,11,11,5,1,6,10
40370,2763,1426,1337,734,579,985,465
40371,2838,1425,1413,724,686,841,587
40372,2128,1071,1057,504,423,747,454
40374,1702,830,872,449,357,524,372
40376,52,29,23,8,5,23,16
40379,3288,1685,1603,893,733,1088,574
40380,6612,3257,3355,1736,1621,1881,1374
40383,22408,10849,11559,5969,4948,7141,4350
40385,3131,1560,1571,794,712,939,686
40387,2046,1037,1009,483,425,601,537
40390,7366,3640,3726,2106,2339,1585,1336
40391,35262,17211,18051,9061,8729,10185,7287
40402,2905,1443,1462,799,674,831,601
40403,23774,11455,12319,6574,6396,6452,4352
40404,643,318,325,225,418,0,0
40409,3843,1844,1999,964,846,1159,874
40419,4621,2349,2272,1329,1079,1295,918
40422,24280,11834,12446,6091,5864,6791,5534
40434,34,16,18,7,7,8,12
40437,4932,2460,2472,1246,1187,1448,1051
40440,2092,985,1107,578,522,596,396
40442,1136,563,573,329,256,331,220
40444,14096,6935,7161,3565,3198,4363,2970
40445,997,466,531,246,236,306,209
40447,8251,4105,4146,2086,2061,2467,1637
40448,53,24,29,13,16,14,10
40456,9300,4600,4700,2383,2235,2726,1956
40460,1129,564,565,272,249,361,247
40461,3121,1562,1559,835,835,941,510
40464,1114,560,554,282,251,352,229
40468,1807,863,944,446,396,542,423
40472,1679,845,834,372,354,512,441
40475,55803,27147,28656,14735,18655,13759,8654
40481,218,115,103,66,65,64,23
40484,11612,5652,5960,3119,2784,3278,2431
40486,2223,1095,1128,601,554,636,432
40489,4109,2059,2050,1138,942,1127,902
40502,25709,12360,13349,4736,8035,6959,5979
40503,28003,13827,14176,6051,8947,7518,5487
40504,25655,12738,12917,6085,9252,5816,4502
40505,26040,12875,13165,6290,7088,7525,5137
40506,2802,1379,1423,2182,620,0,0
40507,1757,999,758,87,708,556,406
40508,23569,11813,11756,6011,10864,4451,2243
40509,32364,15440,16924,8449,11587,8082,4246
40510,1928,1340,588,213,881,588,246
40511,31798,16617,15181,8086,11902,7811,3999
40513,10994,5248,5746,3251,1889,3965,1889
40514,14647,7053,7594,4381,3766,4668,1832
40515,33595,16317,17278,8950,10268,10063,4314
40516,2877,1421,1456,687,687,906,597
40517,35227,16765,18462,8613,13945,7894,4775
40601,49566,23815,25751,12412,12391,14546,10217
40604,462,437,25,2,294,159,7
40701,29497,14103,15394,7877,7079,8105,6436
40729,5485,2777,2708,1485,1337,1636,1027
40734,3764,1892,1872,1049,883,1100,732
40737,1379,673,706,376,335,420,248
40740,3321,1645,1676,984,871,933,533
40741,21875,10709,11166,5564,5675,6278,4358
40743,229,112,117,70,56,64,39
40744,18334,8934,9400,5099,4682,5277,3276
40759,2531,1278,1253,764,569,769,429
40763,469,237,232,110,93,157,109
40769,18507,9034,9473,5234,4927,4858,3488
40771,1068,516,552,296,241,330,201
40801,531,259,272,132,146,144,109
40806,2499,1228,1271,622,599,773,505
40807,337,153,184,65,65,105,102
40808,99,45,54,28,26,27,18
40810,1548,796,752,411,371,463,303
40813,669,315,354,167,145,193,164
40815,1534,761,773,411,404,443,276
40816,78,41,37,21,15,32,10
40818,110,56,54,26,29,28,27
40819,729,370,359,182,170,233,144
40820,581,284,297,173,140,161,107
40823,4231,2053,2178,1100,971,1179,981
40824,559,275,284,172,150,161,76
40826,759,412,347,195,189,236,139
40827,674,328,346,163,170,210,131
40828,3965,1962,2003,998,1040,1207,720
40829,172,83,89,33,34,60,45
40830,301,152,149,72,69,96,64
40831,5150,2430,2720,1310,1184,1402,1254
40840,312,148,164,101,81,83,47
40843,259,118,141,50,65,81,63
40844,123,60,63,21,40,31,31
40845,635,345,290,143,153,208,131
40847,261,138,123,82,62,72,45
40849,352,178,174,99,82,113,58
40854,1213,578,635,302,266,342,303
40855,860,402,458,215,171,251,223
40856,756,368,388,185,179,228,164
40858,397,192,205,93,104,121,79
40862,647,315,332,167,158,212,110
40863,502,247,255,105,110,162,125
40865,410,200,210,107,102,144,57
40868,1100,532,568,289,267,348,196
40870,279,132,147,74,69,84,52
40873,2390,1171,1219,574,559,735,522
40874,504,259,245,109,110,164,121
40902,1239,614,625,343,293,380,223
40903,681,343,338,195,166,179,141
40906,11132,5393,5739,3057,2838,2952,2285
40913,171,89,82,43,31,55,42
40914,467,229,238,110,115,144,98
40915,896,453,443,240,224,260,172
40921,295,137,158,85,67,78,65
40923,735,365,370,214,178,190,153
40927,482,241,241,131,126,159,66
40935,2699,1359,1340,780,656,730,533
40939,273,140,133,60,65,96,52
40940,478,243,235,110,98,141,129
40941,251,120,131,73,56,73,49
40943,748,381,367,193,168,211,176
40946,220,113,107,53,54,64,49
40949,788,387,401,196,178,232,182
40953,998,507,491,300,266,249,183
40958,451,214,237,114,97,131,109
40962,19143,10332,8811,4625,5708,5509,3301
40964,151,76,75,38,32,47,34
40965,13570,6324,7246,3402,3234,3729,3205
40972,1327,666,661,442,259,368,258
40977,10362,5247,5115,2430,2606,3078,2248
40979,148,73,75,48,33,40,27
40982,388,185,203,141,107,100,40
40983,352,176,176,79,90,116,67
40988,555,271,284,132,138,176,109
40995,121,60,61,27,20,45,29
40997,371,187,184,101,89,103,78
41001,16412,8105,8307,4788,3829,5174,2621
41002,2510,1225,1285,703,559,713,535
41003,2786,1434,1352,840,664,840,442
41004,4122,2061,2061,1169,981,1199,773
41005,22569,11370,11199,6929,6227,6538,2875
41006,4434,2206,2228,1138,927,1430,939
41007,4193,2114,2079,1238,852,1349,754
41008,7457,3756,3701,2072,1974,1963,1448
41010,3217,1637,1580,911,719,1034,553
41011,25872,13146,12726,5884,8130,7169,4689
41014,6942,3396,3546,1796,2095,1975,1076
41015,20864,10184,10680,5471,5344,6343,3706
41016,6075,3048,3027,1591,1931,1635,918
41017,38940,19025,19915,10488,9618,11529,7305
41018,27345,13349,13996,7758,7954,7217,4416
41030,6299,3111,3188,1956,1682,1818,843
41031,15886,7697,8189,4184,3468,4751,3483
41033,1976,1018,958,575,452,616,333
41034,1032,516,516,280,238,307,207
41035,10785,5347,5438,3396,2756,2989,1644
41039,2502,1265,1237,650,542,818,492
41040,7265,3582,3683,1999,1746,2203,1317
41041,7153,3416,3737,1903,1686,1980,1584
41042,49968,24152,25816,14003,14001,13451,8513
41043,1745,870,875,460,390,586,309
41044,1116,559,557,320,264,304,228
41045,1273,661,612,372,304,403,194
41046,1414,738,676,452,318,410,234
41048,13959,6947,7012,5055,3863,3851,1190
41049,2261,1131,1130,626,564,631,440
41051,26796,13322,13474,8684,7825,7208,3079
41052,107,51,56,31,17,39,20
41055,1813,884,929,505,398,523,387
41056,14228,6835,7393,3770,3261,4149,3048
41059,2712,1355,1357,642,560,919,591
41062,35,18,17,8,10,12,5
41063,3378,1707,1671,926,762,1113,577
41064,2073,1041,1032,515,409,627,522
41071,20869,10530,10339,5072,7083,5486,3228
41073,5955,2940,3015,1398,1799,1705,1053
41074,5338,2624,2714,1483,1621,1446,788
41075,16459,7869,8590,4342,3955,4716,3446
41076,16468,7832,8636,3855,4490,4382,3741
41080,1849,983,866,501,402,616,330
41083,1326,679,647,368,305,417,236
41085,724,390,334,240,190,197,97
41086,2771,1425,1346,811,638,878,444
41091,16873,8528,8345,5648,3524,5462,2239
41092,3514,1781,1733,1015,730,1196,573
41093,2869,1450,1419,785,609,877,598
41094,13631,6757,6874,4256,3222,4164,1989
41095,3540,1745,1795,1041,842,952,705
41097,7349,3784,3565,2083,1890,2039,1337
41098,2037,1030,1007,505,462,596,474
41099,1169,493,676,601,567,1,0
41101,18758,8843,9915,4678,4610,5252,4218
41102,21712,11233,10479,4795,5130,6582,5205
41121,1852,931,921,498,423,554,377
41124,1039,524,515,275,253,272,239
41129,9922,4979,4943,2380,2238,3047,2257
41132,425,224,201,86,80,160,99
41135,172,92,80,36,35,56,45
41139,8271,3863,4408,1956,1937,2309,2069
41141,2461,1238,1223,719,593,693,456
41142,91,44,47,31,24,22,14
41143,14535,7175,7360,3821,3691,3927,3096
41144,10279,5102,5177,2652,2332,2973,2322
41146,412,222,190,110,97,117,88
41149,733,355,378,205,165,173,190
41159,583,302,281,171,145,151,116
41164,13125,6611,6514,3458,3108,3701,2858
41166,919,463,456,258,209,252,200
41168,3043,1482,1561,865,675,910,593
41169,5354,2542,2812,1259,1167,1603,1325
41171,5042,2995,2047,1060,1534,1512,936
41174,1122,560,562,282,279,285,276
41175,5591,2701,2890,1417,1199,1590,1385
41179,7852,3910,3942,2028,1812,2341,1671
41180,1087,553,534,248,243,331,265
41183,1618,777,841,411,331,480,396
41189,2264,1123,1141,564,510,689,501
41201,238,121,117,49,55,83,51
41203,696,330,366,173,151,223,149
41204,560,289,271,159,135,186,80
41214,750,393,357,259,198,191,102
41216,1297,630,667,313,308,393,283
41219,2053,1016,1037,550,482,592,429
41222,2627,1297,1330,670,606,803,548
41224,6414,3908,2506,1227,2385,1844,958
41226,168,91,77,40,37,51,40
41230,11730,5740,5990,3081,2811,3440,2398
41231,1002,491,511,280,238,278,206
41232,782,392,390,212,193,238,139
41234,601,277,324,164,147,157,133
41238,860,436,424,226,213,246,175
41240,6916,3351,3565,1523,1745,1987,1661
41250,1195,614,581,302,286,372,235
41254,571,293,278,152,117,194,108
41255,1036,526,510,246,219,360,211
41256,2433,1161,1272,633,531,774,495
41257,390,192,198,120,114,99,57
41260,885,449,436,265,317,176,127
41262,1474,747,727,403,361,429,281
41263,525,261,264,157,127,141,100
41264,389,195,194,92,88,142,67
41265,1857,924,933,471,450,572,364
41267,1245,578,667,391,318,318,218
41268,395,195,200,92,91,115,97
41271,237,116,121,41,50,86,60
41274,585,275,310,167,154,162,102
41301,6159,2993,3166,1584,1369,1833,1373
41311,7538,4156,3382,1651,2042,2387,1458
41314,5239,2603,2636,1295,1176,1581,1187
41317,190,92,98,55,41,59,35
41332,1184,607,577,287,279,323,295
41339,10957,5449,5508,2856,2667,3254,2180
41348,1219,636,583,312,294,395,218
41352,677,343,334,177,172,206,122
41360,500,255,245,166,108,147,79
41365,501,234,267,148,117,139,97
41366,20,10,10,4,6,5,5
41367,179,93,86,34,44,57,44
41385,470,241,229,120,102,139,109
41390,52,30,22,14,12,21,5
41397,64,32,32,17,18,23,6
41408,445,220,225,136,118,115,76
41421,233,114,119,70,62,62,39
41425,1138,569,569,300,280,350,208
41464,722,371,351,207,162,215,138
41465,11979,5984,5995,3189,2960,3566,2264
41472,10985,6409,4576,2358,3379,3216,2032
41501,23298,11342,11956,5591,6224,6842,4641
41503,570,255,315,113,138,156,163
41512,976,555,421,230,269,300,177
41513,590,286,304,118,127,184,161
41514,3491,1676,1815,874,828,1116,673
41517,109,48,61,26,19,40,24
41519,1108,541,567,284,286,302,236
41522,5352,2612,2740,1269,1212,1613,1258
41524,384,198,186,83,71,128,102
41526,125,66,59,30,33,39,23
41527,675,338,337,157,140,208,170
41528,999,482,517,263,263,270,203
41531,985,501,484,244,235,311,195
41534,273,133,140,82,61,79,51
41535,526,250,276,135,128,163,100
41537,5373,2618,2755,1351,1294,1573,1155
41538,97,46,51,22,21,32,22
41539,1722,852,870,473,416,556,277
41540,302,154,148,72,73,108,49
41543,543,267,276,136,123,158,126
41544,931,454,477,233,203,300,195
41547,369,188,181,94,102,107,66
41548,862,426,436,201,192,276,193
41553,2288,1121,1167,541,551,663,533
41554,1102,531,571,250,268,350,234
41555,915,452,463,243,224,258,190
41557,1716,826,890,418,433,541,324
41558,809,384,425,197,201,255,156
41559,339,167,172,91,72,114,62
41560,384,194,190,90,104,107,83
41562,2807,1399,1408,755,718,830,504
41563,445,222,223,113,100,159,73
41564,1159,572,587,299,260,372,228
41566,714,369,345,197,172,229,116
41567,369,190,179,116,93,112,48
41568,1073,554,519,285,267,330,191
41571,639,329,310,160,149,200,130
41572,3754,1806,1948,924,933,1157,740
41601,755,373,382,168,175,215,197
41602,819,396,423,183,204,249,183
41603,1498,739,759,424,343,470,261
41604,620,318,302,156,147,201,116
41605,637,304,333,141,159,192,145
41606,656,316,340,142,143,216,155
41607,318,162,156,80,78,98,62
41612,78,36,42,15,22,26,15
41615,675,345,330,182,156,207,130
41616,794,389,405,199,207,235,153
41619,599,285,314,160,143,161,135
41621,329,162,167,85,78,100,66
41622,228,107,121,46,42,87,53
41630,1230,625,605,283,300,380,267
41631,1106,550,556,317,274,322,193
41632,614,314,300,175,141,202,96
41635,3056,1513,1543,785,783,935,553
41636,984,464,520,274,209,304,197
41640,1343,677,666,371,298,435,239
41642,725,355,370,210,195,209,111
41643,194,110,84,31,40,71,52
41645,1268,614,654,366,326,352,224
41647,1815,901,914,537,427,526,325
41649,2631,1274,1357,620,625,792,594
41650,534,256,278,146,139,151,98
41653,11451,5635,5816,2725,2995,3301,2430
41655,896,438,458,244,237,248,167
41659,520,249,271,119,113,170,118
41660,802,388,414,205,226,211,160
41663,384,197,187,104,98,126,56
41666,908,463,445,218,212,292,186
41667,720,356,364,217,188,196,119
41669,865,324,541,156,286,269,154
41701,17252,8458,8794,4169,4398,5243,3442
41712,380,185,195,94,94,112,80
41713,51,26,25,11,7,21,12
41714,418,189,229,100,100,131,87
41719,1043,524,519,243,270,348,182
41721,788,415,373,220,204,228,136
41722,1688,849,839,416,414,511,347
41723,1537,780,757,460,403,435,239
41725,174,86,88,47,43,53,31
41727,640,325,315,163,169,214,94
41729,230,115,115,57,69,54,50
41731,1023,496,527,218,216,353,236
41735,295,140,155,82,89,76,48
41739,179,82,97,41,42,47,49
41740,877,451,426,241,222,261,153
41745,200,98,102,48,49,67,36
41746,835,430,405,216,204,243,172
41749,3556,1802,1754,771,902,1096,787
41751,289,144,145,67,44,121,57
41754,460,237,223,123,135,131,71
41759,397,199,198,88,91,137,81
41760,35,18,17,6,8,12,9
41762,107,53,54,22,23,33,29
41763,574,294,280,123,137,208,106
41764,741,367,374,149,190,259,143
41766,131,69,62,32,34,36,29
41772,277,132,145,55,63,84,75
41773,1273,612,661,337,301,383,252
41774,2659,1315,1344,601,595,907,556
41775,114,59,55,21,26,39,28
41776,1509,741,768,396,375,455,283
41777,947,462,485,242,213,300,192
41804,720,348,372,179,187,208,146
41810,502,252,250,115,101,156,130
41812,230,114,116,50,56,61,63
41815,802,411,391,233,193,243,133
41817,251,127,124,59,60,82,50
41819,392,200,192,80,82,131,99
41821,537,250,287,120,135,145,137
41822,2553,1232,1321,661,632,723,537
41824,1072,522,550,273,265,346,188
41825,548,263,285,132,119,152,145
41826,978,485,493,161,214,337,266
41828,808,404,404,208,187,256,157
41831,849,442,407,206,226,271,146
41832,424,221,203,108,87,143,86
41833,321,170,151,85,71,121,44
41834,659,331,328,170,175,192,122
41835,790,383,407,184,181,243,182
41836,798,374,424,201,190,240,167
41837,1284,642,642,363,310,367,244
41838,548,289,259,135,133,158,122
41839,1193,582,611,281,261,375,276
41840,1111,542,569,290,259,309,253
41843,949,487,462,225,205,314,205
41844,1355,688,667,399,439,311,206
41845,293,154,139,71,72,91,59
41847,617,301,316,158,125,204,130
41848,80,38,42,30,21,18,11
41849,193,102,91,54,48,52,39
41855,696,349,347,178,164,205,149
41858,8064,3897,4167,1927,2090,2347,1700
41859,349,181,168,67,65,126,91
41861,108,51,57,23,19,47,19
41862,952,480,472,256,225,296,175
42001,27960,13136,14824,6832,6390,7996,6742
42003,29683,14350,15333,7268,7008,8576,6831
42020,2330,1162,1168,651,548,664,467
42021,1505,733,772,390,314,444,357
42022,104,50,54,23,22,30,29
42023,2422,1186,1236,542,512,653,715
42024,1490,736,754,383,352,420,335
42025,19305,9532,9773,4462,4205,5647,4991
42027,2291,1146,1145,575,511,689,516
42028,635,316,319,152,145,197,141
42029,6321,3038,3283,1506,1318,1848,1649
42031,3418,1637,1781,815,703,953,947
42032,192,92,100,54,43,52,43
42035,1068,521,547,308,262,282,216
42036,1167,574,593,292,270,366,239
42037,29,17,12,1,2,18,8
42038,5298,3120,2178,858,1305,1732,1403
42039,1751,867,884,459,388,511,393
42040,1082,539,543,281,250,309,242
42041,4627,2158,2469,1037,952,1315,1323
42044,3404,1692,1712,643,607,1071,1083
42045,2089,1030,1059,430,394,675,590
42047,192,90,102,44,43,52,53
42048,2147,1067,1080,588,499,597,463
42049,1480,715,765,365,317,449,349
42050,3256,1740,1516,712,903,947,694
42051,2840,1451,1389,769,699,816,556
42053,4931,2472,2459,1243,1136,1553,999
42054,984,497,487,278,232,285,189
42055,2609,1256,1353,473,417,773,946
42056,1982,950,1032,502,416,546,518
42058,2336,1144,1192,597,558,692,489
42060,130,57,73,45,33,19,33
42061,55,24,31,13,12,19,11
42064,8421,4180,4241,2119,1870,2338,2094
42066,23182,11266,11916,6283,5474,6111,5314
42069,1100,567,533,285,262,340,213
42071,29655,14174,15481,6960,10277,6402,6016
42076,1213,634,579,229,213,393,378
42078,1852,905,947,384,356,506,606
42079,1426,708,718,350,334,431,311
42081,2203,1087,1116,517,441,708,537
42082,1845,866,979,438,404,533,470
42083,446,226,220,100,91,157,98
42084,83,41,42,14,16,23,30
42085,918,459,459,226,209,274,209
42086,4036,1991,2045,1023,880,1274,859
42087,2419,1250,1169,564,534,727,594
42088,2656,1305,1351,738,600,715,603
42101,55648,27598,28050,16416,19621,12426,7185
42102,88,44,44,22,29,27,10
42103,18936,9210,9726,5016,4762,5338,3820
42104,29610,14155,15455,7475,9483,7479,5173
42120,2588,1334,1254,707,604,754,523
42122,4368,2166,2202,1174,890,1518,786
42123,840,400,440,241,166,237,196
42124,55,28,27,12,14,18,11
42127,6199,3006,3193,1643,1476,1797,1283
42129,7026,3462,3564,1820,1583,2032,1591
42130,175,94,81,51,36,54,34
42133,1370,707,663,330,281,423,336
42134,16785,8195,8590,4485,4067,4822,3411
42140,1264,619,645,318,292,344,310
42141,30349,14655,15694,7902,7226,8523,6698
42151,275,142,133,63,61,79,72
42153,326,167,159,80,81,89,76
42154,691,355,336,190,169,204,128
42156,254,125,129,61,49,92,52
42157,437,215,222,138,115,107,77
42159,1195,581,614,300,276,339,280
42160,1992,971,1021,610,479,542,361
42163,56,27,29,17,16,11,12
42164,16277,7920,8357,4458,3940,4470,3409
42166,2314,1171,1143,621,514,686,493
42167,8145,4032,4113,2081,1720,2404,1940
42170,1403,701,702,347,276,465,315
42171,6841,3391,3450,1900,1732,1913,1296
42202,2389,1184,1205,608,495,713,573
42204,657,328,329,188,141,203,125
42206,5407,2674,2733,1556,1364,1499,988
42207,1207,623,584,273,249,377,308
42210,4236,2020,2216,1055,955,1144,1082
42211,13422,6577,6845,3313,2598,3859,3652
42214,682,331,351,201,146,181,154
42215,1300,655,645,389,277,368,266
42217,4117,2026,2091,1118,977,1191,831
42220,6844,3408,3436,1917,1703,1840,1384
42223,13685,8313,5372,5848,7342,456,39
42232,812,420,392,243,189,245,135
42234,2469,1185,1284,821,609,607,432
42236,929,481,448,267,214,277,171
42240,42479,20264,22215,11747,10942,11384,8406
42254,209,104,105,53,48,68,40
42256,5028,2513,2515,1274,1060,1464,1230
42259,1281,721,560,342,306,342,291
42261,10602,5290,5312,2700,2649,2978,2275
42262,8396,4209,4187,2999,4008,1106,283
42265,820,406,414,222,193,225,180
42266,2590,1286,1304,892,578,652,468
42273,443,221,222,97,102,131,113
42274,2373,1192,1181,641,578,743,411
42275,883,448,435,230,215,262,176
42276,14471,6983,7488,3842,3290,4100,3239
42280,484,225,259,157,117,129,81
42285,375,191,184,96,86,104,89
42286,1291,648,643,416,308,332,235
42301,42440,20317,22123,11341,10593,11501,9005
42303,38909,18873,20036,10440,9995,10686,7788
42320,8205,4030,4175,2303,2010,2094,1798
42321,327,165,162,85,86,98,58
42322,47,29,18,16,14,12,5
42323,793,375,418,212,199,191,191
42324,1276,630,646,327,254,376,319
42325,2028,1024,1004,527,491,603,407
42326,460,240,220,136,94,137,93
42327,4037,1969,2068,1019,903,1165,950
42328,1389,711,678,392,347,353,297
42330,9386,5061,4325,2151,2575,2686,1974
42332,271,144,127,73,61,91,46
42333,1111,578,533,351,241,326,193
42337,2026,980,1046,512,441,594,479
42338,88,54,34,24,25,27,12
42339,800,414,386,196,204,215,185
42343,1782,902,880,442,375,505,460
42344,856,417,439,231,200,263,162
42345,11747,5723,6024,2845,2800,3218,2884
42347,6152,3059,3093,1649,1434,1705,1364
42348,4810,2442,2368,1387,1085,1392,946
42349,1503,750,753,403,366,433,301
42350,1433,722,711,388,304,393,348
42351,3851,1945,1906,1069,881,1104,797
42352,2060,986,1074,534,480,566,480
42354,252,123,129,71,72,61,48
42355,1852,943,909,474,396,621,361
42356,83,0,83,0,0,2,81
42361,492,257,235,118,97,146,131
42366,5863,2982,2881,1692,1194,1878,1099
42367,667,332,335,151,140,204,172
42368,1325,686,639,362,295,382,286
42369,331,162,169,104,65,93,69
42370,28,13,15,2,4,11,11
42371,476,251,225,109,101,144,122
42372,1854,890,964,470,414,545,425
42374,277,133,144,75,58,81,63
42376,5799,2910,2889,1621,1236,1846,1096
42378,3339,1706,1633,1011,784,966,578
42404,2569,1246,1323,691,584,766,528
42406,3555,1794,1761,943,787,1133,692
42408,6737,3239,3498,1717,1429,1962,1629
42409,2586,1406,1180,553,734,836,463
42410,1460,681,779,436,355,383,286
42411,1656,838,818,361,352,496,447
42413,3118,1639,1479,810,646,1005,657
42420,38192,18224,19968,9826,9523,10974,7869
42431,26916,12926,13990,6665,6734,7557,5960
42436,1030,511,519,222,198,395,215
42437,8324,4440,3884,2418,2369,2018,1519
42440,748,369,379,188,184,218,158
42441,1594,829,765,421,414,438,321
42442,3504,1742,1762,959,836,1014,695
42445,11331,5427,5904,2841,2528,3216,2746
42450,4063,1953,2110,1032,915,1122,994
42451,783,408,375,196,159,273,155
42452,2141,1088,1053,548,474,735,384
42453,532,264,268,111,127,179,115
42455,3376,1664,1712,965,816,914,681
42456,1690,825,865,476,360,529,325
42458,1151,590,561,312,265,359,215
42459,4423,2105,2318,1150,1025,1251,997
42461,1481,731,750,419,342,420,300
42462,1319,658,661,364,303,443,209
42463,156,80,76,41,31,54,30
42464,1799,878,921,482,416,549,352
42501,17592,8235,9357,4355,4161,4909,4167
42503,22894,11224,11670,5808,5384,6637,5065
42516,463,233,230,123,91,124,125
42518,2914,1482,1432,727,628,875,684
42519,3191,1610,1581,735,648,1008,800
42528,1524,782,742,449,339,426,310
42533,802,396,406,217,227,207,151
42539,10026,4784,5242,2565,2462,2706,2293
42541,531,258,273,130,114,155,132
42544,5843,2910,2933,1264,1170,1778,1631
42553,5284,2645,2639,1445,1313,1449,1077
42565,735,368,367,195,159,203,178
42566,660,332,328,173,143,186,158
42567,6007,3022,2985,1557,1415,1718,1317
42602,10169,5086,5083,2666,2241,2877,2385
42603,130,64,66,23,22,47,38
42629,4953,2421,2532,1186,1019,1434,1314
42631,134,62,72,34,35,31,34
42633,20065,9927,10138,5102,4708,5791,4464
42634,1565,778,787,461,370,453,281
42635,5103,3398,1705,999,1846,1573,685
42638,207,94,113,54,51,61,41
42642,12573,6141,6432,3173,3004,3564,2832
42647,4086,2019,2067,1066,966,1161,893
42649,2326,1150,1176,654,557,679,436
42653,4619,2309,2310,1342,1165,1240,872
42701,48194,23462,24732,13083,12463,13946,8702
42712,1855,952,903,489,402,570,394
42713,1641,817,824,429,343,519,350
42715,347,168,179,110,59,88,90
42716,1582,786,796,416,384,462,320
42717,6558,3205,3353,1629,1318,1912,1699
42718,24312,11728,12584,6390,5994,6547,5381
42721,3982,1975,2007,1085,911,1118,868
42722,714,360,354,198,174,195,147
42724,4714,2334,2380,1257,1141,1430,886
42726,4667,2400,2267,1207,978,1402,1080
42728,15925,7879,8046,4290,3974,4265,3396
42729,1617,810,807,516,315,427,359
42731,341,181,160,92,68,88,93
42732,2120,1093,1027,596,487,615,422
42733,1454,742,712,387,325,417,325
42740,1973,990,983,547,464,587,375
42741,480,216,264,121,93,157,109
42743,8869,4311,4558,2182,1941,2550,2196
42746,1892,951,941,510,425,580,377
42748,8706,4293,4413,2239,2054,2444,1969
42749,5245,2511,2734,1428,1147,1479,1191
42753,743,385,358,182,176,222,163
42754,15349,7769,7580,4031,3961,4189,3168
42757,2974,1483,1491,797,644,910,623
42758,139,69,70,40,40,36,23
42762,422,204,218,114,94,126,88
42764,559,275,284,152,143,164,100
42765,5840,2914,2926,1633,1351,1641,1215
42776,2736,1377,1359,798,665,751,522
42782,953,500,453,226,220,298,209
42784,2685,1355,1330,747,655,775,508
42788,310,156,154,67,62,113,68
70001,37996,18409,19587,7865,11808,10207,8116
70002,18879,9387,9492,3880,5553,4939,4507
70003,40150,19439,20711,9342,9777,11850,9181
70005,24339,11784,12555,4730,5991,7236,6382
70006,15703,7710,7993,3443,4345,4003,3912
70030,4585,2296,2289,1329,1056,1378,822
70031,1316,654,662,331,328,416,241
70032,3635,1852,1783,922,1099,1052,562
70036,1227,621,606,260,232,436,299
70037,15590,7740,7850,4871,4025,4408,2286
70038,426,229,197,128,104,123,71
70039,2460,1146,1314,859,626,671,304
70040,1604,799,805,401,330,518,355
70041,2381,1256,1125,649,567,789,376
70043,16760,8599,8161,4702,5619,4263,2176
70047,13006,6431,6575,3874,2969,4293,1870
70049,2481,1131,1350,660,567,711,543
70050,74,41,33,21,14,23,16
70051,2518,1206,1312,701,647,742,428
70052,3795,1789,2006,1135,904,1038,718
70053,16499,8566,7933,3880,5099,4704,2816
70056,39082,18783,20299,11250,11417,10423,5992
70057,4719,2528,2191,1265,1378,1375,701
70058,39887,19237,20650,11973,10972,11612,5330
70062,17095,8253,8842,4752,4701,4555,3087
70065,51116,25048,26068,12695,14039,14653,9729
70067,2757,1394,1363,750,645,855,507
70068,34101,16604,17497,10437,9058,10050,4556
70070,12471,6066,6405,3654,3002,3897,1918
70071,3653,1762,1891,978,799,1034,842
70072,56344,26832,29512,15875,14701,16157,9611
70075,4417,2247,2170,1375,1350,1206,486
70076,292,137,155,97,72,69,54
70079,3067,1495,1572,861,756,885,565
70080,1556,785,771,436,423,459,238
70082,336,160,176,102,75,104,55
70083,2353,1168,1185,655,570,689,439
70084,7552,3789,3763,2142,1833,2059,1518
70085,4427,2254,2173,1158,1038,1412,819
70086,1969,980,989,586,467,578,338
70087,8122,3946,4176,2495,2179,2400,1048
70090,7671,3758,3913,2096,1838,2259,1478
70091,278,165,113,64,82,80,52
70092,6651,3207,3444,2068,1811,1907,865
70094,31669,15305,16364,9222,7995,8916,5536
70112,3655,1840,1815,647,1635,972,401
70113,7025,3484,3541,1698,1867,2132,1328
70114,22870,10603,12267,6706,6188,6168,3808
70115,31695,15355,16340,5480,11942,8498,5775
70116,11507,6254,5253,1790,3435,3781,2501
70117,23389,11568,11821,5686,6725,6770,4208
70118,33008,15639,17369,7936,12293,7447,5332
70119,36228,19137,17091,7796,13331,10168,4933
70121,12029,5846,6183,2237,3153,3894,2745
70122,28564,13044,15520,7352,7859,7952,5401
70123,26475,12696,13779,5412,6796,8117,6150
70124,16824,8285,8539,3684,5433,4902,2805
70125,14479,6706,7773,3885,4941,3547,2106
70126,23958,11014,12944,7348,6677,6084,3849
70127,20471,9359,11112,6691,5787,5371,2622
70128,17113,7948,9165,5205,4756,4848,2304
70129,9064,4607,4457,2629,2647,2470,1318
70130,14064,7275,6789,1764,6359,3599,2342
70131,29915,14130,15785,8220,8345,8305,5045
70139,0,0,0,0,0,0,0
70163,0,0,0,0,0,0,0
70301,43037,20663,22374,11983,11954,11652,7448
70339,6033,2998,3035,1543,1340,1879,1271
70340,109,49,60,42,34,24,9
70341,4449,2145,2304,1259,1034,1297,859
70342,4979,2439,2540,1551,1258,1399,771
70343,5504,2780,2724,1651,1386,1578,889
70344,6143,3064,3079,1733,1486,1760,1164
70345,9754,4846,4908,2686,2403,2882,1783
70346,10925,5277,5648,3313,2857,2800,1955
70352,205,89,116,47,51,57,50
70353,1402,712,690,422,342,357,281
70354,4931,2468,2463,1368,1258,1375,930
70355,1041,522,519,281,278,314,168
70356,2484,1214,1270,675,591,749,469
70357,3043,1556,1487,823,765,883,572
70358,1296,693,603,261,247,452,336
70359,8408,4070,4338,2756,2477,2204,971
70360,26429,12977,13452,7305,6800,7881,4443
70363,26513,13577,12936,7965,7537,6998,4013
70364,30503,14958,15545,8812,8796,7977,4918
70372,2518,1241,1277,640,629,753,496
70373,7141,3592,3549,1948,1817,2062,1314
70374,7125,3547,3578,1939,1869,2027,1290
70375,125,66,59,36,37,30,22
70377,4403,2235,2168,1326,1075,1245,757
70380,22928,11566,11362,6180,5955,6530,4263
70390,6969,3375,3594,1925,1701,1942,1401
70391,202,99,103,48,41,54,59
70392,8456,4184,4272,2495,2207,2376,1378
70393,774,379,395,239,197,227,111
70394,14328,7092,7236,3891,3624,4128,2685
70395,4658,2313,2345,1286,1165,1430,777
70397,1365,702,663,371,322,412,260
70401,20415,9814,10601,5701,7282,4523,2909
70402,1514,563,951,1055,458,1,0
70403,26011,12436,13575,7342,7369,6705,4595
70420,7345,3535,3810,2033,1607,2348,1357
70422,13797,7045,6752,3842,3511,3823,2621
70426,6342,3654,2688,1520,1716,2010,1096
70427,20033,9511,10522,5548,4613,5412,4460
70431,5366,2689,2677,1323,1077,1736,1230
70433,31133,14939,16194,8701,7360,8856,6216
70435,16603,8140,8463,4412,3807,4871,3513
70436,629,310,319,216,159,160,94
70437,7918,3851,4067,1982,1559,2477,1900
70438,18540,9115,9425,5302,4423,5112,3703
70441,5112,2481,2631,1414,1147,1441,1110
70442,277,142,135,80,65,77,55
70443,10232,4958,5274,3135,2602,2759,1736
70444,10160,4941,5219,2981,2334,2845,2000
70445,10840,5350,5490,2716,2387,3334,2403
70446,5877,2919,2958,1760,1502,1644,971
70447,10150,4980,5170,3205,2429,3046,1470
70448,24851,11974,12877,7716,5439,7815,3881
70449,3611,1838,1773,846,786,1237,742
70450,2884,1406,1478,839,599,801,645
70451,182,98,84,59,69,30,24
70452,13163,6489,6674,3491,2999,4036,2637
70453,1045,528,517,334,236,290,185
70454,24954,11962,12992,7074,6508,6979,4393
70455,1474,747,727,431,345,433,265
70456,2850,1369,1481,839,717,789,505
70458,35077,17149,17928,9081,8597,10154,7245
70460,22096,10945,11151,6313,5855,6316,3612
70461,27818,13679,14139,8389,6724,8484,4221
70462,5699,2833,2866,1452,1334,1774,1139
70463,126,64,62,31,28,46,21
70464,312,154,158,76,73,84,79
70465,776,362,414,298,213,179,86
70466,8512,4357,4155,2440,2586,2233,1253
70471,21383,10263,11120,6193,3922,7109,4159
70501,31358,15296,16062,8942,9177,8171,5068
70503,27816,13593,14223,7405,8086,7371,4954
70506,41163,19996,21167,9969,15195,9729,6270
70507,16558,7902,8656,5000,4774,4308,2476
70508,34810,16927,17883,9120,10540,9791,5359
70510,25313,12160,13153,7549,6208,6779,4777
70512,9780,4840,4940,2840,2342,2848,1750
70513,124,62,62,26,35,35,28
70514,2545,1241,1304,747,595,718,485
70515,3838,2148,1690,1024,1209,1018,587
70516,1546,802,744,543,383,390,230
70517,26500,13122,13378,7913,6906,7522,4159
70518,12297,6122,6175,3546,3629,3576,1546
70519,222,101,121,48,67,50,57
70520,18405,9056,9349,5604,5013,5192,2596
70523,906,426,480,274,235,251,146
70524,314,154,160,97,64,93,60
70525,13150,6435,6715,4051,3235,3615,2249
70526,19206,9300,9906,5721,4662,5196,3627
70528,2333,1137,1196,669,594,628,442
70529,11752,5818,5934,3717,3498,3091,1446
70531,1261,641,620,366,302,378,215
70532,2685,1303,1382,815,606,716,548
70533,7385,3614,3771,2214,1872,2078,1221
70534,899,457,442,277,243,238,141
70535,18215,8611,9604,5419,4467,4726,3603
70537,541,264,277,158,127,141,115
70538,14844,7196,7648,4157,3426,4311,2950
70541,432,206,226,125,91,112,104
70542,3435,1666,1769,876,751,1053,755
70543,4077,2009,2068,1304,1070,1098,605
70544,11677,5564,6113,3497,2684,3378,2118
70546,16425,8006,8419,4880,3926,4300,3319
70548,10353,5019,5334,2852,2532,2897,2072
70549,3948,1926,2022,1113,869,1140,826
70550,174,90,84,49,37,48,40
70552,1819,903,916,559,460,483,317
70554,5582,2675,2907,1699,1274,1558,1051
70555,7372,3695,3677,2235,2034,2091,1012
70556,331,153,178,115,87,63,66
70558,134,67,67,25,27,40,42
70559,2943,1485,1458,886,707,856,494
70560,42022,20597,21425,12752,10940,11355,6975
70563,18502,9069,9433,5336,4275,5449,3442
70570,38987,18411,20576,12005,9133,10390,7459
70575,55,27,28,13,11,12,19
70576,1526,1041,485,350,686,264,226
70577,4645,2303,2342,1380,1179,1301,785
70578,16122,7835,8287,4761,3990,4448,2923
70580,179,83,96,56,41,48,34
70581,929,471,458,291,201,293,144
70582,19781,9602,10179,5750,4951,5578,3502
70583,11693,5715,5978,3386,3225,3373,1709
70584,7358,3541,3817,2124,1780,2256,1198
70585,235,122,113,63,59,71,42
70586,20313,9904,10409,6318,4590,5525,3880
70589,3283,1608,1675,961,693,931,698
70591,5299,2586,2713,1589,1287,1407,1016
70592,18878,9338,9540,6015,5756,5077,2030
70601,32384,15363,17021,8918,8413,8774,6279
70605,32741,15836,16905,8534,8528,9063,6616
70607,25560,12354,13206,7540,8095,6166,3759
70611,19256,9453,9803,5936,4781,5602,2937
70615,14335,7610,6725,3974,4246,3946,2169
70630,1440,692,748,417,333,424,266
70631,962,481,481,247,207,355,153
70632,371,187,184,76,68,143,84
70633,7604,3702,3902,2199,1822,1994,1589
70634,25125,12296,12829,7323,6290,6732,4780
70637,654,340,314,211,146,193,104
70638,937,451,486,311,236,236,154
70639,684,348,336,209,161,180,134
70640,301,152,149,92,72,86,51
70643,352,181,171,91,67,118,76
70644,308,157,151,99,59,93,57
70645,1262,658,604,299,274,394,295
70646,750,386,364,187,184,228,151
70647,8703,4300,4403,2685,2177,2473,1368
70648,8026,4660,3366,1954,2391,2309,1372
70650,435,210,225,143,104,109,79
70651,500,249,251,188,136,120,56
70652,2203,1114,1089,724,496,604,379
70653,3111,1554,1557,818,694,896,703
70654,155,80,75,44,36,51,24
70655,3002,1474,1528,814,660,839,689
70656,4023,1999,2024,1197,942,1051,833
70657,4315,2197,2118,1369,1055,1189,702
70658,955,486,469,290,236,269,160
70659,1482,720,762,430,440,356,256
70660,2612,1776,836,562,1168,591,291
70661,2309,1143,1166,588,501,681,539
70662,411,219,192,116,89,117,89
70663,28150,13625,14525,7961,7281,7672,5236
70665,10743,5315,5428,3370,2675,2989,1709
70668,6424,3141,3283,1761,1491,1898,1274
70669,10131,4944,5187,2849,2600,2751,1931
70706,20752,10244,10508,6860,5771,5582,2539
70710,3593,1753,1840,1104,1108,957,424
70711,5266,2641,2625,1513,1366,1526,861
70712,479,241,238,176,150,125,28
70714,19803,9406,10397,5944,5004,5404,3451
70715,1433,702,731,446,319,371,297
70719,4460,2147,2313,1321,1110,1257,772
70721,701,364,337,314,178,133,76
70722,5713,2802,2911,1450,1288,1763,1212
70723,1759,910,849,456,436,542,325
70725,1826,867,959,601,495,484,246
70726,50583,24758,25825,15614,14590,12953,7426
70729,1032,509,523,302,250,306,174
70730,3499,1664,1835,895,789,1100,715
70732,1178,565,613,306,257,371,244
70733,1621,805,816,424,376,519,302
70734,7554,3731,3823,2718,2180,2037,619
70736,518,267,251,138,133,148,99
70737,38643,19018,19625,11381,10944,10667,5651
70739,12486,6155,6331,3412,2988,3657,2429
70740,1305,647,658,303,304,441,257
70743,350,193,157,106,79,99,66
70744,6181,3078,3103,1836,1633,1673,1039
70747,180,85,95,48,39,52,41
70748,6657,4289,2368,1174,2015,2284,1184
70749,1554,755,799,337,328,483,406
70750,1951,976,975,600,440,529,382
70752,806,409,397,180,184,255,187
70753,870,423,447,209,188,303,170
70754,10170,5189,4981,2888,2949,2847,1486
70755,2186,1065,1121,633,539,647,367
70756,393,186,207,111,83,108,91
70757,3177,1554,1623,877,752,927,621
70759,1528,775,753,383,324,460,361
70760,6993,3241,3752,1918,1463,1940,1672
70761,897,436,461,220,190,280,207
70762,926,467,459,206,161,316,243
70763,3816,1870,1946,1212,941,1183,480
70764,17584,8557,9027,5030,4272,4968,3314
70767,14914,7397,7517,3986,4004,4458,2466
70769,36084,17979,18105,11883,9612,10421,4168
70770,2923,1425,1498,660,650,1020,593
70772,784,386,398,182,191,243,168
70773,143,76,67,33,30,43,37
70774,10076,5047,5029,2989,2526,3020,1541
70775,14720,9804,4916,2703,4027,5560,2430
70776,6043,3717,2326,659,2538,2238,608
70777,4269,2094,2175,1206,1012,1287,764
70778,2291,1133,1158,686,668,600,337
70780,1015,510,505,278,232,303,202
70782,299,137,162,79,64,99,57
70783,2604,1306,1298,643,536,793,632
70785,20979,10423,10556,6405,5867,5710,2997
70787,127,69,58,27,13,53,34
70788,4051,1915,2136,1214,954,1124,759
70789,750,355,395,204,166,205,175
70791,24918,12038,12880,7498,6330,7128,3962
70801,13,8,5,0,9,3,1
70802,27267,13550,13717,7223,9614,6340,4090
70803,1335,719,616,644,677,8,6
70805,29909,13837,16072,10377,8172,7624,3736
70806,28706,13222,15484,7101,9430,7071,5104
70807,20377,10178,10199,6489,6610,4247,3031
70808,32504,15898,16606,7500,11685,7220,6099
70809,25050,11680,13370,5182,8537,6354,4977
70810,37980,18467,19513,9702,12055,10260,5963
70811,13676,6231,7445,4158,3498,3616,2404
70812,11206,5170,6036,3767,2920,2965,1554
70814,14514,6957,7557,4400,3943,4150,2021
70815,30075,14292,15783,8527,8347,7381,5820
70816,43194,20473,22721,11122,15215,10324,6533
70817,31192,15126,16066,8223,8208,9586,5175
70818,9649,4677,4972,2547,2279,2875,1948
70819,5040,2435,2605,1527,1526,1205,782
70820,17222,8992,8230,4076,10380,2122,644
70836,0,0,0,0,0,0,0
71001,4531,2122,2409,1230,1033,1160,1108
71003,989,485,504,232,220,280,257
71004,644,338,306,159,129,215,141
71006,12158,6010,6148,3295,2690,3689,2484
71007,1141,577,564,261,231,394,255
71008,739,385,354,143,147,253,196
71016,2070,1027,1043,616,497,545,412
71018,1622,785,837,416,357,442,407
71019,8555,4096,4459,2426,2022,2325,1782
71021,772,354,418,199,149,242,182
71023,3632,1791,1841,828,773,1164,867
71024,1420,706,714,413,322,396,289
71027,1585,756,829,390,346,503,346
71028,1666,784,882,428,354,468,416
71029,219,108,111,47,41,75,56
71030,1537,736,801,449,381,439,268
71031,1064,536,528,290,225,279,270
71032,2164,1088,1076,545,463,667,489
71033,3510,1719,1791,810,778,1157,765
71034,313,165,148,90,70,70,83
71037,19325,9521,9804,5471,4981,5541,3332
71038,4064,1909,2155,1072,811,1107,1074
71039,1934,943,991,495,450,560,429
71040,10268,6293,3975,1964,3233,3030,2041
71043,546,289,257,121,99,195,131
71044,657,333,324,141,140,167,209
71045,663,327,336,169,155,186,153
71046,1351,696,655,310,264,423,354
71047,12203,6390,5813,2996,3113,3705,2389
71048,104,51,53,20,14,35,35
71049,3460,1663,1797,1021,823,878,738
71051,2409,1187,1222,592,452,813,552
71052,10259,4754,5505,2913,2365,2849,2132
71055,20268,9866,10402,5242,4997,5553,4476
71060,3089,1528,1561,841,686,938,624
71061,1712,845,867,473,398,456,385
71063,748,357,391,206,159,221,162
71064,4096,2109,1987,943,883,1263,1007
71065,1232,597,635,369,295,327,241
71067,3297,1591,1706,1020,894,855,528
71068,3627,1737,1890,918,716,1003,990
71069,812,397,415,221,180,226,185
71070,1833,931,902,442,404,500,487
71071,2685,1339,1346,754,627,692,612
71072,1530,755,775,418,324,430,358
71073,2319,1154,1165,650,548,641,480
71075,6416,3060,3356,1616,1484,1671,1645
71078,5546,2810,2736,1491,1306,1699,1050
71079,272,130,142,87,46,90,49
71082,5119,2454,2665,1455,1211,1320,1133
71101,8197,4185,4012,1998,2137,2487,1575
71103,7813,3623,4190,2226,1790,1957,1840
71104,14802,7223,7579,3730,5287,3610,2175
71105,21907,10458,11449,4678,7422,5266,4541
71106,34814,16425,18389,10055,8083,9700,6976
71107,33800,16525,17275,10042,9080,8961,5717
71108,20388,9176,11212,7145,5599,5108,2536
71109,22154,10207,11947,6720,5592,5532,4310
71110,2793,1634,1159,1085,1447,228,33
71111,38456,18443,20013,11290,11238,9734,6194
71112,31358,15485,15873,8660,9565,7685,5448
71115,14506,6660,7846,3301,4440,3411,3354
71118,24761,11349,13412,6652,6959,5978,5172
71119,11562,5485,6077,2977,2789,3402,2394
71129,13391,6255,7136,3643,3941,3743,2064
71201,20319,9400,10919,5026,5323,5423,4547
71202,29044,14466,14578,10169,7959,7097,3819
71203,37105,17276,19829,11238,11396,8569,5902
71209,154,54,100,114,40,0,0
71219,1288,637,651,355,296,377,260
71220,23266,10942,12324,6658,5556,6318,4734
71222,3481,1687,1794,1018,783,881,799
71223,523,260,263,147,99,152,125
71225,7068,3449,3619,2173,1776,1981,1138
71226,1638,809,829,384,314,481,459
71227,3635,1795,1840,999,904,1071,661
71229,1662,934,728,341,518,482,321
71232,6581,3147,3434,1927,1478,1834,1342
71233,305,154,151,90,90,65,60
71234,3992,1968,2024,928,899,1298,867
71235,4280,2114,2166,1078,977,1244,981
71237,1578,930,648,326,539,437,276
71238,2807,1389,1418,725,662,872,548
71241,9982,5017,4965,2603,2413,2729,2237
71243,194,103,91,52,34,64,44
71245,4718,2007,2711,1610,2048,544,516
71247,1175,570,605,294,291,292,298
71250,220,111,109,40,31,78,71
71251,9051,4728,4323,2257,2416,2355,2023
71253,255,134,121,67,62,64,62
71254,6759,3639,3120,1967,1992,1697,1103
71256,688,337,351,199,153,195,141
71259,1697,815,882,517,377,442,361
71260,3177,1532,1645,793,703,911,770
71261,1684,808,876,379,297,507,501
71263,8275,4010,4265,2327,1797,2189,1962
71264,1045,514,531,254,232,279,280
71266,1699,839,860,512,351,441,395
71268,2819,1371,1448,749,660,747,663
71269,12757,6216,6541,3486,3294,3504,2473
71270,30887,15173,15714,7995,11411,6481,5000
71272,1893,1058,835,1044,848,1,0
71275,2453,1239,1214,639,631,714,469
71276,289,157,132,89,57,84,59
71277,1758,861,897,428,374,514,442
71279,45,15,30,13,12,11,9
71280,3647,1774,1873,1034,895,1016,702
71282,11070,5466,5604,3051,3262,2948,1809
71286,615,311,304,143,119,198,155
71291,32644,15364,17280,8913,8776,8615,6340
71292,21541,10674,10867,6312,5463,5917,3849
71295,14343,6999,7344,4175,3474,3717,2977
71301,22859,10726,12133,6870,5730,6209,4050
71302,15049,6939,8110,4706,3353,3968,3022
71303,21015,10053,10962,5847,5619,5447,4102
71316,37,23,14,4,5,13,15
71322,6969,3496,3473,1898,1697,1868,1506
71323,989,467,522,269,240,248,232
71325,1321,649,672,353,313,373,282
71326,1164,551,613,355,257,310,242
71327,5454,3304,2150,1205,1853,1621,775
71328,7414,3659,3755,2194,1787,2122,1311
71331,1036,522,514,310,260,260,206
71333,666,320,346,151,111,211,193
71334,9839,5145,4694,2556,2672,2628,1983
71336,1650,783,867,406,334,469,441
71339,130,65,65,41,31,38,20
71340,1710,1237,473,276,772,460,202
71341,3069,1524,1545,823,751,846,649
71342,7533,3744,3789,1976,1936,1978,1643
71343,7678,3785,3893,2079,1720,2157,1722
71345,69,23,46,22,17,14,16
71346,3040,1487,1553,914,661,828,637
71350,4124,1997,2127,1114,886,1177,947
71351,11502,5668,5834,3220,2917,3120,2245
71353,1664,798,866,448,314,512,390
71354,1699,831,868,490,350,515,344
71355,2764,1286,1478,768,623,772,601
71356,648,319,329,179,130,171,168
71357,2149,1010,1139,608,444,584,513
71358,1111,546,565,317,231,327,236
71360,35361,17302,18059,9878,9454,9443,6586
71362,2169,1076,1093,620,500,586,463
71366,1974,940,1034,537,391,578,468
71367,1278,631,647,386,297,351,244
71368,1459,699,760,400,295,445,319
71369,3222,1400,1822,960,800,892,570
71371,2151,1059,1092,610,534,588,419
71373,7358,3556,3802,2171,1783,2002,1402
71375,1129,543,586,298,219,320,292
71377,112,59,53,33,22,35,22
71378,2536,1178,1358,680,493,735,628
71401,117,58,59,41,23,32,21
71403,4584,2275,2309,1345,1013,1291,935
71404,797,402,395,213,174,254,156
71405,5592,2684,2908,1547,1503,1466,1076
71406,216,111,105,67,45,63,41
71407,933,476,457,285,221,260,167
71409,6874,3433,3441,1694,1536,2194,1450
71410,124,53,71,36,25,32,31
71411,2875,1392,1483,831,696,809,539
71414,238,110,128,74,49,65,50
71416,842,393,449,233,172,244,193
71417,4932,2444,2488,1398,1107,1384,1043
71418,6295,3046,3249,1654,1336,1781,1524
71419,2444,1230,1214,659,543,643,599
71422,1542,795,747,369,366,471,336
71423,4538,2283,2255,1335,1092,1265,846
71424,1225,646,579,364,267,362,232
71425,214,110,104,48,42,63,61
71426,229,109,120,54,51,75,49
71427,413,201,212,113,87,127,86
71429,3179,1568,1611,891,679,887,722
71430,2576,1338,1238,786,709,633,448
71432,1053,510,543,299,257,281,216
71433,4367,2128,2239,1230,1046,1185,906
71435,3979,2190,1789,1001,1134,1119,725
71438,1626,807,819,475,409,432,310
71439,1897,930,967,531,417,555,394
71441,618,316,302,177,144,192,105
71446,22762,11417,11345,6180,6755,5926,3901
71447,1469,723,746,355,313,457,344
71449,9696,4760,4936,2442,2166,2539,2549
71450,1070,536,534,298,228,282,262
71452,57,25,32,10,12,14,21
71454,2527,1258,1269,658,536,742,591
71455,227,120,107,48,45,59,75
71456,1223,620,603,315,226,360,322
71457,27809,13078,14731,8410,8380,6211,4808
71459,11902,6719,5183,4648,6572,664,18
71461,2577,1243,1334,763,808,695,311
71462,1432,753,679,405,328,409,290
71463,10801,6406,4395,2365,3452,3015,1969
71465,3139,1528,1611,899,749,825,666
71466,591,291,300,171,155,167,98
71467,7998,5345,2653,1563,3277,2146,1012
71468,868,421,447,241,207,228,192
71469,2792,1366,1426,781,668,742,601
71472,287,149,138,74,54,100,59
71473,495,247,248,126,107,136,126
71474,663,330,333,182,152,201,128
71479,738,373,365,196,154,215,173
71480,1324,966,358,222,544,387,171
71483,11294,6005,5289,2813,3031,3250,2200
71485,1804,877,927,455,358,615,376
71486,4940,2443,2497,1456,1035,1314,1135
71749,480,236,244,130,85,124,141
3579,103,56,47,13,10,34,46
3901,7246,3580,3666,1986,1739,2326,1195
3902,2211,1108,1103,450,337,816,608
3903,6211,3031,3180,1476,1147,2226,1362
3904,7703,3727,3976,1615,2178,2167,1743
3905,1780,849,931,285,252,666,577
3906,4647,2283,2364,1178,977,1537,955
3907,894,448,446,76,87,262,469
3908,7233,3569,3664,2088,1476,2549,1120
3909,9738,4620,5118,2202,1343,3269,2924
3910,328,159,169,45,53,97,133
3911,250,116,134,28,25,58,139
4001,2429,1238,1191,556,463,846,564
4002,7351,3712,3639,1625,1595,2460,1671
4003,330,163,167,47,43,114,126
4005,23146,11080,12066,5642,6371,6452,4681
4006,96,42,54,4,39,15,38
4008,2723,1367,1356,634,540,1011,538
4009,5151,2516,2635,1162,954,1626,1409
4010,1597,804,793,374,317,571,335
4011,20278,9553,10725,4927,4877,5511,4963
4015,3808,1885,1923,918,848,1234,808
4017,341,165,176,55,40,91,155
4019,71,37,34,15,13,17,26
4020,1403,711,692,314,285,469,335
4021,5820,2822,2998,1766,817,2262,975
4022,1148,597,551,264,196,400,288
4024,608,290,318,152,131,194,131
4027,6031,3047,2984,1672,1411,1981,967
4029,1725,883,842,378,374,571,402
4030,2208,1140,1068,551,490,764,403
4032,7879,3731,4148,1942,1404,2729,1804
4037,3834,1870,1964,1031,671,1250,882
4038,16381,7919,8462,4786,3916,4843,2836
4039,7422,3691,3731,1756,1932,2454,1280
4040,3111,1582,1529,717,574,1066,754
4041,1613,827,786,439,340,515,319
4042,4281,2159,2122,1026,1048,1452,755
4043,10810,5027,5783,2443,1619,3535,3213
4046,7496,3629,3867,1651,1322,2556,1967
4047,1892,951,941,470,416,585,421
4048,2946,1478,1468,792,705,940,509
4049,3659,1829,1830,986,916,1198,559
4050,230,114,116,53,26,76,75
4051,1153,563,590,268,159,381,345
4055,3793,1941,1852,932,800,1269,792
4056,257,123,134,70,55,78,54
4057,56,46,10,33,4,10,9
4061,3369,1690,1679,1112,1029,911,317
4062,17020,8540,8480,4201,4322,5516,2981
4063,412,165,247,22,58,86,246
4064,8212,3963,4249,1338,1921,2842,2111
4066,539,263,276,60,70,177,232
4068,1505,762,743,344,305,520,336
4069,1465,705,760,342,272,522,329
4071,4801,2345,2456,1131,925,1724,1021
4072,18482,8926,9556,4443,4268,5984,3787
4073,16189,7804,8385,4121,3967,4768,3333
4074,18760,9086,9674,4794,3227,6340,4399
4076,2683,1351,1332,614,584,959,526
4079,3871,1870,2001,666,600,1262,1343
4083,4525,2109,2416,1079,1056,1411,979
4084,8088,3965,4123,2141,1976,2568,1403
4085,1786,893,893,527,458,563,238
4086,8787,4170,4617,1955,1805,2806,2221
4087,2116,1077,1039,651,460,688,317
4088,1516,753,763,341,290,490,395
4090,9589,4630,4959,1942,1641,3182,2824
4091,911,454,457,230,200,288,193
4092,17515,8354,9161,4037,4879,4965,3634
4093,8034,4050,3984,1982,1872,2705,1475
4095,1274,655,619,287,261,463,263
4096,8349,3931,4418,2042,1409,2881,2017
4097,3574,1732,1842,1038,597,1373,566
4101,17227,8955,8272,2711,7761,4335,2420
4102,17335,8581,8754,3212,6316,4851,2956
4103,30606,14272,16334,6744,9154,8732,5976
4105,11158,5342,5816,3087,1541,3971,2559
4106,25175,11992,13183,5865,6880,7465,4965
4107,8980,4336,4644,2392,1151,3266,2171
4108,862,413,449,157,118,316,271
4109,93,48,45,6,4,36,47
4110,1391,626,765,321,112,413,545
4210,23045,11130,11915,5695,5863,6658,4829
4216,640,321,319,118,102,206,214
4217,3312,1638,1674,789,657,1100,766
4219,1472,741,731,308,319,479,366
4220,3077,1556,1521,764,686,1056,571
4221,1098,537,561,220,222,355,301
4222,3848,1948,1900,926,901,1424,597
4224,3040,1498,1542,798,618,947,677
4226,190,100,90,29,33,70,58
4227,79,33,46,20,17,32,10
4228,6,3,3,0,2,0,4
4231,236,123,113,42,43,86,65
4234,168,85,83,58,36,49,25
4236,4350,2209,2141,1072,924,1527,827
4237,238,123,115,36,45,76,81
4238,1416,745,671,522,296,427,171
4239,4851,2380,2471,1188,1004,1517,1142
4240,36592,17590,19002,9494,9922,9429,7747
4250,4228,2083,2145,1063,1052,1286,827
4252,4799,2342,2457,1271,1197,1463,868
4253,2095,1062,1033,466,447,696,486
4254,3181,1564,1617,911,758,874,638
4255,802,401,401,178,138,302,184
4256,3064,1500,1564,807,738,937,582
4257,2681,1323,1358,600,606,843,632
4258,2617,1314,1303,658,543,950,466
4259,3264,1591,1673,833,686,1145,600
4260,5542,2823,2719,1474,1345,1930,793
4261,444,236,208,67,73,174,130
4263,2326,1193,1133,592,527,785,422
4265,918,447,471,238,206,315,159
4267,37,16,21,5,6,11,15
4268,5023,2435,2588,1167,1056,1422,1378
4270,5880,2970,2910,1397,1295,1982,1206
4271,67,30,37,9,11,17,30
4274,5343,2675,2668,1293,1073,1941,1036
4275,514,276,238,88,60,217,149
4276,5841,2828,3013,1356,1140,1800,1545
4280,6474,3243,3231,1586,1538,2111,1239
4281,5116,2487,2629,1171,1116,1466,1363
4282,5734,2860,2874,1530,1237,1914,1053
4284,1138,571,567,244,173,417,304
4285,433,223,210,58,52,176,147
4286,47,24,23,13,14,14,6
4287,3224,1636,1588,863,746,1115,500
4289,1815,897,918,459,411,508,437
4290,1541,763,778,341,285,587,328
4292,948,482,466,218,201,321,208
4294,3995,1971,2024,991,852,1212,940
4330,26086,12835,13251,5615,6373,7985,6113
4342,1672,858,814,385,327,609,351
4343,25,13,12,2,1,9,13
4344,2951,1407,1544,734,670,822,725
4345,11646,5745,5901,2748,2723,3747,2428
4346,1772,825,947,384,385,549,454
4347,2355,1089,1266,375,461,712,807
4348,2976,1494,1482,687,597,933,759
4349,1158,568,590,225,199,451,283
4350,3577,1760,1817,866,776,1240,695
4351,2571,1226,1345,639,426,914,592
4352,1632,808,824,362,321,594,355
4353,2300,1157,1143,548,460,780,512
4354,1535,763,772,382,302,490,361
4355,2600,1292,1308,664,508,910,518
4357,3399,1665,1734,817,765,1127,690
4358,4276,2131,2145,1112,911,1459,794
4359,388,192,196,86,86,145,71
4360,560,278,282,102,101,200,157
4363,2575,1274,1301,634,584,839,518
4364,6025,2918,3107,1352,1159,2040,1474
4401,44899,21732,23167,10372,13168,12602,8757
4406,819,403,416,145,130,304,240
4408,176,94,82,43,35,57,41
4410,1290,664,626,356,282,430,222
4411,1492,729,763,353,394,446,299
4412,9482,4470,5012,2130,2475,2712,2165
4413,196,97,99,48,36,52,60
4414,1248,665,583,290,215,421,322
4415,276,139,137,68,61,73,74
4416,5468,2651,2817,1234,1215,1791,1228
4417,370,187,183,73,65,120,112
4418,1771,890,881,456,417,600,298
4419,2794,1404,1390,710,670,879,535
4421,1366,909,457,369,526,178,293
4422,1409,792,617,396,330,466,217
4424,823,424,399,163,136,266,258
4426,4720,2291,2429,1127,838,1409,1346
4427,2858,1393,1465,781,632,875,570
4428,3146,1586,1560,728,685,1107,626
4429,4717,2359,2358,1022,893,1774,1028
4430,1728,849,879,376,286,547,519
4431,81,38,43,11,7,36,27
4434,1246,632,614,327,315,385,219
4435,1092,531,561,259,216,396,221
4438,1124,560,564,263,275,354,232
4441,1840,898,942,301,267,613,659
4442,93,50,43,10,19,31,33
4443,2537,1254,1283,555,483,825,674
4444,8824,4393,4431,2316,1972,2864,1672
4448,1431,694,737,307,275,444,405
4449,1489,750,739,362,383,506,238
4450,1368,690,678,334,360,443,231
4451,259,131,128,46,34,101,78
4453,779,399,380,185,172,267,155
4454,69,32,37,8,6,25,30
4455,923,483,440,271,127,326,199
4456,2851,1446,1405,763,744,877,467
4457,5948,2934,3014,1524,1237,1800,1387
4459,773,394,379,128,114,311,220
4460,1419,712,707,307,237,524,351
4461,3070,1515,1555,648,902,955,565
4462,4835,2375,2460,810,723,1689,1613
4463,2847,1409,1438,642,578,892,735
4464,684,361,323,144,95,232,213
4468,9521,4618,4903,2106,3233,2462,1720
4469,2702,1496,1206,1614,1085,3,0
4471,609,323,286,110,111,220,168
4472,2144,1074,1070,436,434,779,495
4473,7660,3875,3785,1410,3575,1308,1367
4474,3733,1851,1882,905,755,1325,748
4475,418,204,214,92,85,132,109
4476,1259,613,646,202,222,396,439
4478,316,177,139,41,32,109,134
4479,1343,649,694,277,222,448,396
4481,559,272,287,101,101,197,160
4485,233,125,108,31,39,84,79
4487,964,513,451,200,165,324,275
4488,1202,601,601,287,286,378,251
4489,197,100,97,34,87,53,23
4490,273,143,130,61,47,90,75
4491,140,76,64,32,24,51,33
4492,166,77,89,33,19,70,44
4493,1967,961,1006,422,409,658,478
4495,407,206,201,89,77,131,110
4496,3757,1857,1900,946,845,1275,691
4497,389,212,177,83,57,145,104
4530,10818,5089,5729,2516,2455,3252,2595
4535,709,345,364,158,135,238,178
4537,2073,1025,1048,435,352,662,624
4538,2080,939,1141,273,326,613,868
4539,1168,583,585,235,205,378,350
4541,80,42,38,7,7,20,46
4543,2218,980,1238,444,398,550,826
4544,724,345,379,103,74,196,351
4547,1152,581,571,227,211,326,388
4548,1042,522,520,207,171,348,316
4551,806,392,414,165,120,235,286
4553,1752,836,916,353,305,548,546
4554,710,341,369,103,75,192,340
4555,1643,814,829,357,311,526,449
4556,1249,626,623,299,216,404,330
4558,308,146,162,51,50,95,112
4562,2216,1115,1101,414,378,765,659
4563,1534,755,779,385,305,444,400
4564,489,250,239,66,65,151,207
4568,391,186,205,47,41,114,189
4570,2,1,1,0,2,0,0
4571,323,168,155,52,54,102,115
4572,5075,2504,2571,1195,1127,1508,1245
4573,501,246,255,106,85,136,174
4574,1510,783,727,335,337,479,359
4575,85,45,40,7,10,16,52
4576,604,293,311,77,49,172,306
4578,4450,2246,2204,944,995,1395,1116
4579,3072,1519,1553,699,587,1075,711
4605,12974,6303,6671,2868,2867,4211,3028
4606,1272,628,644,284,259,372,357
4607,1182,596,586,242,223,379,338
4609,5222,2417,2805,1054,1212,1616,1340
4611,508,260,248,100,95,150,163
4612,589,271,318,107,100,219,163
4613,183,97,86,43,39,50,51
4614,2579,1212,1367,492,456,861,770
4616,824,398,426,161,114,254,295
4617,811,392,419,153,132,242,284
4619,3121,1506,1615,737,629,881,874
4622,1412,682,730,288,262,428,434
4623,1054,525,529,246,221,333,254
4624,184,89,95,13,11,53,107
4625,47,23,24,6,2,16,23
4626,507,280,227,128,101,135,143
4627,1636,766,870,312,288,432,604
4628,703,340,363,172,137,209,185
4629,107,49,58,27,11,38,31
4630,1398,683,715,324,287,457,330
4631,1331,626,705,211,186,409,525
4634,1923,953,970,416,411,654,442
4635,61,38,23,22,17,13,9
4637,136,59,77,15,16,41,64
4640,2261,1106,1155,495,505,691,570
4642,123,56,67,12,13,38,60
4643,1018,508,510,235,212,303,268
4644,13,6,7,3,4,6,0
4645,73,42,31,11,11,26,25
4646,94,54,40,20,24,31,19
4648,580,294,286,133,123,190,134
4649,1370,662,708,267,281,371,451
4650,235,112,123,34,29,69,103
4652,1690,819,871,279,256,545,610
4653,490,241,249,96,77,178,139
4654,3424,1631,1793,771,857,918,878
4655,1119,630,489,220,297,323,279
4657,363,184,179,56,49,150,108
4658,1353,652,701,287,243,402,421
4660,1309,648,661,247,200,448,414
4662,488,231,257,71,111,151,155
4664,1238,604,634,275,254,430,279
4666,1172,575,597,258,195,369,350
4667,1638,777,861,481,386,456,315
4668,1680,868,812,506,367,500,307
4669,204,100,104,40,23,50,91
4671,576,306,270,135,103,183,155
4673,112,53,59,17,18,28,49
4674,484,236,248,107,101,153,123
4675,253,110,143,46,55,90,62
4676,1088,542,546,246,211,348,283
4677,274,135,139,35,51,88,100
4679,1767,830,937,382,331,529,525
4680,1131,574,557,280,238,344,269
4681,1043,518,525,169,193,337,344
4683,104,48,56,21,18,27,38
4684,1466,729,737,279,271,472,444
4685,332,173,159,68,82,102,80
4686,114,58,56,13,14,42,45
4691,441,220,221,98,74,153,116
4693,516,244,272,97,93,149,177
4694,2376,1156,1220,520,420,810,626
4730,9992,4817,5175,2496,2078,2997,2421
4732,1670,870,800,363,331,513,463
4733,221,110,111,36,31,85,69
4734,800,402,398,193,154,259,194
4735,617,309,308,146,111,191,169
4736,9876,4773,5103,2295,2067,3004,2510
4739,1112,562,550,196,189,324,403
4740,1287,639,648,329,271,388,299
4741,3,2,1,0,0,0,3
4742,3496,1691,1805,858,704,1084,850
4743,4676,2265,2411,1141,1034,1392,1109
4745,1082,552,530,238,181,382,281
4746,470,240,230,84,73,153,160
4747,1337,658,679,300,246,418,373
4750,2603,1383,1220,771,630,613,589
4756,3344,1612,1732,604,483,1075,1182
4757,2870,1447,1423,641,624,958,647
4758,1498,703,795,344,331,419,404
4760,795,415,380,163,143,272,217
4761,529,256,273,94,63,199,173
4762,602,304,298,131,90,225,156
4763,726,360,366,152,109,242,223
4764,66,30,36,12,8,16,30
4765,1262,637,625,253,211,399,399
4766,386,197,189,89,83,129,85
4768,400,202,198,53,53,139,155
4769,9692,4674,5018,2270,2552,2737,2133
4772,762,392,370,140,120,251,251
4773,723,387,336,134,105,268,216
4774,730,364,366,107,109,246,268
4776,925,464,461,188,167,295,275
4777,422,229,193,113,86,134,89
4779,398,194,204,45,47,147,159
4780,808,405,403,226,172,242,168
4781,560,291,269,108,117,188,147
4783,426,209,217,66,65,139,156
4785,2504,1224,1280,460,389,794,861
4786,1970,969,1001,458,412,599,501
4787,544,277,267,117,92,189,146
4841,7297,3392,3905,1484,1874,2032,1907
4843,4851,2214,2637,942,674,1451,1784
4847,1536,751,785,397,295,545,299
4848,566,273,293,107,78,185,196
4849,3684,1840,1844,790,682,1177,1035
4851,75,40,35,15,11,35,14
4852,69,37,32,10,17,21,21
4853,354,185,169,77,74,104,99
4854,1580,762,818,281,237,497,565
4855,307,148,159,59,45,70,133
4856,3330,1604,1726,785,460,1112,973
4858,1533,773,760,333,294,472,434
4859,724,360,364,139,114,228,243
4860,1591,766,825,305,238,503,545
4861,2781,1303,1478,646,584,852,699
4862,3592,1799,1793,824,724,1230,814
4863,1165,596,569,243,251,393,278
4864,4751,2809,1942,962,1424,1605,760
4901,26248,12451,13797,6331,6766,7205,5946
4910,2041,1011,1030,524,438,663,416
4911,2136,1102,1034,484,480,695,477
4912,1048,530,518,278,226,340,204
4915,8806,4153,4653,1961,1845,2568,2432
4917,2849,1407,1442,727,564,974,584
4918,349,173,176,65,58,128,98
4920,1713,879,834,363,305,550,495
4921,1593,817,776,391,373,487,342
4922,1164,609,555,266,263,378,257
4923,482,240,242,93,92,169,128
4924,2275,1140,1135,617,550,701,407
4925,75,40,35,5,10,37,23
4926,52,26,26,9,3,21,19
4927,3486,1781,1705,886,835,1108,657
4928,2198,1069,1129,547,479,671,501
4929,837,422,415,220,181,262,174
4930,4295,2072,2223,987,866,1338,1104
4932,1181,594,587,255,236,420,270
4933,65,31,34,28,15,20,2
4936,261,136,125,28,30,96,107
4937,6645,3286,3359,1675,1488,2167,1315
4938,9869,4562,5307,2484,2853,2436,2096
4939,1105,573,532,271,221,366,247
4940,118,60,58,29,32,36,21
4941,1751,866,885,425,356,565,405
4942,1326,674,652,263,202,455,406
4943,1792,864,928,416,354,562,460
4944,42,19,23,8,9,13,12
4945,1242,626,616,258,276,419,289
4947,1852,949,903,384,295,719,454
4949,913,470,443,214,152,328,219
4950,4855,2457,2398,1102,1051,1475,1227
4951,906,451,455,183,169,330,224
4952,1829,885,944,465,388,558,418
4953,3228,1557,1671,779,710,993,746
4955,1362,679,683,323,278,459,302
4956,760,367,393,167,161,265,167
4957,4265,2129,2136,1011,893,1395,966
4958,1954,980,974,414,371,622,547
4961,972,504,468,178,177,336,281
4962,125,59,66,32,37,32,24
4963,7238,3541,3697,1777,1547,2433,1481
4964,221,124,97,27,20,89,85
4965,1976,973,1003,467,413,600,496
4966,1682,819,863,374,309,576,423
4967,4230,2033,2197,1172,931,1264,863
4969,1362,684,678,363,293,467,239
4970,1620,825,795,303,226,555,536
4971,2005,1021,984,463,423,667,452
4973,1389,687,702,364,307,450,268
4974,2611,1244,1367,542,544,807,718
4975,48,23,25,6,6,14,22
4976,9903,4704,5199,2408,2223,2948,2324
4978,799,389,410,150,124,319,206
4979,1064,559,505,239,207,368,250
4981,2316,1129,1187,484,427,784,621
4982,630,350,280,115,157,228,130
4983,1752,904,848,436,367,544,405
4984,523,269,254,119,97,180,127
4985,114,65,49,7,18,34,55
4986,1721,864,857,473,423,493,332
4987,1030,515,515,256,223,314,237
4988,2134,1042,1092,592,645,485,412
4989,4215,2093,2122,1010,826,1484,895
4992,103,47,56,15,41,31,16
20601,24156,11657,12499,7083,5998,7971,3104
20602,24955,11652,13303,7857,7370,6712,3016
20603,28967,13641,15326,9571,7669,9315,2412
20606,431,215,216,84,79,137,131
20607,9802,4816,4986,2679,2089,3613,1421
20608,919,466,453,202,151,336,230
20609,1120,539,581,207,236,330,347
20611,1078,550,528,274,200,405,199
20612,261,140,121,45,63,74,79
20613,11860,5812,6048,3150,2583,4071,2056
20615,405,210,195,96,91,112,106
20616,5857,2813,3044,1791,1520,1754,792
20617,781,379,402,160,131,258,232
20618,607,305,302,131,131,173,172
20619,10503,5200,5303,3148,3090,3002,1263
20620,1443,721,722,425,362,474,182
20621,1373,677,696,386,268,433,286
20622,4900,2727,2173,1258,954,1519,1169
20623,2744,1349,1395,865,539,1030,310
20624,1282,637,645,351,308,434,189
20625,1062,520,542,263,221,321,257
20626,373,184,189,67,90,102,114
20628,594,309,285,153,124,199,118
20629,535,273,262,108,87,192,148
20630,348,167,181,67,66,124,91
20632,347,171,176,94,70,121,62
20634,5927,2895,3032,1789,1723,1811,604
20636,9937,4993,4944,2879,2046,3329,1683
20637,5423,2720,2703,1433,1067,2023,900
20639,14227,7087,7140,4362,2330,5253,2282
20640,10438,5157,5281,3049,2861,2983,1545
20645,857,417,440,207,129,270,251
20646,18890,9306,9584,4843,4015,6285,3747
20650,13717,6783,6934,3943,2690,4481,2603
20653,24481,12053,12428,7431,8020,6462,2568
20657,20483,10157,10326,6365,5128,6424,2566
20658,854,429,425,173,192,308,181
20659,23498,11751,11747,7109,5535,7373,3481
20660,97,44,53,32,27,27,11
20662,2934,1516,1418,773,628,976,557
20664,2987,1516,1471,696,678,921,692
20667,494,245,249,135,111,155,93
20670,1014,589,425,411,505,89,9
20674,830,400,430,175,162,264,229
20675,1671,820,851,393,312,569,397
20676,3871,1934,1937,1068,730,1363,710
20677,2322,1183,1139,605,410,837,470
20678,11045,5375,5670,2981,2565,3573,1926
20680,1119,568,551,291,188,361,279
20684,1125,545,580,264,227,372,262
20685,6471,3239,3232,1901,1293,2337,940
20686,1332,566,766,625,660,19,28
20687,313,163,150,50,70,104,89
20688,1828,757,1071,225,238,393,972
20689,1694,816,878,456,303,617,318
20690,740,369,371,170,144,247,179
20692,1051,522,529,276,217,377,181
20693,1088,528,560,283,224,375,206
20695,6794,3185,3609,1906,1589,2147,1152
20701,2,1,1,0,0,1,1
20705,26188,12831,13357,6929,7864,7537,3858
20706,38692,18376,20316,11525,10788,10673,5706
20707,31538,15085,16453,7667,10322,9003,4546
20708,25546,12034,13512,7204,8884,6566,2892
20710,9313,4379,4934,2737,3181,2144,1251
20711,6643,3280,3363,1628,1275,2240,1500
20712,9031,4477,4554,2323,3276,2432,1000
20714,4345,2056,2289,1082,1239,1320,704
20715,26382,12535,13847,6965,6037,8191,5189
20716,20787,9496,11291,5683,5539,6543,3022
20720,21031,9947,11084,6021,4889,7560,2561
20721,27016,12509,14507,7380,5407,9558,4671
20722,5711,2863,2848,1610,1692,1582,827
20723,28972,14164,14808,8920,7804,9364,2884
20724,16093,7668,8425,4238,5678,4574,1603
20732,9919,4836,5083,2918,2393,3367,1241
20733,2672,1322,1350,658,566,981,467
20735,35421,16804,18617,9181,7792,11981,6467
20736,8904,4442,4462,2550,1489,3335,1530
20737,20684,10803,9881,6528,7415,4801,1940
20740,28780,15227,13553,5233,15590,4866,3091
20742,7808,4108,3700,6053,1755,0,0
20743,38621,17829,20792,11162,10293,10589,6577
20744,50722,23877,26845,12734,11623,15658,10707
20745,28451,13233,15218,7782,8313,8108,4248
20746,28838,13037,15801,8112,8897,7691,4138
20747,40054,18103,21951,11586,11642,11532,5294
20748,38792,17865,20927,9763,10492,11271,7266
20751,2343,1153,1190,496,467,845,535
20754,6951,3476,3475,1877,1182,2495,1397
20755,9302,4878,4424,3801,4275,1130,96
20758,721,359,362,152,145,248,176
20759,3355,1630,1725,1003,586,1180,586
20762,2973,1567,1406,1124,1543,289,17
20763,2664,1395,1269,765,913,728,258
20764,4176,2121,2055,1058,952,1437,729
20765,514,244,270,67,85,190,172
20769,6604,3291,3313,1862,1366,2329,1047
20770,25173,11666,13507,6485,8700,6996,2992
20772,42625,20365,22260,11587,10655,14421,5962
20774,43013,19323,23690,11154,11027,13748,7084
20776,3289,1639,1650,822,599,1125,743
20777,3314,1647,1667,945,423,1285,661
20778,2009,1022,987,506,330,792,381
20779,1182,588,594,260,175,439,308
20781,11440,5927,5513,3122,3863,3189,1266
20782,30560,15091,15469,7697,11036,7552,4275
20783,44487,24591,19896,11082,18673,9842,4890
20784,29449,14530,14919,8859,9324,7866,3400
20785,35052,16191,18861,10411,10594,9350,4697
20794,14098,9102,4996,2214,5808,4658,1418
20812,255,122,133,76,41,87,51
20814,27642,13049,14593,5358,8353,7800,6131
20815,29082,13236,15846,6563,5906,8479,8134
20816,16208,7606,8602,4533,2559,5209,3907
20817,36240,17381,18859,10106,5507,11889,8738
20818,1962,942,1020,488,268,722,484
20832,24965,11924,13041,7204,4892,8864,4005
20833,7735,3792,3943,2396,1204,2831,1304
20837,5789,2864,2925,1712,994,2247,836
20838,259,126,133,61,27,101,70
20839,214,108,106,60,33,66,55
20841,10460,5442,5018,3379,2387,3534,1160
20842,1824,900,924,429,266,673,456
20850,46340,21956,24384,11135,12601,13826,8778
20851,14191,7180,7011,3430,4761,4123,1877
20852,40365,18982,21383,7411,13565,10554,8835
20853,29673,14633,15040,7596,6688,8994,6395
20854,49611,24078,25533,13898,5999,17076,12638
20855,14295,6990,7305,3561,2859,4901,2974
20860,2396,1062,1334,649,277,709,761
20861,1875,901,974,519,270,689,397
20862,343,170,173,85,45,108,105
20866,13344,6214,7130,3905,3427,4389,1623
20868,790,398,392,208,163,254,165
20871,13130,6391,6739,4382,3718,3798,1232
20872,13104,6412,6692,3975,3024,4425,1680
20874,57367,27469,29898,16204,18665,17166,5332
20876,25496,12312,13184,7792,7717,7659,2328
20877,34321,17046,17275,9192,11261,8916,4952
20878,62446,30376,32070,17461,15511,20590,8884
20879,24360,11874,12486,6907,7221,7545,2687
20880,450,219,231,100,56,170,124
20882,14063,7006,7057,4035,2292,5324,2412
20886,33282,16093,17189,8931,9966,9773,4612
20895,19054,8983,10071,5041,3752,6086,4175
20896,906,432,474,252,101,323,230
20899,142,76,66,6,55,56,25
20901,34832,16852,17980,9210,10069,10203,5350
20902,48841,23961,24880,13064,14905,13206,7666
20903,23625,12062,11563,6743,8509,5595,2778
20904,54612,25184,29428,13993,14740,14861,11018
20905,18044,8891,9153,4791,3452,6103,3698
20906,64696,29891,34805,15021,17260,16652,15763
20910,37445,17669,19776,6978,14695,10125,5647
20912,24807,11809,12998,6126,8105,7300,3276
21001,21487,10289,11198,5789,5489,6198,4011
21005,2112,1437,675,805,1118,175,14
21009,29766,14533,15233,8357,9062,8640,3707
21010,104,46,58,41,29,31,3
21012,21317,10338,10979,5831,4417,7093,3976
21013,4653,2283,2370,1109,655,1603,1286
21014,36047,17525,18522,9415,8275,10983,7374
21015,27763,13475,14288,8210,5610,9105,4838
21017,7062,3404,3658,1962,2369,1950,781
21028,3460,1723,1737,865,575,1159,861
21029,11333,5624,5709,3906,1456,4526,1445
21030,24355,11763,12592,5603,7366,6934,4452
21031,4,3,1,1,2,1,0
21032,8848,4459,4389,2077,1725,3182,1864
21034,3387,1673,1714,774,665,1122,826
21035,7815,3987,3828,2160,1039,2840,1776
21036,2114,1066,1048,590,262,778,484
21037,20618,10253,10365,5186,4589,6885,3958
21040,24420,11613,12807,7847,7112,6451,3010
21042,38076,18754,19322,10824,5936,13679,7637
21043,42246,20640,21606,12212,10851,13462,5721
21044,41704,19708,21996,10052,11522,12238,7892
21045,38288,18563,19725,10167,11001,10556,6564
21046,15080,7333,7747,3880,4460,4685,2055
21047,11873,5932,5941,3169,1890,4015,2799
21048,10650,5354,5296,2792,1721,3898,2239
21050,18202,8780,9422,5205,3498,6049,3450
21051,279,145,134,72,30,119,58
21052,303,152,151,58,66,106,73
21053,3305,1649,1656,878,542,1162,723
21054,10127,4889,5238,2684,1829,3384,2230
21056,267,132,135,47,29,81,110
21057,4112,2036,2076,980,535,1308,1289
21060,29223,14345,14878,6785,8365,8501,5572
21061,53684,26210,27474,13594,16870,14760,8460
21071,497,228,269,130,67,190,110
21074,15084,7400,7684,4193,3256,4946,2689
21075,26344,12898,13446,7775,8411,7449,2709
21076,12952,6432,6520,3192,3908,4109,1743
21077,224,107,117,49,52,61,62
21078,17603,8586,9017,4218,3791,5698,3896
21082,654,323,331,151,108,234,161
21084,7652,3818,3834,1822,1335,2737,1758
21085,16171,7980,8191,3798,3690,5149,3534
21087,5451,2663,2788,1190,820,2019,1422
21090,9784,4772,5012,2174,2171,3089,2350
21093,36465,16921,19544,8010,6433,10857,11165
21102,11751,5836,5915,3249,2450,3905,2147
21104,4601,2330,2271,1439,739,1709,714
21105,65,31,34,13,20,24,8
21108,17964,8800,9164,5089,3936,5724,3215
21111,4903,2417,2486,1293,725,1758,1127
21113,30469,14551,15918,8242,10180,8203,3844
21114,25225,12221,13004,7297,7188,7497,3243
21117,53778,24834,28944,13702,17384,15159,7533
21120,6967,3468,3499,1858,1102,2632,1375
21122,60576,30026,30550,15822,14954,19590,10210
21128,12802,6115,6687,3383,3196,3884,2339
21130,187,87,100,44,44,70,29
21131,7253,3605,3648,1953,973,2654,1673
21132,2634,1287,1347,710,479,949,496
21133,29998,13608,16390,8292,7124,9123,5459
21136,33781,16163,17618,9283,7816,10751,5931
21140,3457,1730,1727,860,690,1193,714
21144,31884,15403,16481,9406,8282,9876,4320
21146,26705,13047,13658,7717,4213,9026,5749
21152,5544,2669,2875,1410,1157,1858,1119
21153,323,164,159,102,38,112,71
21154,6464,3288,3176,1609,1229,2253,1373
21155,2371,1169,1202,527,391,794,659
21156,358,170,188,82,50,140,86
21157,36920,18023,18897,9372,8413,11670,7465
21158,20234,9804,10430,5541,4425,6243,4025
21160,2408,1209,1199,616,541,766,485
21161,5490,2775,2715,1344,978,1979,1189
21162,3655,1828,1827,935,815,1176,729
21163,7026,3434,3592,2014,1250,2244,1518
21201,16972,7846,9126,2645,8432,3384,2511
21202,22832,13852,8980,3541,10726,6200,2365
21204,20253,9607,10646,4172,6940,4255,4886
21205,16146,7350,8796,5338,4487,3990,2331
21206,50846,23540,27306,14118,14284,14927,7517
21207,48133,21919,26214,12480,12412,13655,9586
21208,33917,15489,18428,7548,6869,8904,10596
21209,26465,12256,14209,6455,7652,6476,5882
21210,14292,6492,7800,3481,4847,3162,2802
21211,17351,8279,9072,2549,6914,4235,3653
21212,32322,14920,17402,8583,8264,9401,6074
21213,32733,14869,17864,9833,8160,9638,5102
21214,20564,9701,10863,5132,5456,6621,3355
21215,60161,27279,32882,16040,14139,16348,13634
21216,32071,14451,17620,9118,7807,9110,6036
21217,37111,16988,20123,10590,10274,10219,6028
21218,49796,23744,26052,12012,16992,12691,8101
21219,9379,4631,4748,2229,1887,3083,2180
21220,39199,18993,20206,10130,10969,11109,6991
21221,42154,20190,21964,10819,11294,11966,8075
21222,55786,26863,28923,14192,14294,15943,11357
21223,26366,12810,13556,7716,6962,7634,4054
21224,49134,24606,24528,10253,20435,11286,7160
21225,33545,15643,17902,10437,9522,8712,4874
21226,7561,3744,3817,1975,2402,2197,987
21227,33534,16139,17395,8659,10123,8944,5808
21228,47577,22518,25059,10644,11135,13871,11927
21229,45213,20643,24570,11764,12326,12826,8297
21230,33568,16770,16798,6305,15060,7745,4458
21231,15748,7715,8033,2727,7362,3745,1914
21234,69752,32426,37326,15710,19074,19152,15816
21236,38474,18079,20395,9097,11265,10995,7117
21237,30059,14323,15736,7259,9045,8227,5528
21239,28793,12620,16173,7043,8663,7813,5274
21240,0,0,0,0,0,0,0
21244,34611,15764,18847,9782,10703,9562,4564
21250,3205,1706,1499,1688,1516,0,1
21251,934,546,388,581,353,0,0
21252,2872,996,1876,2264,606,2,0
21286,19206,8863,10343,4017,5429,4738,5022
21401,36012,17315,18697,7221,9827,9437,9527
21402,5217,3923,1294,1620,3445,137,15
21403,30269,14482,15787,6530,8369,8654,6716
21405,544,273,271,151,33,184,176
21409,20064,9772,10292,5634,4140,6473,3817
21502,44400,23776,20624,9366,11772,12607,10655
21520,2074,1003,1071,583,437,623,431
21521,1265,624,641,253,282,358,372
21522,141,72,69,35,32,46,28
21523,286,148,138,62,55,84,85
21524,626,303,323,136,135,179,176
21529,631,313,318,132,109,198,192
21530,1591,828,763,399,315,455,422
21531,2227,1119,1108,493,498,697,539
21532,15620,7660,7960,4070,5016,3363,3171
21536,4121,2024,2097,1086,891,1182,962
21538,716,352,364,174,172,190,180
21539,2819,1371,1448,729,626,753,711
21540,65,35,30,10,17,12,26
21541,1546,805,741,359,381,451,355
21542,483,240,243,106,118,136,123
21543,140,73,67,29,27,45,39
21545,1940,957,983,454,424,598,464
21550,14194,6947,7247,3513,2982,4182,3517
21555,1936,961,975,429,370,647,490
21557,1895,936,959,407,386,572,530
21561,2627,1366,1261,594,502,780,751
21562,3141,1514,1627,677,678,863,923
21601,23597,11134,12463,5408,4902,6316,6971
21607,583,286,297,162,129,192,100
21610,378,186,192,76,77,119,106
21612,492,237,255,69,56,146,221
21613,17330,8076,9254,4195,3982,4805,4348
21617,9907,4886,5021,2880,1966,3063,1998
21619,5848,2872,2976,1324,1231,1893,1400
21620,12853,5982,6871,2977,2938,3253,3685
21622,558,281,277,105,88,180,185
21623,2111,1137,974,555,547,651,358
21624,143,71,72,21,23,43,56
21625,2719,1369,1350,691,551,939,538
21626,120,65,55,19,13,43,45
21627,18,7,11,1,1,9,7
21628,556,279,277,135,118,159,144
21629,9555,4590,4965,2552,2197,2743,2063
21631,2731,1367,1364,640,535,873,683
21632,6353,3027,3326,1821,1416,1839,1277
21634,305,145,160,47,54,97,107
21635,2098,1040,1058,478,385,680,555
21636,1186,590,596,312,273,378,223
21638,4934,2449,2485,1211,1031,1562,1130
21639,4408,2106,2302,1269,1156,1263,720
21640,1632,807,825,442,402,513,275
21641,117,51,66,29,32,33,23
21643,5979,2876,3103,1565,1409,1902,1103
21644,111,62,49,31,28,35,17
21645,1039,565,474,194,257,300,288
21647,289,140,149,47,34,93,115
21648,255,138,117,63,32,71,89
21649,1858,1007,851,571,666,417,204
21650,238,122,116,68,58,67,45
21651,2898,1409,1489,747,692,879,580
21652,183,82,101,20,15,45,103
21653,114,49,65,19,23,35,37
21654,1236,615,621,138,129,363,606
21655,5009,2520,2489,1268,1036,1623,1082
21657,777,384,393,191,172,275,139
21658,3862,1943,1919,891,622,1290,1059
21659,1551,757,794,361,330,506,354
21660,4063,1973,2090,1242,1006,1157,658
21661,2653,1264,1389,490,410,772,981
21662,555,282,273,76,67,170,242
21663,3308,1506,1802,515,402,873,1518
21664,539,265,274,132,113,162,132
21665,287,144,143,55,42,85,105
21666,12309,6152,6157,3344,2227,4440,2298
21667,310,162,148,55,53,104,98
21668,1904,930,974,515,399,569,421
21669,229,128,101,37,26,92,74
21671,756,362,394,119,106,237,294
21672,241,117,124,42,24,93,82
21673,3136,1551,1585,741,612,1023,760
21675,105,57,48,17,22,35,31
21676,398,191,207,64,58,120,156
21677,440,224,216,98,70,119,153
21678,2301,1108,1193,501,434,722,644
21679,483,249,234,131,83,149,120
21701,35293,16881,18412,8331,9473,10537,6952
21702,38847,18743,20104,10502,11052,10822,6471
21703,32854,16230,16624,9617,10263,9186,3788
21704,13321,6800,6521,4364,3357,4055,1545
21705,8,6,2,0,3,5,0
21710,4515,2218,2297,1297,791,1539,888
21711,1029,538,491,243,228,335,223
21713,9502,4569,4933,2367,1853,3178,2104
21714,99,44,55,25,29,28,17
21716,4885,2396,2489,1319,1218,1547,801
21717,54,29,25,11,13,15,15
21718,151,76,75,26,24,61,40
21719,1548,758,790,448,393,482,225
21722,5545,2823,2722,1442,1093,1918,1092
21723,803,401,402,306,114,284,99
21727,5850,2800,3050,1710,1698,1450,992
21733,1163,581,582,321,242,398,202
21734,771,381,390,148,161,277,185
21737,1458,734,724,481,191,562,224
21738,3268,1621,1647,1080,366,1236,586
21740,61859,32178,29681,15592,17755,17277,11235
21742,31444,15108,16336,8189,7490,8828,6937
21746,1883,1881,2,20,1135,675,53
21750,3766,1866,1900,915,817,1114,920
21754,6323,3177,3146,1896,988,2444,995
21755,5591,2824,2767,1485,957,2075,1074
21756,3612,1835,1777,987,777,1240,608
21757,3036,1568,1468,769,581,1041,645
21758,4921,2449,2472,1349,1041,1657,874
21762,249,116,133,83,58,70,38
21766,700,364,336,140,143,217,200
21767,991,480,511,237,233,266,255
21769,11236,5562,5674,3207,1980,3967,2082
21770,5164,2634,2530,1365,834,2045,920
21771,29563,14671,14892,8855,5433,10610,4665
21773,5460,2760,2700,1490,940,2000,1030
21774,11662,5718,5944,3981,2617,3867,1197
21776,5735,2900,2835,1534,1181,2014,1006
21777,1470,712,758,439,361,512,158
21778,1094,544,550,237,237,373,247
21779,983,477,506,242,174,345,222
21780,1625,872,753,411,376,500,338
21781,136,78,58,108,14,11,3
21782,4097,2045,2052,985,788,1501,823
21783,9130,4493,4637,2634,1944,2857,1695
21784,37941,19053,18888,10665,7509,12983,6784
21787,10693,5193,5500,2977,2322,3173,2221
21788,11622,5772,5850,2987,2373,3796,2466
21790,100,48,52,18,26,32,24
21791,5281,2644,2637,1385,1067,1682,1147
21793,9775,4690,5085,2817,2138,3006,1814
21794,2434,1229,1205,770,335,944,385
21795,9233,4434,4799,2286,1827,2716,2404
21797,8839,4437,4402,2550,1388,3263,1638
21798,2345,1154,1191,640,448,797,460
21801,29961,14266,15695,8946,7581,7890,5544
21802,89,53,36,1,13,59,16
21804,38491,18043,20448,10320,11957,9240,6974
21810,487,221,266,118,97,143,129
21811,22550,10779,11771,4321,3802,6181,8246
21813,2852,1445,1407,684,478,1062,628
21814,380,172,208,73,71,148,88
21817,5236,2444,2792,1357,1048,1424,1407
21821,991,504,487,169,186,299,337
21822,1930,951,979,440,414,667,409
21824,198,95,103,21,22,62,93
21826,4837,2259,2578,1433,1470,1226,708
21829,527,271,256,128,104,162,133
21830,4026,1989,2037,1144,888,1231,763
21835,507,255,252,106,93,160,148
21837,2614,1305,1309,672,570,830,542
21838,1736,871,865,426,326,527,457
21840,375,194,181,66,51,133,125
21841,860,433,427,212,171,290,187
21842,11089,5623,5466,1630,2284,3332,3843
21849,3238,1612,1626,797,717,1038,686
21850,2790,1377,1413,702,672,884,532
21851,7315,3380,3935,1936,1574,2139,1666
21853,11126,5024,6102,3389,3721,2272,1744
21856,1035,584,451,234,243,334,224
21861,757,354,403,190,178,229,160
21862,106,60,46,23,16,44,23
21863,5029,2524,2505,1148,1084,1584,1213
21864,611,281,330,149,94,215,153
21865,470,238,232,78,90,145,157
21866,78,39,39,8,8,23,39
21867,114,55,59,30,27,42,15
21869,1006,467,539,221,189,305,291
21871,2124,1080,1044,482,411,677,554
21872,718,338,380,158,131,277,152
21874,2210,1088,1122,593,567,662,388
21875,6467,3077,3390,1770,1704,1932,1061
21890,3240,3238,2,39,1946,1130,125
21901,15875,7815,8060,4561,4054,4677,2583
21902,471,418,53,19,45,230,177
21903,5687,2829,2858,1410,1260,1872,1145
21904,7252,3611,3641,2020,1530,2478,1224
21911,11004,5415,5589,3242,2488,3311,1963
21912,1231,633,598,331,257,434,209
21913,663,319,344,202,172,183,106
21914,765,396,369,173,171,266,155
21915,3030,1530,1500,653,564,1075,738
21916,37,37,0,0,0,4,33
21917,2520,1328,1192,673,516,865,466
21918,4284,2180,2104,1152,907,1481,744
21919,3467,1702,1765,804,540,1164,959
21920,257,131,126,68,53,95,41
21921,44471,21910,22561,12727,11534,12998,7212
21930,94,47,47,15,19,26,34
1001,16769,7845,8924,3430,3698,4930,4711
1002,29049,13950,15099,7104,11976,5549,4420
1003,10372,5325,5047,4741,5614,17,0
1005,5079,2570,2509,1423,1042,1668,946
1007,14649,7133,7516,3995,3063,5181,2410
1008,1263,653,610,273,251,440,299
1009,741,386,355,175,202,224,140
1010,3609,1790,1819,854,671,1331,753
1011,1370,706,664,318,256,512,284
1012,661,334,327,138,125,243,155
1013,23188,10902,12286,6142,6487,6093,4466
1020,29668,14353,15315,6416,7303,8884,7065
1022,2451,1156,1295,554,709,556,632
1026,946,472,474,191,165,368,222
1027,17660,8402,9258,3589,4422,5805,3844
1028,15720,7401,8319,3941,2746,5007,4026
1029,789,412,377,149,128,295,217
1030,11669,5747,5922,2966,2336,4014,2353
1031,1308,656,652,324,328,383,273
1032,570,277,293,134,106,210,120
1033,6227,3077,3150,1532,1263,2171,1261
1034,2021,1019,1002,497,347,740,437
1035,5250,2507,2743,1037,1209,1615,1389
1036,5109,2484,2625,1207,783,1782,1337
1037,838,440,398,339,140,231,128
1038,2545,1225,1320,508,446,913,678
1039,1336,618,718,253,240,532,311
1040,39880,18701,21179,11685,10589,9948,7658
1050,2530,1272,1258,608,544,907,471
1053,1685,840,845,277,245,589,574
1054,1851,922,929,386,330,621,514
1056,21103,10839,10264,4629,5071,6653,4750
1057,8534,4180,4354,2145,1695,3031,1663
1060,15284,6211,9073,2877,5671,3865,2871
1062,11150,5260,5890,2607,2161,3955,2427
1063,430,1,429,149,276,3,2
1066,64,30,34,15,8,21,20
1068,1902,955,947,480,358,744,320
1069,8469,4228,4241,1936,1847,2874,1812
1070,629,314,315,140,101,228,160
1071,1596,786,810,405,346,564,281
1072,1478,704,774,375,277,580,246
1073,5792,2808,2984,1395,1032,2157,1208
1074,319,157,162,108,94,76,41
1075,17527,7183,10344,4103,4529,4810,4085
1077,9502,4714,4788,2343,1853,3324,1982
1079,692,350,342,187,159,214,132
1080,2334,1118,1216,571,605,705,453
1081,1698,857,841,401,382,572,343
1082,10322,5085,5237,2507,2456,3216,2143
1083,2888,1438,1450,773,694,913,508
1084,176,90,86,36,21,64,55
1085,41117,20111,21006,10604,10434,11948,8131
1086,687,338,349,512,175,0,0
1088,670,344,326,99,124,269,178
1089,28391,13854,14537,6671,7361,8388,5971
1092,1394,698,696,397,338,444,215
1093,325,162,163,56,44,131,94
1094,351,150,201,84,66,99,102
1095,14319,6782,7537,3714,2134,4812,3659
1096,2217,1053,1164,484,428,800,505
1097,111,51,60,36,41,26,8
1098,1101,543,558,182,166,456,297
1103,2479,1196,1283,439,920,726,394
1104,22865,10859,12006,6638,6083,5918,4226
1105,12350,5920,6430,4174,3756,3049,1371
1106,16021,7487,8534,4476,2277,5070,4198
1107,11611,5523,6088,4524,3194,2552,1341
1108,26688,12750,13938,8722,7810,6569,3587
1109,30250,14221,16029,10593,8765,6855,4037
1118,14071,6466,7605,3492,3679,3921,2979
1119,14152,6760,7392,4243,4103,3318,2488
1128,2631,1331,1300,537,616,873,605
1129,7019,3313,3706,1704,1737,2025,1553
1151,8698,4128,4570,2799,2564,2151,1184
1199,0,0,0,0,0,0,0
1201,46504,22327,24177,10873,10709,13773,11149
1220,8603,4148,4455,1900,1889,2589,2225
1222,829,400,429,205,150,298,176
1223,2314,1168,1146,448,410,884,572
1224,182,93,89,39,33,83,27
1225,3117,1579,1538,674,597,1097,749
1226,6945,3331,3614,1705,1324,2210,1706
1229,95,40,55,13,12,35,35
1230,8430,4053,4377,1923,1500,2597,2410
1235,2766,1401,1365,606,523,1000,637
1236,1509,724,785,319,282,494,414
1237,2496,1253,1243,573,443,889,591
1238,6047,2906,3141,1242,1281,1914,1610
1240,4534,2044,2490,936,600,1263,1735
1242,476,224,252,99,116,160,101
1243,334,166,168,61,47,145,81
1244,151,77,74,35,40,45,31
1245,985,477,508,180,177,297,331
1247,16087,7672,8415,3932,4123,4431,3601
1253,731,360,371,128,139,267,197
1254,972,464,508,170,116,341,345
1255,915,490,425,167,140,336,272
1256,692,351,341,155,114,268,155
1257,2121,1055,1066,416,340,706,659
1258,374,177,197,60,42,127,145
1259,635,318,317,122,100,220,193
1260,240,115,125,54,36,81,69
1262,1238,576,662,168,231,382,457
1264,137,62,75,11,23,36,67
1266,1463,703,760,263,184,514,502
1267,7989,3736,4253,1937,2165,1726,2161
1270,778,397,381,165,119,312,182
1301,17700,8428,9272,3875,4303,5394,4128
1330,1506,737,769,311,252,567,376
1331,13263,6547,6716,3353,3104,4144,2662
1337,2596,1300,1296,544,471,932,649
1338,187,92,95,38,29,64,56
1339,1438,725,713,295,284,476,383
1340,1701,878,823,368,336,617,380
1341,1833,898,935,434,309,674,416
1342,1492,773,719,374,273,533,312
1343,75,36,39,16,19,21,19
1344,1498,734,764,365,350,464,319
1346,533,271,262,114,81,183,155
1347,166,84,82,35,43,55,33
1349,1091,528,563,239,285,348,219
1350,121,62,59,28,28,37,28
1351,2270,1100,1170,472,489,835,474
1354,1500,746,754,322,282,553,343
1355,878,447,431,201,129,356,192
1360,3032,1498,1534,754,548,1054,676
1364,7969,3876,4093,2031,1817,2446,1675
1366,1277,652,625,282,208,464,323
1367,522,258,264,107,79,157,179
1368,1261,628,633,307,226,483,245
1370,4084,1973,2111,817,819,1363,1085
1373,4600,2222,2378,1012,941,1522,1125
1375,3684,1813,1871,610,1530,987,557
1376,5247,2558,2689,1137,1326,1508,1276
1378,774,385,389,160,137,295,182
1379,813,404,409,144,176,297,196
1420,40337,19602,20735,11015,11837,10607,6878
1430,6089,3091,2998,1769,1187,2159,974
1431,3074,1545,1529,819,590,1168,497
1432,7089,3529,3560,1755,1839,2327,1168
1434,1795,1476,319,261,1080,392,62
1436,3336,1694,1642,861,695,999,781
1438,559,278,281,149,127,191,92
1440,20347,10418,9929,4751,5226,6230,4140
1450,10646,5264,5382,3267,1632,4112,1635
1451,4747,2359,2388,1411,468,1872,996
1452,4382,2189,2193,1225,859,1650,648
1453,40883,19832,21051,10315,10116,12420,8032
1460,8924,4290,4634,2522,1490,3166,1746
1462,10086,5005,5081,2541,1893,3546,2106
1463,11497,5703,5794,3206,2256,4171,1864
1464,7211,4252,2959,1481,2225,2464,1041
1467,316,150,166,77,36,136,67
1468,4021,2024,1997,1079,846,1388,708
1469,6801,3363,3438,1868,1426,2440,1067
1473,7277,3640,3637,1902,1430,2575,1370
1474,2125,1050,1075,570,398,812,345
1475,10270,5154,5116,2956,2367,3222,1725
1501,16075,7757,8318,3730,3436,4959,3950
1503,2866,1418,1448,654,492,1008,712
1504,9026,4352,4674,2365,2170,2983,1508
1505,4355,2091,2264,1096,781,1594,884
1506,3390,1679,1711,810,700,1101,779
1507,12981,6378,6603,3561,2660,4576,2184
1510,13606,6648,6958,3274,3656,4206,2470
1515,2183,1107,1076,544,495,708,436
1516,8500,4231,4269,2494,1888,3030,1088
1518,2974,1480,1494,822,614,916,622
1519,6595,3235,3360,1856,1386,2348,1005
1520,13997,6748,7249,3802,2673,4497,3025
1521,2481,1285,1196,589,538,901,453
1522,3310,1650,1660,916,671,1169,554
1523,7582,4346,3236,1772,2109,2369,1332
1524,6696,3258,3438,1742,1540,2143,1271
1525,290,142,148,77,91,83,39
1527,13246,6374,6872,3103,3091,4164,2888
1529,3190,1585,1605,956,760,1064,410
1531,999,501,498,232,213,377,177
1532,14155,6946,7209,4042,2499,4961,2653
1534,5631,2772,2859,1558,1240,1843,990
1535,4680,2298,2382,1183,1044,1534,919
1536,6888,3281,3607,1810,1642,2128,1308
1537,2248,1084,1164,508,556,727,457
1540,11291,5553,5738,3053,2469,3833,1936
1541,3413,1709,1704,883,466,1374,690
1542,2202,1077,1125,575,517,656,454
1543,7973,3945,4028,2478,1659,2702,1134
1545,35299,17211,18088,9798,7623,11301,6577
1550,16719,8059,8660,4305,4463,4686,3265
1560,4527,2218,2309,1300,1400,1257,570
1561,330,114,216,78,156,73,23
1562,11688,5829,5859,2750,2829,3671,2438
1564,7808,3841,3967,2070,1362,2765,1611
1566,6294,3088,3206,1643,1324,2003,1324
1568,7480,3665,3815,2250,1315,2722,1193
1569,13569,6754,6815,3605,2909,4616,2439
1570,16767,8110,8657,3946,4222,4941,3658
1571,11390,5702,5688,3127,2863,3419,1981
1581,18272,8960,9312,5022,4164,5871,3215
1583,7591,4225,3366,1483,1783,2556,1769
1585,4554,2179,2375,1003,889,1464,1198
1588,9733,4643,5090,2703,2265,2914,1851
1590,8875,4371,4504,2488,1573,3231,1583
1602,22819,10685,12134,5504,6155,6383,4777
1603,19916,9900,10016,5434,5988,5369,3125
1604,34677,16835,17842,8413,11064,9136,6064
1605,26221,12190,14031,7744,7724,6388,4365
1606,19077,9156,9921,4351,5485,5450,3791
1607,8351,4066,4285,2248,2671,2229,1203
1608,3888,2093,1795,1232,1406,954,296
1609,22421,11664,10757,5986,7908,4931,3596
1610,23945,11665,12280,7714,9128,4951,2152
1611,2242,1102,1140,589,575,674,404
1612,4845,2423,2422,1507,968,1460,910
1701,31217,14944,16273,7279,6701,9700,7537
1702,37206,18118,19088,9026,13270,9546,5364
1718,469,229,240,126,79,164,100
1719,4996,2555,2441,1419,831,2034,712
1720,21361,10481,10880,6464,3510,7841,3546
1721,16593,8066,8527,4381,3881,5556,2775
1730,13221,6582,6639,3303,2230,4393,3295
1731,1396,690,706,644,516,224,12
1740,4897,2424,2473,1527,684,1922,764
1741,4852,2416,2436,1415,487,1920,1030
1742,17726,8987,8739,4307,2735,6015,4669
1745,397,199,198,92,83,145,77
1746,13547,6667,6880,3852,2348,4761,2586
1747,5911,2897,3014,1637,1127,2027,1120
1748,14925,7340,7585,5018,2361,5613,1933
1749,19063,9403,9660,4710,4521,5917,3915
1752,38499,19063,19436,9093,11010,11693,6703
1754,10106,4837,5269,2437,2395,3391,1883
1756,5839,2924,2915,1749,966,2185,939
1757,28061,13971,14090,7020,7413,8495,5133
1760,32786,15777,17009,8278,7493,10544,6471
1770,4119,2004,2115,1320,415,1565,819
1772,9370,4637,4733,3083,1332,3423,1532
1773,5112,2452,2660,1290,561,1743,1518
1775,6590,3244,3346,1856,1034,2418,1282
1776,17659,8617,9042,5961,2127,6439,3132
1778,13109,6321,6788,3776,1783,4482,3068
1801,38903,18851,20052,8362,10998,11389,8154
1803,24487,11940,12547,5809,5861,7230,5587
1810,33201,16021,17180,9480,6050,11224,6447
1821,30310,14954,15356,7747,7417,9588,5558
1824,24911,12141,12770,6318,4702,8298,5593
1826,29422,14413,15009,7502,7268,9275,5377
1827,3179,1598,1581,990,420,1260,509
1830,25137,12106,13031,5967,6594,7617,4959
1832,22060,10588,11472,5842,6183,6518,3517
1833,8183,4040,4143,2343,1519,2893,1428
1834,6459,3127,3332,1733,1113,2257,1356
1835,13682,6513,7169,3613,3559,4366,2144
1840,4733,2366,2367,1227,1344,1337,825
1841,47225,22807,24418,16215,14321,11295,5394
1843,24425,11605,12820,7558,7472,6085,3310
1844,47249,22507,24742,12461,11636,14089,9063
1845,28352,13535,14817,8395,5729,8883,5345
1850,15237,7454,7783,4609,4640,4065,1923
1851,30190,15043,15147,8750,9799,7981,3660
1852,33508,16505,17003,8339,10683,8966,5520
1854,27606,13880,13726,7869,9104,6532,4101
1860,6338,3057,3281,1694,1065,2347,1232
1862,10227,5477,4750,2506,2483,3464,1774
1863,8891,4226,4665,2085,2155,2692,1959
1864,14892,7325,7567,4071,2859,5248,2714
1867,23956,11606,12350,6539,4662,7865,4890
1876,28667,13908,14759,7069,6060,9480,6058
1879,11305,5522,5783,3098,2407,4165,1635
1880,24733,11904,12829,5742,5894,7968,5129
1886,21951,10901,11050,6952,3333,8312,3354
1887,22325,10949,11376,6134,4638,7508,4045
1890,21382,10193,11189,6450,3314,6939,4679
1901,1689,828,861,240,460,434,555
1902,45139,22126,23013,12929,13887,11469,6854
1904,18203,8854,9349,4396,4434,5713,3660
1905,25251,12393,12858,7621,7658,6562,3410
1906,26660,12706,13954,5664,6165,8351,6480
1907,14027,6560,7467,3413,2432,4610,3572
1908,3410,1638,1772,604,527,1218,1061
1913,16283,7871,8412,3958,3825,5509,2991
1915,39502,18721,20781,9260,10452,11601,8189
1921,7961,3918,4043,2392,933,3075,1561
1922,3108,1513,1595,871,464,1175,598
1923,26342,12321,14021,6067,5521,8476,6278
1929,3504,1753,1751,881,655,1215,753
1930,28789,13845,14944,5948,5867,9570,7404
1937,151,85,66,0,11,104,36
1938,13175,6275,6900,3046,2208,4485,3436
1940,12108,5870,6238,3207,1873,4020,3008
1944,5136,2406,2730,1293,662,1746,1435
1945,19808,9356,10452,5240,2847,6801,4920
1949,8987,5030,3957,2138,2119,3056,1674
1950,17416,8093,9323,3876,3176,6103,4261
1951,3558,1738,1820,766,529,1370,893
1952,8283,4006,4277,1807,1716,2872,1888
1960,50944,24200,26744,10813,11477,15169,13485
1966,6952,3205,3747,1329,1038,2307,2278
1969,5856,2897,2959,1547,1094,2188,1027
1970,41109,19154,21955,9319,12659,11547,7584
1982,7764,3815,3949,2260,1538,2568,1398
1983,6089,2941,3148,1760,745,2101,1483
1984,4875,2206,2669,1592,1129,1292,862
1985,4235,2104,2131,1217,554,1634,830
2019,16332,7932,8400,4226,3856,5409,2841
2021,21561,10198,11363,5441,4561,6622,4937
2025,7542,3703,3839,2350,964,2540,1688
2026,24711,11950,12761,5563,5583,7593,5972
2030,5589,2780,2809,1859,571,2013,1146
2032,4226,2100,2126,1159,875,1389,803
2035,16865,8273,8592,4406,3562,5669,3228
2038,31635,15501,16134,10071,6460,10705,4399
2043,22157,10405,11752,6379,3248,6795,5735
2045,10293,4877,5416,1969,1966,3877,2481
2047,180,78,102,24,25,63,68
2048,23184,11517,11667,7235,4889,8073,2987
2050,25429,12377,13052,6849,4591,8739,5250
2052,12024,5828,6196,4009,1530,4475,2010
2053,12752,6205,6547,3845,2261,4643,2003
2054,7891,3863,4028,2113,1528,2791,1459
2056,10981,6512,4469,2770,2251,4334,1626
2061,10506,5035,5471,3187,1414,3531,2374
2062,28602,13693,14909,6363,7524,8173,6542
2066,17656,8465,9191,4832,2614,6051,4159
2067,17486,8434,9052,5104,2761,6245,3376
2071,1707,1220,487,363,658,537,149
2072,26999,12944,14055,6330,5984,8510,6175
2081,18472,8791,9681,5013,3348,6084,4027
2090,14636,6971,7665,4496,1881,4820,3439
2093,10955,5400,5555,3097,1773,4032,2053
2108,3825,1921,1904,690,1383,1003,749
2109,3771,1951,1820,261,1842,876,792
2110,1733,895,838,111,504,470,648
2111,7383,3767,3616,1382,2956,1714,1331
2113,6915,3146,3769,336,4711,949,919
2114,11999,5992,6007,985,7155,2095,1764
2115,28441,13852,14589,7731,15433,2692,2585
2116,20628,10065,10563,3235,8898,4555,3940
2118,26498,14218,12280,4281,11838,6863,3516
2119,25346,11608,13738,7278,7367,6695,4006
2120,15181,7477,7704,3813,7877,2169,1322
2121,25978,11424,14554,8887,7219,6393,3479
2122,23479,11628,11851,6293,7694,6201,3291
2124,47783,21824,25959,13866,13932,12740,7245
2125,33295,16399,16896,8835,12090,8267,4103
2126,25562,11547,14015,7076,6814,6978,4694
2127,31799,14935,16864,4980,15298,7064,4457
2128,40508,21314,19194,10062,15942,9644,4860
2129,16439,7589,8850,2914,6979,4082,2464
2130,35401,16230,19171,6177,14731,8661,5832
2131,29826,13862,15964,7335,8568,8915,5008
2132,25861,12043,13818,5423,6047,7981,6410
2134,21503,11574,9929,2035,15117,2809,1542
2135,42780,20817,21963,4541,25791,6323,6125
2136,28488,13324,15164,8055,7373,8212,4848
2138,36314,17074,19240,6335,18725,5762,5492
2139,36349,18298,18051,5935,19994,6389,4031
2140,17607,8147,9460,3111,7190,4363,2943
2141,11910,5972,5938,1597,6151,2387,1775
2142,3141,1696,1445,341,2105,393,302
2143,24514,12137,12377,2688,13635,4921,3270
2144,23891,11162,12729,2492,13969,4219,3211
2145,25439,12936,12503,5023,10838,6306,3272
2148,59503,28825,30678,13009,20128,16524,9842
2149,41550,20384,21166,10573,13116,11351,6510
2150,35124,17868,17256,9939,12589,8272,4324
2151,51808,25412,26396,11764,15728,14115,10201
2152,17497,8458,9039,3500,4220,5649,4128
2155,57964,27706,30258,12192,19441,14905,11426
2163,2582,1287,1295,613,1952,10,7
2169,55055,26439,28616,10365,18295,15037,11358
2170,19505,9341,10164,3746,6187,5663,3909
2171,17711,8419,9292,2894,5771,5258,3788
2176,26983,12692,14291,6336,6329,8339,5979
2180,21437,10148,11289,4627,4734,6706,5370
2184,35744,16874,18870,8814,8172,10714,8044
2186,27003,12736,14267,7766,5219,8275,5743
2188,14608,6805,7803,3114,3730,4361,3403
2189,14559,6870,7689,3608,3799,4541,2611
2190,16119,7745,8374,3747,3944,5075,3353
2191,8457,4038,4419,1750,1862,2826,2019
2199,1146,524,622,72,577,187,310
2203,0,0,0,0,0,0,0
2210,2090,1189,901,125,1216,574,175
2215,26125,11214,14911,7147,16427,1395,1156
2301,61025,29305,31720,17390,16608,16634,10393
2302,32741,15778,16963,9388,8595,9276,5482
2322,4356,2109,2247,1006,917,1413,1020
2324,26563,13683,12880,6962,7469,8046,4086
2330,11509,5610,5899,2899,2431,3654,2525
2332,15059,7241,7818,4552,1854,5123,3530
2333,13794,6729,7065,3753,3025,4365,2651
2338,7518,3659,3859,1901,1528,2528,1561
2339,13879,6775,7104,4165,2362,4648,2704
2341,10218,5080,5138,2917,2115,3391,1795
2343,10745,5227,5518,2616,2584,3342,2203
2346,23106,11287,11819,5932,5154,7086,4934
2347,10612,5200,5412,2923,1962,3735,1992
2351,16029,7830,8199,4032,4095,5099,2803
2356,12564,6030,6534,3519,2545,4125,2375
2357,1360,570,790,686,638,9,27
2359,17828,8751,9077,5057,3612,6148,3011
2360,56271,27714,28557,13692,13137,17428,12014
2364,12629,6040,6589,3447,2393,4121,2668
2366,197,196,1,5,119,71,2
2367,2820,1384,1436,705,492,1035,588
2368,32158,15437,16721,7838,8272,9827,6221
2370,17489,8358,9131,4346,4355,5380,3408
2375,9188,4463,4725,2335,1996,3096,1761
2379,6916,3400,3516,1637,1386,2211,1682
2382,14489,7070,7419,3990,3648,4434,2417
2420,14052,6686,7366,3884,1759,4835,3574
2421,17342,8218,9124,4861,2359,5798,4324
2445,20679,9514,11165,4373,7349,5163,3794
2446,29311,12846,16465,4705,13697,5698,5211
2451,17426,8525,8901,3237,5682,4925,3582
2452,14238,7080,7158,3252,5199,3064,2723
2453,28968,14599,14369,5933,12252,6659,4124
2457,1432,802,630,573,851,4,4
2458,12131,5612,6519,2670,3380,3541,2540
2459,19095,9038,10057,5787,3253,5626,4429
2460,8742,4127,4615,2132,1962,2783,1865
2461,7059,3324,3735,1883,1418,2267,1491
2462,1554,699,855,338,254,458,504
2464,2953,1343,1610,653,799,875,626
2465,11710,5576,6134,3076,2291,3767,2576
2466,8096,3609,4487,2286,2100,2094,1616
2467,22491,10364,12127,6498,7600,4455,3938
2468,5273,2570,2703,1452,672,1795,1354
2472,32014,15004,17010,5420,11420,8595,6579
2474,26312,12344,13968,5592,7350,7951,5419
2476,16532,7560,8972,3776,3424,5436,3896
2478,24664,11590,13074,6467,5239,7657,5301
2481,16244,6773,9471,5743,2873,4718,2910
2482,10306,4761,5545,3051,1533,3207,2515
2492,19931,9595,10336,6150,2834,6395,4552
2493,11261,5377,5884,3596,1270,3649,2746
2494,8955,4318,4637,2533,1598,2878,1946
2532,12690,6496,6194,2831,2893,3718,3248
2534,842,415,427,146,129,244,323
2535,1177,592,585,230,210,368,369
2536,19583,9335,10248,4263,3520,6188,5612
2537,6293,3043,3250,1696,994,2050,1553
2538,3603,1759,1844,894,876,1222,611
2539,4067,2092,1975,856,916,1336,959
2540,8221,3673,4548,1175,1116,2185,3745
2542,1139,776,363,313,607,198,21
2543,635,297,338,84,158,167,226
2553,226,106,120,34,45,70,77
2554,9852,5049,4803,2217,2855,3080,1700
2556,3115,1454,1661,562,385,890,1278
2557,4491,2196,2295,935,991,1462,1103
2558,2156,1056,1100,430,448,697,581
2559,3376,1603,1773,574,546,965,1291
2561,539,279,260,119,98,183,139
2562,2977,1410,1567,729,506,1010,732
2563,10359,4951,5408,2582,1648,3580,2549
2564,310,149,161,42,64,107,97
2568,4000,1961,2039,792,981,1277,950
2571,10481,5017,5464,2552,2214,3186,2529
2575,2725,1300,1425,585,513,962,665
2576,3754,1787,1967,883,719,1144,1008
2584,10,7,3,3,0,5,2
2601,14089,6922,7167,2871,3859,4221,3138
2630,1850,881,969,315,214,563,758
2631,9679,4481,5198,1781,1275,2911,3712
2632,10742,5052,5690,2109,1888,3361,3384
2633,3884,1868,2016,512,491,1018,1863
2635,3296,1618,1678,618,452,1021,1205
2637,253,125,128,35,18,90,110
2638,3207,1498,1709,438,379,837,1553
2639,2875,1370,1505,492,610,867,906
2641,532,253,279,54,31,120,327
2642,4937,2297,2640,706,661,1415,2155
2643,26,7,19,0,2,10,14
2644,3955,1926,2029,1231,766,1402,556
2645,9663,4500,5163,1852,1528,2909,3374
2646,1676,776,900,202,180,437,857
2647,129,61,68,23,14,37,55
2648,7301,3545,3756,1718,1337,2618,1628
2649,14006,6511,7495,3009,2578,4045,4374
2650,848,358,490,82,97,182,487
2651,16,9,7,0,0,2,14
2652,1175,586,589,164,177,426,408
2653,5911,2790,3121,718,701,1491,3001
2655,3518,1641,1877,669,474,982,1393
2657,2942,1602,1340,221,467,1316,938
2659,1108,533,575,171,173,313,451
2660,6261,2882,3379,1080,933,1742,2506
2663,173,85,88,21,28,44,80
2664,9371,4380,4991,1691,1569,2552,3559
2666,828,403,425,130,99,263,336
2667,2580,1200,1380,372,405,849,954
2668,3278,1582,1696,823,435,1189,831
2669,285,140,145,48,35,62,140
2670,1307,582,725,141,198,366,602
2671,1023,470,553,149,156,279,439
2672,180,87,93,26,25,57,72
2673,8402,3971,4431,1584,1929,2369,2520
2675,6577,2982,3595,943,828,1752,3054
2702,4125,2052,2073,1006,901,1445,773
2703,43593,21296,22297,10907,11268,13523,7895
2713,52,31,21,9,14,11,18
2715,3123,1572,1551,886,680,1014,543
2717,4745,2400,2345,1202,976,1589,978
2718,6655,3263,3392,1860,1721,2131,943
2719,15873,7636,8237,3353,3354,4995,4171
2720,30287,14445,15842,6519,8467,8595,6706
2721,26290,12482,13808,6731,7596,6792,5171
2723,14767,6973,7794,3779,4408,3743,2837
2724,16908,7994,8914,4204,4808,4479,3417
2725,2631,1213,1418,523,560,743,805
2726,15534,7408,8126,3369,3141,4735,4289
2738,4907,2309,2598,1221,706,1543,1437
2739,6045,2943,3102,1359,896,2086,1704
2740,43087,20401,22686,10773,11900,11273,9141
2743,10307,5063,5244,2367,2237,3370,2333
2744,11900,5845,6055,3373,3579,2961,1987
2745,24576,11693,12883,5742,6501,6957,5376
2746,15342,7560,7782,4611,4986,3515,2230
2747,22927,11832,11095,5899,7044,6023,3961
2748,11442,5446,5996,2396,2020,3480,3546
2760,26739,13033,13706,7307,6515,8644,4273
2762,8264,4046,4218,2087,1988,2633,1556
2763,1973,960,1013,600,443,663,267
2764,3988,1993,1995,1111,774,1296,807
2766,19031,9191,9840,5421,4598,5983,3029
2767,13566,6612,6954,3578,2939,4273,2776
2769,11608,5805,5803,3011,2150,4180,2267
2770,5093,2571,2522,1412,866,1827,988
2771,13708,6653,7055,3309,2715,4732,2952
2777,15840,7757,8083,3468,3359,5121,3892
2779,6411,3162,3249,1855,1335,2325,896
2780,49036,23400,25636,12035,12818,14696,9487
2790,15717,7672,8045,3405,3054,5127,4131
2791,246,117,129,21,33,68,124
2861,14,7,7,0,2,3,9
48001,11986,6049,5937,2643,2377,4022,2944
48002,3285,1691,1594,934,646,1101,604
48003,6070,3059,3011,1727,1254,2037,1052
48005,5379,2698,2681,1475,1018,1856,1030
48006,4007,2102,1905,1121,827,1361,698
48009,20107,9671,10436,5204,4453,6425,4025
48014,4256,2138,2118,1314,1007,1256,679
48015,8257,3810,4447,1986,2007,2322,1942
48017,11805,5785,6020,2363,3569,3483,2390
48021,32353,15660,16693,9283,8766,9152,5152
48022,2654,1347,1307,794,521,905,434
48023,5178,2626,2552,1322,1110,1754,992
48025,14543,7029,7514,3879,2052,4875,3737
48026,14480,6720,7760,3480,3132,4624,3244
48027,3249,1657,1592,882,697,1085,585
48028,1190,626,564,121,105,408,556
48030,16422,8108,8314,4445,4688,4728,2561
48032,2322,1176,1146,635,483,782,422
48033,16064,7052,9012,3288,3831,4697,4248
48034,12590,5385,7205,2736,3568,3329,2957
48035,34788,16471,18317,9125,9174,9669,6820
48036,20980,9888,11092,4818,4951,6140,5071
48038,41057,19139,21918,8659,10760,11986,9652
48039,7807,3818,3989,1980,1705,2511,1611
48040,9956,4794,5162,2565,2095,2945,2351
48041,4561,2339,2222,1274,922,1571,794
48042,27291,13463,13828,8402,6104,8276,4509
48043,16305,8397,7908,3799,4726,4731,3049
48044,52289,25948,26341,16655,12446,16354,6834
48045,24604,12122,12482,5278,5881,8340,5105
48047,39415,19291,20124,11259,9494,12457,6205
48048,7548,3677,3871,2429,2056,2048,1015
48049,5582,2817,2765,1407,1123,1961,1091
48050,1653,841,812,385,289,618,361
48051,17319,9152,8167,5003,4648,5719,1949
48054,7339,3610,3729,1678,1240,2443,1978
48059,15123,7262,7861,3720,3022,4595,3786
48060,40831,19734,21097,11365,10837,11094,7535
48062,9373,4676,4697,2512,2093,2884,1884
48063,4070,2097,1973,1155,821,1356,738
48064,4107,2087,2020,1078,789,1430,810
48065,10547,5209,5338,2883,2066,3469,2129
48066,47388,22927,24461,12170,12992,13674,8552
48067,24458,12325,12133,4199,9692,6794,3773
48069,2526,1282,1244,541,548,882,555
48070,6238,3067,3171,1799,1059,2059,1321
48071,29694,14570,15124,6764,8831,8522,5577
48072,14970,7167,7803,3449,4555,4517,2449
48073,32798,15737,17061,6201,10378,9568,6651
48074,9356,4753,4603,2418,2137,3003,1798
48075,21790,9918,11872,5168,5198,5983,5441
48076,25386,11677,13709,6343,5442,8030,5571
48079,12304,6076,6228,3290,2317,4135,2562
48080,22494,10565,11929,4625,5598,6744,5527
48081,20635,9976,10659,4358,4511,6508,5258
48082,16549,7967,8582,3619,3817,5057,4056
48083,22507,10980,11527,5741,5804,6552,4410
48084,14231,7054,7177,3470,4079,4075,2607
48085,24660,12271,12389,6730,4572,8343,5015
48088,22255,10679,11576,4991,5041,6397,5826
48089,31978,15782,16196,9496,9207,8678,4597
48091,31106,15238,15868,8562,8406,8764,5374
48092,25680,12633,13047,5990,6326,7520,5844
48093,23037,10552,12485,4902,5175,6554,6406
48094,18028,8913,9115,5022,3848,5549,3609
48095,4906,2387,2519,1276,884,1608,1138
48096,3739,1931,1808,894,675,1329,841
48097,5499,2742,2757,1687,1172,1592,1048
48098,19582,9578,10004,4967,3069,7129,4417
48101,28200,13567,14633,6790,6665,8375,6370
48103,53057,25663,27394,12411,15208,15999,9439
48104,38315,19266,19049,6763,21420,5843,4289
48105,33905,16981,16924,7815,12944,7555,5591
48108,26164,12701,13463,6590,8649,7278,3647
48109,6904,3405,3499,5064,1828,2,10
48111,42313,20593,21720,11179,11649,12850,6635
48114,19702,9917,9785,5234,3474,7041,3953
48116,26432,13063,13369,6862,5240,8812,5518
48117,10124,5048,5076,2575,2155,3403,1991
48118,12552,6171,6381,3060,2305,4212,2975
48120,8274,4181,4093,2986,2323,1436,1529
48122,10727,5155,5572,2954,2921,3032,1820
48124,31732,15368,16364,7547,7714,9558,6913
48125,21273,10404,10869,5623,5587,6019,4044
48126,47465,23832,23633,18533,13155,10006,5771
48127,36501,17534,18967,10329,8719,9465,7988
48128,10682,5138,5544,2981,2468,3241,1992
48130,14420,7127,7293,4353,2768,4928,2371
48131,6764,3380,3384,1916,1750,1971,1127
48133,5753,2879,2874,1493,1237,1820,1203
48134,21408,10467,10941,6278,5341,6449,3340
48135,27665,13576,14089,6974,6900,8542,5249
48137,4796,2443,2353,1248,951,1656,941
48138,10371,5079,5292,2460,1354,3619,2938
48139,206,106,100,37,42,69,58
48140,3095,1581,1514,854,627,1056,558
48141,25366,11883,13483,7945,6662,6593,4166
48143,32,17,15,6,4,12,10
48144,9952,4955,4997,2664,1869,3274,2145
48145,3503,1804,1699,820,695,1257,731
48146,38098,18686,19412,10496,10550,10801,6251
48150,27127,13094,14033,6569,6520,8445,5593
48152,31173,14987,16186,7017,6482,10236,7438
48154,38642,18778,19864,8946,7178,12569,9949
48157,1436,693,743,372,325,479,260
48158,7309,3630,3679,1815,1257,2610,1627
48159,2582,1313,1269,721,591,869,401
48160,13785,7625,6160,3480,3696,4424,2185
48161,26470,12953,13517,7349,6587,7649,4885
48162,29344,14009,15335,7748,7006,8490,6100
48164,9175,4659,4516,2437,1865,3246,1627
48165,6339,3163,3176,1734,1725,2002,878
48166,11569,5822,5747,3526,3015,3409,1619
48167,21534,10187,11347,4995,4813,6855,4871
48168,21781,10608,11173,6145,3697,7350,4589
48169,20813,10519,10294,5570,4012,7439,3792
48170,39963,19406,20557,9476,8480,12647,9360
48173,12700,6387,6313,3486,3069,3964,2181
48174,31515,15361,16154,9268,8126,9278,4843
48176,21447,10560,10887,6208,4008,7298,3933
48177,218,97,121,60,60,63,35
48178,29320,14264,15056,8431,5831,9720,5338
48179,3274,1674,1600,773,758,1131,612
48180,63131,30215,32916,17497,16792,17488,11354
48182,21708,10585,11123,5613,4430,7028,4637
48183,43182,20874,22308,11026,9774,13064,9318
48184,17643,8510,9133,4641,4561,5218,3223
48185,47618,21932,25686,10766,13494,13357,10001
48186,36506,18024,18482,9983,9944,10579,6000
48187,49148,23958,25190,14189,12341,14771,7847
48188,41025,20094,20931,12527,10549,12684,5265
48189,13632,6852,6780,3415,3372,4707,2138
48190,107,53,54,21,16,48,22
48191,4054,2010,2044,1142,883,1327,702
48192,25883,12667,13216,6212,6576,8066,5029
48193,15623,7315,8308,3671,3512,4312,4128
48195,30047,14353,15694,6852,7836,8705,6654
48197,61132,29910,31222,17233,22125,14650,7124
48198,38186,18238,19948,10726,11529,9990,5941
48201,12814,6556,6258,2328,4587,3566,2333
48202,16603,8146,8457,4198,4987,4541,2877
48203,28409,13772,14637,8144,6722,8251,5292
48204,27997,12860,15137,8009,6846,7572,5570
48205,44045,20683,23362,16512,11951,11339,4243
48206,21954,10382,11572,6207,5322,6124,4301
48207,20252,9154,11098,4202,5200,5832,5018
48208,10234,5070,5164,2730,2892,3069,1543
48209,32262,16682,15580,12049,10196,7019,2998
48210,31017,15702,15315,11891,9452,6571,3103
48211,7082,3803,3279,2278,1991,1813,1000
48212,39038,20529,18509,12899,11751,9513,4875
48213,27712,13198,14514,8655,7041,7189,4827
48214,22759,10452,12307,5486,4870,6853,5550
48215,13565,6330,7235,4032,3168,3803,2562
48216,5645,2882,2763,1484,1739,1589,833
48217,8210,3864,4346,2243,1930,2287,1750
48218,7903,3718,4185,2580,2033,2024,1266
48219,46931,21612,25319,13602,11942,13012,8375
48220,22319,10944,11375,4405,8454,6266,3194
48221,38727,17205,21522,10766,8651,10194,9116
48223,25336,11713,13623,7988,6526,7236,3586
48224,44439,20598,23841,15721,11634,12183,4901
48225,14554,6731,7823,4218,3666,4167,2503
48226,5302,3038,2264,379,2158,1675,1090
48227,45380,21219,24161,13903,11567,11823,8087
48228,52130,24540,27590,18018,13982,13126,7004
48229,9556,4519,5037,2878,2446,2556,1676
48230,16976,8114,8862,4834,2970,5681,3491
48233,0,0,0,0,0,0,0
48234,36140,16781,19359,11490,9285,9432,5933
48235,45063,20202,24861,12333,10524,11965,10241
48236,30607,14773,15834,8023,5105,9773,7706
48237,29319,13228,16091,8253,7441,8083,5542
48238,31743,14720,17023,9311,7743,8519,6170
48239,35524,17116,18408,9782,9206,10793,5743
48240,17722,8693,9029,4672,5039,5112,2899
48242,0,0,0,0,0,0,0
48243,0,0,0,0,0,0,0
48301,14127,6822,7305,3741,1727,4725,3934
48302,15360,7528,7832,3451,2184,4887,4838
48304,16009,7656,8353,3673,1976,5050,5310
48306,26691,13116,13575,7998,4334,9535,4824
48307,41369,19853,21516,10931,11366,12125,6947
48309,29135,13959,15176,7580,6190,8553,6812
48310,42766,21055,21711,10649,11249,12146,8722
48312,32720,15586,17134,7540,7979,9235,7966
48313,33952,16413,17539,8368,8588,10172,6824
48314,20245,9802,10443,4837,4943,6152,4313
48315,26563,12684,13879,6413,4990,8393,6767
48316,25404,12522,12882,6442,5443,8031,5488
48317,26610,13301,13309,6713,8176,7537,4184
48320,4589,2298,2291,1183,1205,1492,709
48322,31265,14749,16516,7710,5883,9300,8372
48323,17708,8665,9043,4590,2867,5702,4549
48324,17350,8722,8628,4818,3120,6112,3300
48326,20298,10030,10268,4703,7371,5114,3110
48327,21559,10645,10914,5470,5966,6656,3467
48328,24960,12104,12856,6346,6962,7229,4423
48329,25009,12311,12698,6326,5842,7947,4894
48331,21503,10282,11221,5294,4251,7066,4892
48334,18540,8495,10045,4297,3710,5560,4973
48335,22398,10495,11903,4944,7189,5775,4490
48336,25486,12123,13363,6200,6049,8111,5126
48340,24307,11679,12628,7992,7411,5941,2963
48341,17139,8615,8524,4408,4947,4903,2881
48342,18407,9063,9344,5922,4911,5043,2531
48346,22567,11052,11515,6096,5151,7025,4295
48348,23387,11696,11691,7248,4034,8438,3667
48350,7100,3587,3513,1974,1310,2605,1211
48353,6481,3240,3241,1854,1240,2090,1297
48356,8407,4236,4171,2202,1754,2977,1474
48357,8170,4107,4063,2253,1559,2903,1455
48359,8044,3997,4047,2525,1957,2543,1019
48360,11651,5755,5896,3680,2376,3960,1635
48362,15141,7497,7644,4200,3465,5147,2329
48363,4978,2531,2447,1376,760,1827,1015
48367,4727,2410,2317,1201,955,1705,866
48370,1685,873,812,417,242,627,399
48371,23155,11497,11658,6960,5089,7548,3558
48374,14049,7051,6998,4807,2328,5624,1290
48375,21801,10502,11299,5915,5349,6926,3611
48377,15244,7218,8026,3415,4841,3890,3098
48380,7404,3717,3687,2149,1193,2659,1403
48381,12605,6094,6511,3231,2546,4374,2454
48382,21945,10897,11048,6651,4248,7771,3275
48383,12701,6370,6331,3764,2721,4390,1826
48386,17434,8599,8835,4445,3522,5999,3468
48390,22898,11186,11712,5525,5650,7453,4270
48393,16111,8034,8077,4538,4869,4942,1762
48397,0,0,0,0,0,0,0
48401,1439,723,716,352,277,467,343
48411,156,74,82,42,34,45,35
48412,5682,2896,2786,1461,1128,1936,1157
48413,7551,3612,3939,1866,1523,2286,1876
48414,2492,1302,1190,652,483,875,482
48415,9471,4678,4793,2464,2034,2970,2003
48416,5002,2505,2497,1460,1090,1549,903
48417,2983,1508,1475,833,647,985,518
48418,4312,2186,2126,1284,916,1368,744
48419,2740,1386,1354,710,569,812,649
48420,22078,11002,11076,5533,4972,6678,4895
48421,6647,3326,3321,1693,1407,2170,1377
48422,6400,3200,3200,1786,1365,1882,1367
48423,32708,15611,17097,8758,8050,9300,6600
48426,1022,536,486,288,234,290,210
48427,2879,1413,1466,721,580,803,775
48428,5027,2586,2441,1331,861,1837,998
48429,8944,4392,4552,2383,1934,2709,1918
48430,36738,18037,18701,9826,8045,11497,7370
48432,636,341,295,153,110,213,160
48433,26497,12626,13871,6780,5093,8028,6596
48434,104,51,53,16,10,33,45
48435,2083,1067,1016,585,446,645,407
48436,3764,1921,1843,1044,777,1298,645
48437,581,256,325,123,118,177,163
48438,6951,3536,3415,2074,1200,2512,1165
48439,49209,23686,25523,13885,12085,13941,9298
48440,157,76,81,44,31,50,32
48441,4085,2045,2040,984,760,1174,1167
48442,20669,10283,10386,5585,4776,6636,3672
48444,9327,4599,4728,2791,2143,2783,1610
48445,1370,705,665,327,274,414,355
48446,30749,15457,15292,8005,6647,9755,6342
48449,3147,1578,1569,837,685,944,681
48450,4780,2284,2496,954,742,1467,1617
48451,14767,7342,7425,4249,3168,4577,2773
48453,5146,2530,2616,1453,1104,1474,1115
48454,1324,683,641,356,279,433,256
48455,7974,4027,3947,1998,1272,2913,1791
48456,858,439,419,205,192,283,178
48457,8436,4178,4258,2306,1895,2540,1695
48458,20538,9858,10680,5874,4898,5819,3947
48460,2330,1138,1192,566,493,735,536
48461,8428,4246,4182,2594,1855,2663,1316
48462,13266,6740,6526,3685,2513,5035,2033
48463,4627,2329,2298,1119,878,1577,1053
48464,2231,1147,1084,556,499,744,432
48465,629,328,301,137,111,184,197
48466,1578,811,767,422,343,486,327
48467,2337,1176,1161,348,303,786,900
48468,1294,676,618,233,176,374,511
48469,1245,576,669,214,184,361,486
48470,784,397,387,212,176,209,187
48471,5745,2731,3014,1408,1247,1754,1336
48472,1912,955,957,563,415,542,392
48473,22507,10814,11693,5759,4964,6651,5133
48475,2766,1385,1381,753,562,849,602
48476,577,280,297,168,137,172,100
48502,1164,826,338,167,663,282,52
48503,25168,12053,13115,6958,6643,6938,4629
48504,30926,14571,16355,10241,7893,8005,4787
48505,25710,12161,13549,8564,6215,6350,4581
48506,30019,14812,15207,8773,7656,8857,4733
48507,30607,14462,16145,8608,8350,8018,5631
48509,9470,4663,4807,2270,2099,2990,2111
48519,7465,3545,3920,1811,1851,2152,1651
48529,10271,5044,5227,3095,2842,2950,1384
48532,19375,9004,10371,4942,4522,5629,4282
48551,0,0,0,0,0,0,0
48553,0,0,0,0,0,0,0
48554,0,0,0,0,0,0,0
48601,38406,17766,20640,12239,8828,10124,7215
48602,30119,14482,15637,9029,8364,7977,4749
48603,26913,12686,14227,6062,6684,7237,6930
48604,13074,6163,6911,4124,3888,2880,2182
48607,1774,900,874,411,377,590,396
48609,12461,6080,6381,2845,2246,3891,3479
48610,3083,1561,1522,558,524,998,1003
48611,6554,3253,3301,1747,1418,1994,1395
48612,9259,4717,4542,2170,1784,2798,2507
48613,1158,609,549,333,246,348,231
48614,1376,696,680,377,340,383,276
48615,3058,1514,1544,864,658,933,603
48616,7513,3738,3775,1928,1589,2251,1745
48617,8857,4318,4539,2502,2082,2412,1861
48618,5393,2666,2727,1388,1177,1622,1206
48619,465,242,223,69,60,166,170
48621,1359,647,712,304,193,383,479
48622,6491,3207,3284,1571,1312,1913,1695
48623,13993,7733,6260,3585,3674,4401,2333
48624,15810,7821,7989,3512,2709,4334,5255
48625,13152,6682,6470,2884,2555,4024,3689
48626,6078,3009,3069,1599,1185,1969,1325
48627,141,70,71,13,18,35,75
48628,1938,998,940,415,354,636,533
48629,7854,3908,3946,1403,1264,2290,2897
48630,69,31,38,12,12,20,25
48631,4643,2358,2285,1108,964,1514,1057
48632,5125,2594,2531,1094,911,1467,1653
48633,210,103,107,13,22,66,109
48634,4371,2222,2149,990,908,1415,1058
48635,1573,799,774,284,214,476,599
48636,864,436,428,166,128,263,307
48637,3359,1677,1682,834,719,1032,774
48638,12922,5988,6934,2940,2991,3554,3437
48640,32690,15990,16700,8735,7866,9400,6689
48642,32277,15737,16540,8869,7585,9768,6055
48647,4420,2226,2194,1138,791,1300,1191
48649,1576,785,791,388,315,509,364
48650,7253,3663,3590,1784,1510,2260,1699
48651,4690,2311,2379,821,644,1340,1885
48652,1548,791,757,371,299,532,346
48653,10293,5206,5087,1958,1482,3218,3635
48654,2521,1272,1249,537,417,786,781
48655,6460,3225,3235,1687,1340,2002,1431
48656,4058,2034,2024,733,618,1199,1508
48657,7981,3963,4018,1905,1514,2639,1923
48658,5138,2548,2590,1313,1114,1507,1204
48659,2850,1493,1357,728,644,860,618
48661,10691,5196,5495,2568,2061,3068,2994
48662,1594,807,787,423,325,490,356
48667,0,0,0,0,0,0,0
48701,1368,682,686,354,330,391,293
48703,3238,1653,1585,571,514,967,1186
48705,535,291,244,52,62,167,254
48706,40596,19524,21072,9676,9165,11790,9965
48708,27262,13340,13922,7298,7015,7680,5269
48710,0,0,0,0,0,0,0
48720,1042,548,494,232,209,346,255
48721,411,218,193,64,48,139,160
48722,3123,1558,1565,708,624,970,821
48723,12479,6239,6240,3013,2823,3701,2942
48724,359,160,199,113,88,90,68
48725,2464,1203,1261,379,338,710,1037
48726,6172,3062,3110,1640,1296,1757,1479
48727,1269,667,602,354,276,386,253
48728,290,145,145,33,28,105,124
48729,1586,792,794,440,315,514,317
48730,4716,2216,2500,922,680,1431,1683
48731,1683,832,851,465,374,482,362
48732,11483,5507,5976,2768,2523,3344,2848
48733,1758,894,864,446,357,515,440
48734,7444,3514,3930,1716,1160,2175,2393
48735,1051,534,517,283,223,301,244
48737,1245,647,598,182,128,382,553
48738,1269,644,625,154,142,338,635
48739,4043,2068,1975,716,604,1135,1588
48740,2556,1257,1299,484,332,803,937
48741,2086,1057,1029,571,471,611,433
48742,1647,817,830,294,229,465,659
48743,63,35,28,11,8,18,26
48744,4615,2315,2300,1175,887,1441,1112
48745,1346,691,655,264,188,462,432
48746,8528,4304,4224,2253,1772,2693,1810
48747,1494,760,734,377,335,467,315
48748,1693,862,831,280,231,512,670
48749,1094,555,539,247,207,346,294
48750,8846,4374,4472,1773,1532,2551,2990
48754,1001,511,490,281,202,307,211
48755,3110,1557,1553,580,506,898,1126
48756,4640,2374,2266,1090,935,1354,1261
48757,3817,1892,1925,927,824,1174,892
48759,3293,1619,1674,772,676,1008,837
48760,1351,701,650,400,324,381,246
48761,1026,543,483,153,120,295,458
48762,1139,583,556,217,162,300,460
48763,5012,2453,2559,978,791,1526,1717
48765,725,366,359,155,107,239,224
48766,1270,661,609,300,236,444,290
48767,2162,1083,1079,535,476,626,525
48768,9832,4946,4886,2790,2141,2995,1906
48770,1891,956,935,450,334,581,526
48801,12923,6145,6778,3625,3507,3122,2669
48806,1676,841,835,433,347,486,410
48807,916,471,445,235,203,289,189
48808,5178,2548,2630,1348,1267,1562,1001
48809,11015,5422,5593,3223,2634,3287,1871
48811,5641,3961,1680,991,1939,1878,833
48813,21182,10474,10708,5676,4864,6319,4323
48815,2259,1167,1092,646,604,645,364
48816,121,63,58,29,27,51,14
48817,6422,3119,3303,1675,1419,1881,1447
48818,2407,1188,1219,659,535,701,512
48819,2701,1363,1338,785,543,918,455
48820,16641,8172,8469,4905,3374,5454,2908
48821,5836,2835,3001,1178,906,2060,1692
48822,2714,1397,1317,671,476,973,594
48823,51302,24904,26398,8678,28061,7610,6953
48825,12596,5886,6710,8789,3804,3,0
48827,15971,7904,8067,4570,3422,5089,2890
48829,3254,1602,1652,853,692,966,743
48831,3512,1778,1734,983,719,1053,757
48832,1393,690,703,334,291,432,336
48834,2090,1059,1031,550,458,628,454
48835,2680,1362,1318,855,556,723,546
48836,13510,6831,6679,4036,3297,4256,1921
48837,18926,9227,9699,4938,4062,6102,3824
48838,17863,8790,9073,5035,4299,5078,3451
48840,12501,5885,6616,2831,3211,3834,2625
48841,826,420,406,215,172,268,171
48842,20432,9786,10646,5617,5090,6221,3504
48843,42931,21251,21680,12632,10044,13361,6894
48845,1003,514,489,263,199,316,225
48846,20269,12486,7783,4674,7021,5658,2916
48847,6041,2986,3055,1569,1384,1728,1360
48848,7789,3899,3890,2226,1558,2615,1390
48849,5717,2819,2898,1593,1244,1728,1152
48850,4474,2240,2234,1251,995,1204,1024
48851,2365,1236,1129,676,518,766,405
48852,150,73,77,49,29,42,30
48853,671,346,325,214,154,186,117
48854,18598,9352,9246,4690,4348,5840,3720
48855,14752,7382,7370,4238,3243,4868,2403
48856,966,484,482,295,252,239,180
48857,2453,1231,1222,679,592,721,461
48858,50025,24118,25907,14039,21862,8554,5570
48860,1334,691,643,371,330,399,234
48861,1522,767,755,428,356,477,261
48864,20148,9652,10496,5022,5357,5992,3777
48865,1903,974,929,542,431,587,343
48866,4851,2347,2504,1393,1069,1396,993
48867,28264,13838,14426,7688,6550,8116,5910
48870,148,75,73,47,43,37,21
48871,1952,972,980,477,376,658,441
48872,7840,3909,3931,2299,1822,2447,1272
48873,1615,819,796,524,329,489,273
48874,180,83,97,75,45,48,12
48875,10186,5053,5133,2988,2398,3034,1766
48876,4014,1969,2045,1200,1000,1223,591
48877,2392,1208,1184,643,538,761,450
48878,1677,805,872,503,390,480,304
48879,18075,8980,9095,5250,4041,5344,3440
48880,10669,7048,3621,2035,3783,3158,1693
48881,5501,2746,2755,1540,1203,1732,1026
48883,7122,3519,3603,1975,1711,2193,1243
48884,4427,2217,2210,1172,972,1362,921
48885,927,490,437,268,212,288,159
48886,2116,1076,1040,550,470,582,514
48888,6366,3195,3171,1604,1421,1893,1448
48889,1322,681,641,343,244,430,305
48890,2152,1062,1090,608,480,670,394
48891,2985,1514,1471,815,657,871,642
48892,4382,2246,2136,1250,1031,1395,706
48893,5212,2597,2615,1413,1157,1526,1116
48894,2059,1025,1034,708,435,479,437
48895,11189,5473,5716,3057,2139,3687,2306
48896,154,61,93,49,45,40,20
48897,1525,780,745,427,309,459,330
48906,26634,13168,13466,7445,7790,7068,4331
48910,34560,16603,17957,8618,12369,8630,4943
48911,40111,18810,21301,11957,11656,10390,6108
48912,17035,8554,8481,3708,6500,4202,2625
48915,9218,4548,4670,2724,2935,2344,1215
48917,32062,15295,16767,7457,8554,8913,7138
48921,0,0,0,0,0,0,0
48933,2530,1394,1136,294,1357,521,358
49001,22095,10790,11305,6518,7313,5335,2929
49002,18786,9106,9680,4762,4928,5193,3903
49004,15645,7617,8028,4101,4088,4366,3090
49006,26455,13235,13220,6801,13203,3412,3039
49007,10762,5505,5257,2772,4436,2362,1192
49008,16186,7881,8305,3650,5778,3569,3189
49009,42362,20551,21811,10797,12543,11043,7979
49010,17374,8666,8708,4650,3961,5289,3474
49011,2285,1145,1140,583,511,661,530
49012,3339,1692,1647,787,597,1228,727
49013,5508,2800,2708,1572,1285,1566,1085
49014,22127,11304,10823,5897,5351,6697,4182
49015,26782,12672,14110,7308,6618,7270,5586
49017,20785,10139,10646,5337,4690,6154,4604
49021,6182,3096,3086,1620,1310,1963,1289
49022,31814,15143,16671,9894,7484,8494,5942
49024,28552,13568,14984,8032,7225,8098,5197
49026,2186,1065,1121,572,446,676,492
49027,161,79,82,46,39,54,22
49028,6387,3235,3152,1910,1513,1833,1131
49029,1606,813,793,411,350,496,349
49030,2523,1314,1209,784,622,649,468
49031,7884,3962,3922,1940,1577,2480,1887
49032,3105,1550,1555,892,777,831,605
49033,1760,908,852,411,309,603,437
49034,2389,1203,1186,605,439,791,554
49036,24868,13552,11316,5822,6222,7361,5463
49037,22576,10862,11714,6642,5831,5819,4284
49038,9310,4609,4701,2340,2039,2810,2121
49040,3388,1685,1703,918,719,951,800
49042,4892,2461,2431,1409,1167,1396,920
49043,2462,1225,1237,846,514,675,427
49045,5598,2785,2813,1554,1269,1625,1150
49046,7281,3655,3626,1836,1359,2321,1765
49047,14805,7214,7591,4025,3340,3980,3460
49048,25432,12338,13094,7454,7174,6738,4066
49050,1557,778,779,382,302,483,390
49051,2436,1211,1225,607,474,818,537
49052,975,518,457,240,232,315,188
49053,7028,3463,3565,2048,1638,2102,1240
49055,6276,3130,3146,1630,1279,2055,1312
49056,4016,2089,1927,1138,924,1167,787
49057,6795,3460,3335,2175,1730,1791,1099
49058,19127,9382,9745,5206,4237,5547,4137
49060,1738,871,867,419,292,584,443
49061,1622,856,766,410,361,513,338
49064,3717,1852,1865,1060,813,1080,764
49065,6662,3273,3389,1847,1390,2049,1376
49066,722,345,377,213,162,174,173
49067,4522,2318,2204,1188,963,1385,986
49068,14646,7094,7552,3778,2991,4406,3471
49070,2451,1247,1204,753,563,705,430
49071,9174,4572,4602,2845,1995,3019,1315
49072,3164,1596,1568,911,634,966,653
49073,4951,2480,2471,1400,1140,1441,970
49074,149,19,130,0,0,7,142
49075,121,68,53,39,34,36,12
49076,4589,2382,2207,1424,1308,1193,664
49078,8902,4378,4524,2419,2016,2726,1741
49079,13606,6764,6842,3720,3152,4145,2589
49080,15802,7838,7964,4315,3470,4793,3224
49082,6579,3298,3281,2011,1446,1879,1243
49083,6961,3409,3552,1834,1246,2384,1497
49084,36,20,16,11,9,11,5
49085,23804,11565,12239,5569,5206,7182,5847
49087,6126,3093,3033,1738,1215,2084,1089
49088,3648,1864,1784,980,760,1148,760
49089,1875,969,906,521,401,613,340
49090,13810,6596,7214,3477,2815,4052,3466
49091,19872,9665,10207,5952,4712,5269,3939
49092,2187,1088,1099,596,461,638,492
49093,18380,9055,9325,4941,4289,5067,4083
49094,4104,2068,2036,1145,897,1167,895
49095,1960,1002,958,429,344,638,549
49096,3316,1724,1592,919,744,1001,652
49097,10326,5185,5141,2733,2257,3225,2111
49098,5966,2944,3022,1662,1323,1738,1243
49099,5629,2839,2790,1426,1193,1760,1250
49101,3104,1568,1536,776,681,1003,644
49102,1563,796,767,402,288,427,446
49103,11082,5531,5551,2693,3107,2997,2285
49104,868,337,531,397,470,1,0
49106,4636,2257,2379,1074,865,1418,1279
49107,10382,5133,5249,2721,2347,3043,2271
49111,3346,1667,1679,879,655,1069,743
49112,10171,5045,5126,2836,2089,3120,2126
49113,1904,964,940,419,418,585,482
49115,294,142,152,39,28,101,126
49116,394,189,205,47,34,128,185
49117,3951,1947,2004,784,639,1244,1284
49119,136,72,64,37,29,50,20
49120,37122,18089,19033,9654,8297,10733,8438
49125,2046,1043,1003,377,345,666,658
49126,1341,662,679,355,277,387,322
49127,10694,5275,5419,2781,2180,3320,2413
49128,3715,1833,1882,850,702,1231,932
49129,609,294,315,92,73,212,232
49130,1659,800,859,352,321,548,438
49201,45190,25815,19375,10455,11898,14477,8360
49202,20661,9792,10869,5716,5885,5005,4055
49203,38280,18113,20167,11221,9376,10072,7611
49220,2290,1139,1151,593,459,722,516
49221,41310,21211,20099,10806,11200,11068,8236
49224,14224,6916,7308,4125,3700,3551,2848
49227,1284,650,634,338,296,406,244
49228,5545,2759,2786,1513,1201,1675,1156
49229,3245,1652,1593,885,695,1077,588
49230,10475,5251,5224,2341,1804,3443,2887
49232,2801,1396,1405,906,588,780,527
49233,2646,1335,1311,629,511,825,681
49234,2579,1294,1285,557,434,894,694
49235,2117,1083,1034,572,470,659,416
49236,4838,2444,2394,1392,985,1501,960
49237,2980,1481,1499,817,571,966,626
49238,1735,866,869,519,381,522,313
49240,8703,4364,4339,2345,1776,2992,1590
49241,2579,1314,1265,762,545,781,491
49242,15248,7329,7919,4175,3874,4009,3190
49245,4845,2409,2436,1454,1082,1390,919
49246,3255,1646,1609,814,552,1106,783
49247,5768,2845,2923,1570,1216,1659,1323
49248,899,471,428,220,212,279,188
49249,3408,1696,1712,775,677,1077,879
49250,6182,3090,3092,1766,1338,1771,1307
49251,6229,3151,3078,1737,1387,2007,1098
49252,2605,1319,1286,683,562,758,602
49253,3166,1631,1535,657,590,1040,879
49254,3321,1672,1649,784,750,1055,732
49255,1939,1004,935,697,419,484,339
49256,3888,1918,1970,1125,909,1070,784
49259,2523,1282,1241,678,554,805,486
49261,290,134,156,87,64,87,52
49262,1280,648,632,336,273,366,305
49263,85,39,46,17,17,33,18
49264,1992,1009,983,547,411,690,344
49265,4958,2488,2470,1320,882,1653,1103
49266,2942,1517,1425,749,629,907,657
49267,4072,2078,1994,1018,792,1366,896
49268,1059,551,508,279,252,319,209
49269,5998,2994,3004,1688,1219,1979,1112
49270,5874,2991,2883,1560,1219,1969,1126
49271,2256,1122,1134,574,444,748,490
49272,2417,1223,1194,580,483,848,506
49274,3670,1875,1795,1081,748,1037,804
49276,1003,501,502,277,214,307,205
49277,3668,1883,1785,982,733,1187,766
49279,797,408,389,211,161,251,174
49282,372,187,185,62,75,112,123
49283,4362,1951,2411,1293,1299,870,900
49284,3028,1524,1504,817,643,962,606
49285,5720,2918,2802,1639,1216,1863,1002
49286,14797,7174,7623,3942,3249,4465,3141
49287,2099,1083,1016,556,412,703,428
49288,1384,705,679,402,304,410,268
49289,167,96,71,37,46,65,19
49301,18701,9280,9421,6337,3017,6621,2726
49302,7585,3898,3687,2321,1507,2617,1140
49303,1129,578,551,391,279,303,156
49304,4328,2196,2132,794,798,1312,1424
49305,2264,1162,1102,528,433,647,656
49306,9244,4618,4626,2620,1796,3128,1700
49307,20112,10120,9992,5562,7917,3725,2908
49309,1843,973,870,358,304,566,615
49310,3016,1547,1469,909,643,907,557
49312,274,140,134,43,55,92,84
49315,19915,9891,10024,5967,4239,5821,3888
49316,20074,9921,10153,6176,4554,5999,3345
49318,1398,717,681,405,299,458,236
49319,16181,8072,8109,4969,4157,4673,2382
49320,21,10,11,4,1,9,7
49321,16241,7938,8303,4674,4642,4567,2358
49322,1212,629,583,340,286,354,232
49323,9410,4700,4710,3075,2261,2964,1110
49325,1909,980,929,582,435,616,276
49326,3752,1957,1795,1000,794,1232,726
49327,8406,4295,4111,2600,1977,2439,1390
49328,3885,2023,1862,1166,913,1230,576
49329,8641,4310,4331,2688,2078,2557,1318
49330,5440,2746,2694,1743,1284,1622,791
49331,16627,8171,8456,4935,3815,5168,2709
49332,3019,1487,1532,620,529,870,1000
49333,11191,5603,5588,3398,2569,3354,1870
49335,314,145,169,102,81,84,47
49336,4352,2218,2134,1391,998,1217,746
49337,12088,6083,6005,3263,2420,3574,2831
49338,1842,937,905,474,412,581,375
49339,2283,1153,1130,623,513,765,382
49340,2912,1464,1448,760,631,849,672
49341,33737,16658,17079,10950,7021,10826,4940
49342,1649,811,838,433,363,471,382
49343,5489,2764,2725,1601,1265,1700,923
49344,3410,1749,1661,858,721,1128,703
49345,13040,6441,6599,3910,3100,3841,2189
49346,5446,2705,2741,1196,895,1360,1995
49347,1257,626,631,310,249,382,316
49348,12153,6032,6121,3653,2908,3586,2006
49349,8087,4169,3918,2178,1803,2414,1692
49401,20735,9412,11323,7884,9193,2536,1122
49402,1380,739,641,234,192,445,509
49403,2473,1259,1214,676,546,806,445
49404,8269,4080,4189,2511,2015,2370,1373
49405,1559,803,756,372,313,502,372
49406,884,455,429,139,84,345,316
49408,9091,4582,4509,2488,1867,2852,1884
49410,2005,1035,970,498,406,623,478
49411,1538,819,719,332,286,506,414
49412,11065,5311,5754,3035,2290,3055,2685
49415,6480,3205,3275,1692,1317,2145,1326
49417,29183,14322,14861,7927,6394,9026,5836
49418,27417,13313,14104,7854,7104,7558,4901
49419,7791,3987,3804,2561,1819,2394,1017
49420,6420,3193,3227,1917,1377,1714,1412
49421,5991,3043,2948,1672,1228,1797,1294
49423,44977,21679,23298,12927,12404,11293,8353
49424,44760,22338,22422,13918,11558,12309,6975
49425,3660,1887,1773,1060,814,1119,667
49426,33244,16453,16791,11029,7952,9215,5048
49428,25420,12320,13100,7349,6037,6788,5246
49431,16875,8097,8778,4072,3401,4795,4607
49434,20,12,8,0,3,3,14
49435,3549,1778,1771,1007,745,1154,643
49436,1622,840,782,284,273,480,585
49437,6902,3362,3540,1834,1361,2081,1626
49440,953,461,492,209,289,254,201
49441,36308,17415,18893,9178,8456,10339,8335
49442,41214,19718,21496,12686,11110,10536,6882
49444,29456,15996,13460,7913,8445,8335,4763
49445,20784,10212,10572,5641,4435,6317,4391
49446,2321,1143,1178,663,450,715,493
49448,3410,1781,1629,902,780,1120,608
49449,2675,1312,1363,459,385,722,1109
49450,3302,1664,1638,1234,814,848,406
49451,6012,3039,2973,1765,1441,1836,970
49452,1952,997,955,568,492,588,304
49453,2626,1340,1286,543,429,964,690
49454,4574,2298,2276,1270,944,1387,973
49455,5034,2504,2530,1501,1074,1363,1096
49456,18581,8932,9649,4814,3664,5637,4466
49457,10565,5336,5229,3114,2594,3196,1661
49458,119,61,58,25,23,34,37
49459,1351,684,667,379,295,378,299
49460,8126,4276,3850,2392,1815,2636,1283
49461,8929,4383,4546,2333,1743,2769,2084
49464,27481,13466,14015,8946,6701,7492,4342
49503,35940,18434,17506,9110,15031,7807,3992
49504,39994,19864,20130,10775,13107,9346,6766
49505,31216,15056,16160,7928,9491,7699,6098
49506,31354,14926,16428,9080,8828,8341,5105
49507,35459,17269,18190,13026,10975,8053,3405
49508,39148,18519,20629,11415,10722,10310,6701
49509,26720,13187,13533,8331,8151,6686,3552
49512,15448,7571,7877,4006,5613,3517,2312
49519,27424,13408,14016,7510,9228,7006,3680
49525,27383,13128,14255,7672,6439,8216,5056
49534,21570,10567,11003,5704,6200,6059,3607
49544,8944,4337,4607,2198,2803,2418,1525
49546,31880,14908,16972,9125,7074,8363,7318
49548,30524,15163,15361,8950,8977,8485,4112
49601,21236,10449,10787,5394,4818,6143,4881
49611,236,112,124,70,46,68,52
49612,1121,562,559,216,174,350,381
49613,680,337,343,115,82,173,310
49614,2790,1407,1383,685,471,838,796
49615,4131,2013,2118,820,620,1209,1482
49616,1974,940,1034,485,371,568,550
49617,3363,1716,1647,673,579,1024,1087
49618,761,395,366,204,163,225,169
49619,1110,560,550,242,182,341,345
49620,2445,1253,1192,708,600,733,404
49621,3096,1574,1522,746,492,1085,773
49622,2494,1240,1254,524,431,797,742
49623,1164,601,563,268,266,343,287
49625,1379,710,669,340,248,469,322
49626,421,201,220,89,71,138,123
49627,206,96,110,12,17,65,112
49628,372,193,179,79,69,117,107
49629,2223,1051,1172,445,295,615,868
49630,1429,708,721,246,178,477,528
49631,6357,3169,3188,1684,1250,1769,1654
49632,1126,575,551,268,215,352,291
49633,3703,1908,1795,902,740,1152,909
49634,116,60,56,33,29,30,24
49635,3350,1614,1736,605,460,897,1388
49636,560,267,293,102,50,103,305
49637,3405,1701,1704,921,839,1035,610
49638,824,436,388,158,120,312,234
49639,2557,1292,1265,717,543,706,591
49640,1618,797,821,321,269,472,556
49642,842,413,429,187,132,236,287
49643,6253,3163,3090,1696,1546,1971,1040
49644,2033,1081,952,311,257,631,834
49645,1632,803,829,406,298,529,399
49646,8229,4114,4115,2067,1868,2394,1900
49648,2098,1037,1061,378,290,599,831
49649,7789,4541,3248,2113,2359,2381,936
49650,3144,1563,1581,907,744,986,507
49651,7665,3888,3777,1884,1511,2204,2066
49653,1922,969,953,443,325,551,603
49654,690,336,354,89,50,194,357
49655,3173,1608,1565,844,654,927,748
49656,1534,777,757,329,263,483,459
49657,3683,1829,1854,1145,795,1009,734
49659,6801,3405,3396,1875,1430,1996,1500
49660,14066,7437,6629,2857,3147,4283,3779
49663,5874,2968,2906,1790,1273,1694,1117
49664,2067,1033,1034,411,344,682,630
49665,4413,2210,2203,1211,924,1283,995
49666,106,56,50,26,29,38,13
49667,549,290,259,129,102,177,141
49668,3625,1896,1729,980,739,1125,781
49670,1891,925,966,278,222,536,855
49674,110,55,55,17,5,25,63
49675,1030,488,542,175,107,322,426
49676,3407,1726,1681,786,601,1085,935
49677,6631,3223,3408,1737,1456,1826,1612
49679,1428,728,700,366,254,431,377
49680,1916,992,924,565,422,588,341
49682,4253,2067,2186,1017,688,1306,1242
49683,1939,996,943,459,364,623,493
49684,37963,18214,19749,9301,8722,11497,8443
49686,32056,15529,16527,7619,7264,9536,7637
49688,2703,1374,1329,707,501,896,599
49689,1560,814,746,269,217,538,536
49690,6182,3051,3131,1414,1005,2093,1670
49701,1036,461,575,197,173,312,354
49705,937,478,459,271,217,288,161
49706,4585,2319,2266,1151,1020,1445,969
49707,22701,11028,11673,5241,4630,6776,6054
49709,3618,1846,1772,617,535,1054,1412
49710,409,218,191,61,43,122,183
49712,7890,3946,3944,1979,1539,2451,1921
49713,1864,948,916,488,377,601,398
49715,3130,1522,1608,898,652,890,690
49716,806,416,390,182,130,249,245
49717,72,35,37,8,4,20,40
49718,701,345,356,138,117,206,240
49719,1362,683,679,241,217,400,504
49720,9172,4431,4741,2080,1692,2839,2561
49721,14436,7112,7324,3288,2728,4277,4143
49722,220,115,105,51,55,66,48
49724,1146,583,563,294,246,381,225
49725,766,387,379,121,89,204,352
49726,1058,542,516,146,127,312,473
49727,7145,3526,3619,1838,1399,2158,1750
49728,334,177,157,66,52,117,99
49729,1446,734,712,343,247,483,373
49730,2187,1107,1080,567,465,724,431
49733,1965,968,997,444,331,639,551
49735,19515,9574,9941,5093,4111,5871,4440
49736,578,280,298,97,79,158,244
49738,9924,4939,4985,2237,1756,3108,2823
49740,7042,3435,3607,1491,1111,2228,2212
49743,769,399,370,158,111,256,244
49744,823,405,418,211,158,271,183
49745,1089,556,533,217,167,367,338
49746,3685,1871,1814,763,633,1149,1140
49747,1921,973,948,362,280,567,712
49748,170,88,82,21,19,59,71
49749,4283,2143,2140,904,680,1293,1406
49751,2087,1076,1011,444,349,687,607
49752,515,267,248,119,96,188,112
49753,2057,1060,997,481,338,652,586
49755,1892,971,921,448,349,592,503
49756,3857,1945,1912,665,518,1158,1516
49757,492,260,232,94,131,166,101
49759,1682,854,828,331,221,480,650
49760,713,354,359,121,101,260,231
49762,639,330,309,90,70,208,271
49764,139,72,67,40,34,49,16
49765,4154,2061,2093,949,759,1255,1191
49766,2417,1213,1204,577,434,810,596
49768,476,240,236,72,45,169,190
49769,1644,829,815,499,364,486,295
49770,16862,8220,8642,4378,3924,4962,3598
49774,1851,960,891,465,343,569,474
49775,95,48,47,8,8,22,57
49776,1888,958,930,418,327,601,542
49777,1640,848,792,215,186,520,719
49779,4639,2287,2352,820,767,1431,1621
49780,1946,983,963,559,369,607,411
49781,4020,1977,2043,952,829,1284,955
49782,657,340,317,104,67,240,246
49783,19668,9691,9977,5008,5524,5180,3956
49788,6609,5351,1258,1011,3037,2159,402
49791,329,149,180,63,58,96,112
49793,322,173,149,49,43,101,129
49795,2097,1043,1054,501,379,663,554
49796,320,164,156,63,50,96,111
49799,2327,1231,1096,585,467,720,555
49801,11424,5651,5773,2710,2142,3717,2855
49802,6230,2952,3278,1488,1311,1784,1647
49805,336,168,168,78,49,106,103
49806,627,311,316,99,95,217,216
49807,3390,1757,1633,813,652,1090,835
49808,352,186,166,37,40,112,163
49812,925,482,443,210,164,313,238
49814,1429,741,688,340,248,482,359
49815,488,253,235,108,54,175,151
49816,724,363,361,170,132,254,168
49817,615,325,290,128,91,215,181
49818,988,518,470,210,156,336,286
49819,36,20,16,8,5,13,10
49820,382,185,197,67,65,136,114
49821,1354,716,638,335,244,434,341
49822,220,108,112,33,22,97,68
49825,299,146,153,81,51,95,72
49826,137,69,68,27,19,61,30
49827,897,474,423,226,163,236,272
49829,17347,8360,8987,4224,3875,4975,4273
49831,780,404,376,180,137,256,207
49833,266,133,133,53,46,89,78
49834,284,151,133,81,53,76,74
49835,802,418,384,153,115,250,284
49836,938,482,456,172,124,295,347
49837,9795,4844,4951,2374,1838,3064,2519
49838,504,266,238,83,67,160,194
49839,479,266,213,38,42,139,260
49840,771,395,376,137,113,287,234
49841,7016,3492,3524,1879,1714,2030,1393
49847,998,498,500,234,178,321,265
49848,128,70,58,20,29,48,31
49849,12242,6038,6204,2947,2814,3663,2818
49852,120,58,62,28,26,28,38
49853,1278,653,625,239,190,392,457
49854,6469,3155,3314,1473,1140,1985,1871
49855,33561,17210,16351,7210,11168,8776,6407
49858,12088,5991,6097,2722,2357,3823,3186
49861,616,324,292,102,77,221,216
49862,5025,2901,2124,884,1383,1488,1270
49863,130,62,68,38,36,30,26
49864,54,27,27,7,7,19,21
49866,8034,3953,4081,2074,1884,2374,1702
49868,5409,3203,2206,1066,1518,1663,1162
49870,3329,1621,1708,839,710,951,829
49871,510,258,252,124,111,178,97
49872,206,107,99,50,43,57,56
49873,120,64,56,28,24,37,31
49874,1126,540,586,234,182,340,370
49876,1240,622,618,292,226,450,272
49877,67,36,31,12,3,23,29
49878,3583,1871,1712,693,512,1202,1176
49879,1038,533,505,193,135,346,364
49880,1142,590,552,233,197,389,323
49881,345,184,161,69,58,131,87
49883,151,83,68,23,26,38,64
49884,552,281,271,115,95,189,153
49885,1897,971,926,442,355,667,433
49886,435,216,219,107,76,127,125
49887,2474,1249,1225,540,381,775,778
49891,816,421,395,195,144,228,249
49892,1948,1004,944,395,301,740,512
49893,1784,928,856,381,273,649,481
49894,680,332,348,140,121,204,215
49895,765,378,387,138,83,282,262
49896,1749,895,854,544,433,495,277
49901,346,166,180,75,65,112,94
49902,145,73,72,21,16,54,54
49903,133,68,65,30,21,44,38
49905,2005,1043,962,741,472,524,268
49908,3292,2046,1246,704,1089,960,539
49910,385,196,189,54,42,122,167
49911,2744,1386,1358,625,519,854,746
49912,1081,564,517,173,174,372,362
49913,7248,3672,3576,2101,1521,1960,1666
49915,630,311,319,168,127,168,167
49916,2765,1423,1342,753,544,807,661
49917,205,101,104,61,34,63,47
49918,120,65,55,11,22,37,50
49919,242,122,120,40,30,66,106
49920,4273,2137,2136,738,578,1346,1611
49921,360,220,140,81,139,91,49
49922,1043,531,512,291,234,294,224
49925,494,258,236,79,73,191,151
49927,483,227,256,94,88,155,146
49929,216,116,100,40,38,56,82
49930,6987,3508,3479,1729,2101,1579,1578
49931,9630,6029,3601,2691,4501,1304,1134
49934,900,433,467,200,172,282,246
49935,6096,2979,3117,1191,1022,1840,2043
49938,7945,3894,4051,1752,1611,2300,2282
49942,156,73,83,42,35,34,45
49945,2621,1359,1262,583,478,765,795
49946,4040,1990,2050,1007,805,1195,1033
49947,1818,1514,304,108,786,604,320
49948,590,329,261,119,94,182,195
49950,1121,587,534,209,182,303,427
49952,143,82,61,32,23,55,33
49953,2879,1446,1433,519,394,959,1007
49955,371,199,172,100,93,89,89
49958,1270,691,579,282,254,404,330
49959,344,177,167,71,61,103,109
49960,185,97,88,32,29,56,68
49961,107,52,55,15,9,29,54
49962,260,144,116,26,24,87,123
49963,1024,522,502,257,252,262,253
49965,440,241,199,55,80,143,162
49967,492,256,236,68,59,162,203
49968,2247,1107,1140,406,400,657,784
49969,1401,723,678,260,167,421,553
49970,243,130,113,41,31,72,99
49971,483,240,243,82,54,152,195
54540,16,9,7,0,0,6,10
54554,10,5,5,0,2,3,5
51360,93,53,40,10,14,25,44
55001,2916,1458,1458,689,392,1146,689
55003,3471,2513,958,445,1503,997,526
55005,4422,2313,2109,1353,1157,1460,452
55006,4069,2012,2057,1216,1048,1106,699
55007,2498,1285,1213,671,482,846,499
55008,14685,7184,7501,4081,3641,4042,2921
55009,8030,4028,4002,2066,1655,2582,1727
55011,10170,5324,4846,2981,2237,3758,1194
55012,2078,1075,1003,487,456,753,382
55013,6541,3179,3362,1733,1310,2001,1497
55014,27274,14316,12958,7687,6956,9730,2901
55016,34204,17064,17140,10820,9004,9955,4425
55017,714,359,355,189,139,271,115
55018,997,526,471,257,160,388,192
55019,1817,924,893,519,487,529,282
55020,3717,1889,1828,1308,875,1184,350
55021,29732,15918,13814,8129,7709,8481,5413
55024,32406,16288,16118,11266,9624,8774,2742
55025,23244,11670,11574,6501,5456,7228,4059
55026,455,242,213,107,72,172,104
55027,3031,1549,1482,989,758,822,462
55029,38,22,16,10,9,9,10
55030,1289,684,605,321,261,427,280
55031,2035,1059,976,574,506,636,319
55032,3616,1888,1728,970,782,1296,568
55033,29488,14620,14868,7835,7171,8909,5573
55036,71,39,32,18,15,18,20
55037,4940,2523,2417,1341,1094,1414,1091
55038,20816,10380,10436,6759,5559,6207,2291
55040,12568,6494,6074,3798,3501,3616,1653
55041,7601,3749,3852,1770,1467,2249,2115
55042,8840,4438,4402,2631,1471,3248,1490
55043,3540,1800,1740,852,686,1309,693
55044,47218,23686,23532,16157,10263,15970,4828
55045,7577,3809,3768,2091,1533,2439,1514
55046,5211,2692,2519,1732,1589,1338,552
55047,2528,1285,1243,577,261,1028,662
55049,2476,1264,1212,790,575,695,416
55051,9719,4834,4885,2485,2098,2769,2367
55052,2090,1061,1029,537,465,642,446
55053,1009,505,504,295,197,339,178
55054,2171,1115,1056,848,827,406,90
55055,3418,1750,1668,925,897,1028,568
55056,13546,6831,6715,4180,3412,3991,1963
55057,24602,11841,12761,7261,7280,5930,4131
55060,28911,14219,14692,8276,6846,8221,5568
55063,9348,4773,4575,2331,2134,2756,2127
55065,1201,631,570,362,269,398,172
55066,18564,9090,9474,4576,4169,5392,4427
55068,27490,13662,13828,8842,7041,8377,3230
55069,5540,3288,2252,1223,1687,1669,961
55070,7541,3733,3808,2546,2256,1989,750
55071,5569,2808,2761,1573,1516,1628,852
55072,4737,2999,1738,908,1628,1349,852
55073,3237,1628,1609,848,521,1190,678
55074,2222,1163,1059,673,605,678,266
55075,20152,9919,10233,5224,5712,5830,3386
55076,21323,10081,11242,5308,5543,6507,3965
55077,12572,6174,6398,3716,3094,3922,1840
55079,8329,4345,3984,2291,1793,3114,1131
55080,2607,1376,1231,674,532,897,504
55082,35024,17335,17689,9463,6504,11980,7077
55084,1628,815,813,423,329,557,319
55085,417,219,198,105,100,149,63
55087,268,138,130,56,62,95,55
55088,1704,893,811,434,285,648,337
55089,1814,932,882,498,353,648,315
55090,401,206,195,91,101,139,70
55092,10840,5516,5324,3091,2351,3754,1644
55101,5592,3064,2528,506,2711,1439,936
55102,18207,9074,9133,2968,6553,5334,3352
55103,12991,6465,6526,4313,4075,3164,1439
55104,43248,21296,21952,11568,15975,10589,5116
55105,28455,13335,15120,7741,9426,7238,4050
55106,52730,26107,26623,18812,16264,11660,5994
55107,14776,7122,7654,4935,4271,3537,2033
55108,14688,6847,7841,3301,5814,3267,2306
55109,31444,15014,16430,7997,8260,8774,6413
55110,37759,18416,19343,9296,8221,12081,8161
55111,0,0,0,0,0,0,0
55112,43250,20964,22286,10645,11551,11580,9474
55113,38994,18452,20542,8279,10744,10180,9791
55114,3100,1526,1574,377,1883,617,223
55115,8607,4193,4414,2502,1311,3144,1650
55116,23851,11126,12725,5098,7176,6656,4921
55117,41649,20182,21467,12563,12658,10460,5968
55118,27548,13178,14370,6639,6146,7920,6843
55119,38966,19172,19794,11145,11411,10521,5889
55120,4352,2065,2287,1083,855,1519,895
55121,7861,3887,3974,1827,2839,2054,1141
55122,30346,14768,15578,7805,8669,9602,4270
55123,26030,12905,13125,8196,5498,9822,2514
55124,49084,23796,25288,13539,12407,15543,7595
55125,43281,20737,22544,12927,10592,13558,6204
55126,25140,12036,13104,5949,5162,8544,5485
55127,16782,7986,8796,3844,3068,5647,4223
55128,28113,13505,14608,7560,7254,8662,4637
55129,18697,9154,9543,6525,5115,5358,1699
55130,17575,8934,8641,6970,5365,3661,1579
55150,198,94,104,56,49,58,35
55155,0,0,0,0,0,0,0
55301,10535,5280,5255,3708,3818,2249,760
55302,7107,3556,3551,1876,1429,2088,1714
55303,46352,23327,23025,13292,12272,13931,6857
55304,45967,23378,22589,14815,9385,16042,5725
55305,19368,8980,10388,3912,5292,5515,4649
55306,15935,7858,8077,4243,4589,4747,2356
55307,3227,1596,1631,909,786,841,691
55308,9064,4490,4574,3239,2372,2539,914
55309,18208,9234,8974,6438,5183,4887,1700
55310,1519,784,735,348,247,528,396
55311,32788,15944,16844,10626,8011,10781,3370
55312,1595,814,781,418,327,479,371
55313,23255,11538,11717,7073,5579,6727,3876
55314,1337,682,655,345,263,375,354
55315,4762,2425,2337,1638,1302,1418,404
55316,23089,11589,11500,6886,5690,7981,2532
55317,19218,9383,9835,6178,3801,6995,2244
55318,25493,12731,12762,8092,6720,7926,2755
55319,5038,2615,2423,1423,1036,1717,862
55320,4973,2514,2459,1423,1248,1533,769
55321,5341,2717,2624,1983,1141,1349,868
55322,3163,1656,1507,969,769,968,457
55324,1234,646,588,264,223,416,331
55325,4610,2378,2232,1398,899,1341,972
55327,3478,1799,1679,886,623,1391,578
55328,8541,4255,4286,2756,1690,2743,1352
55329,2118,1108,1010,610,514,559,435
55330,36440,18392,18048,11213,9542,11009,4676
55331,17524,8726,8798,4982,2555,6592,3395
55332,1922,961,961,463,364,557,538
55333,856,439,417,220,143,274,219
55334,2939,1474,1465,820,634,773,712
55335,1629,826,803,398,319,494,418
55336,8054,4012,4042,2240,1840,2250,1724
55337,44356,21504,22852,11623,12930,11939,7864
55338,1123,558,565,324,297,330,172
55339,988,514,474,277,240,308,163
55340,6327,3213,3114,1991,933,2422,981
55341,2850,1464,1386,1054,807,809,180
55342,2015,1029,986,505,376,636,498
55343,23933,11304,12629,5127,7672,6406,4728
55344,13952,6638,7314,3004,5632,3011,2305
55345,21147,10292,10855,5393,3437,7454,4863
55346,16776,8189,8587,4805,3417,6196,2358
55347,30069,14641,15428,9397,6152,10884,3636
55349,3887,1962,1925,1080,908,1145,754
55350,18280,9025,9255,5015,4437,5015,3813
55352,8751,4428,4323,2892,2140,2625,1094
55353,3162,1604,1558,894,714,925,629
55354,2741,1371,1370,813,664,813,451
55355,9656,4794,4862,2513,2094,2789,2260
55356,5311,2683,2628,1570,726,1960,1055
55357,3246,1620,1626,1016,557,1224,449
55358,4982,2524,2458,1425,1096,1579,882
55359,5954,3016,2938,1588,876,2327,1163
55360,2672,1387,1285,844,801,710,317
55362,18089,9012,9077,5692,5038,4928,2431
55363,4496,2279,2217,1481,1516,1036,463
55364,14353,7373,6980,3688,2805,5306,2554
55366,443,236,207,150,107,130,56
55367,913,464,449,257,202,292,162
55368,2218,1113,1105,604,526,662,426
55369,32524,15883,16641,8080,8234,10905,5305
55370,802,415,387,202,148,270,182
55371,16442,8253,8189,4729,4019,4850,2844
55372,29811,14978,14833,9072,6461,10122,4156
55373,5600,2792,2808,1687,1427,1834,652
55374,13576,6796,6780,4638,3192,4145,1601
55375,4518,2226,2292,1587,1440,1133,358
55376,16242,8223,8019,5963,4102,4637,1540
55378,26958,13506,13452,9071,6854,8664,2369
55379,40416,19782,20634,12864,13027,10281,4244
55381,2063,1071,992,550,468,645,400
55382,3563,1854,1709,967,683,1183,730
55384,1672,777,895,230,431,412,599
55385,1291,664,627,326,261,448,256
55386,6330,3150,3180,2224,1168,2114,824
55387,12249,5973,6276,4064,2850,3529,1806
55388,5619,2802,2817,1669,1366,1721,863
55389,2643,1344,1299,772,565,718,588
55390,2473,1341,1132,674,727,691,381
55391,14486,7146,7340,3680,2152,5031,3623
55395,2892,1447,1445,792,707,813,580
55396,2252,1097,1155,584,457,644,567
55397,2693,1346,1347,734,651,847,461
55398,15540,7978,7562,5190,4282,4536,1532
55401,6590,3698,2892,273,3619,1718,980
55402,368,247,121,11,225,112,20
55403,14985,8037,6948,1053,7752,3631,2549
55404,27121,14572,12549,6110,12365,5675,2971
55405,15411,7936,7475,3073,6887,3837,1614
55406,32112,15440,16672,6567,10630,9906,5009
55407,37881,19036,18845,10825,14513,8885,3658
55408,29981,15623,14358,5479,16014,5939,2549
55409,11615,5562,6053,2734,4033,3198,1650
55410,19340,9207,10133,4722,5021,6379,3218
55411,27428,13236,14192,11062,7994,5834,2538
55412,22148,10764,11384,7293,6759,5753,2343
55413,12934,6619,6315,2398,5576,3129,1831
55414,28495,15066,13429,6340,17979,2449,1727
55415,2604,1704,900,405,1366,673,160
55416,29027,13765,15262,5274,10572,7871,5310
55417,24875,12282,12593,5649,7782,7366,4078
55418,29472,14581,14891,6488,10020,8151,4813
55419,26406,12653,13753,6897,7101,8250,4158
55420,21767,10757,11010,5099,6148,5856,4664
55421,27035,13080,13955,6440,8127,6885,5583
55422,27820,13386,14434,6327,7526,8185,5782
55423,35375,17387,17988,8280,11228,9030,6837
55424,9685,4689,4996,3262,1369,3353,1701
55425,8952,4548,4404,2181,2756,2373,1642
55426,24945,12019,12926,5040,8718,6316,4871
55427,22919,11084,11835,5287,6015,6605,5012
55428,29357,14080,15277,7705,8334,7342,5976
55429,26751,12954,13797,7975,8444,6456,3876
55430,21508,10505,11003,6639,6498,5235,3136
55431,18435,8941,9494,3789,4366,5466,4814
55432,30027,14788,15239,7502,8278,8164,6083
55433,33613,16167,17446,8970,9413,9415,5815
55434,28823,14165,14658,7690,8033,8370,4730
55435,11592,5017,6575,2041,2882,2586,4083
55436,13138,6169,6969,3333,1948,4131,3726
55437,17484,8272,9212,3671,3793,5053,4967
55438,16249,7592,8657,3240,3645,5003,4361
55439,8750,4166,4584,2444,1039,2765,2502
55441,17848,8750,9098,4149,4875,5461,3363
55442,13217,6333,6884,3132,3161,4458,2466
55443,32462,15746,16716,10547,8937,8811,4167
55444,15667,7866,7801,4773,4367,4716,1811
55445,9879,4903,4976,3047,2828,2715,1289
55446,18695,8929,9766,5348,4742,5770,2835
55447,21187,10357,10830,5599,4985,6581,4022
55448,27863,13575,14288,7694,7160,8594,4415
55449,23277,11372,11905,7207,6755,6746,2569
55450,10,2,8,4,1,3,2
55454,8125,3930,4195,2773,3454,985,913
55455,1050,487,563,478,572,0,0
55601,105,66,39,25,14,33,33
55602,177,94,83,18,20,79,60
55603,508,265,243,85,102,207,114
55604,3360,1662,1698,624,601,1090,1045
55605,565,279,286,142,146,177,100
55606,272,144,128,46,30,120,76
55607,134,74,60,21,17,47,49
55609,303,142,161,66,53,105,79
55612,518,268,250,74,90,180,174
55613,205,104,101,36,31,73,65
55614,2627,1383,1244,516,462,764,885
55615,256,127,129,28,49,91,88
55616,6994,3454,3540,1595,1412,2124,1863
55702,500,267,233,144,111,164,81
55703,701,373,328,152,144,242,163
55704,1128,567,561,294,244,331,259
55705,3299,1693,1606,724,571,1057,947
55706,1825,893,932,330,265,530,700
55707,3440,1781,1659,1003,688,1096,653
55708,959,473,486,211,170,297,281
55709,4075,2140,1935,985,814,1291,985
55710,1292,662,630,253,228,434,377
55711,607,351,256,158,157,169,123
55712,586,306,280,155,114,170,147
55713,1017,538,479,261,223,264,269
55716,341,168,173,98,81,97,65
55717,335,185,150,55,55,137,88
55718,3281,1625,1656,753,664,1038,826
55719,5895,2957,2938,1416,1375,1702,1402
55720,16999,8399,8600,4773,4094,4724,3408
55721,3410,1707,1703,858,648,1098,806
55722,1200,615,585,344,286,321,249
55723,2363,1220,1143,474,391,745,753
55724,741,405,336,137,142,270,192
55725,103,55,48,21,15,43,24
55726,1045,521,524,254,199,302,290
55731,5820,2971,2849,1064,1104,1764,1888
55732,1453,780,673,296,229,546,382
55733,4616,2390,2226,1320,901,1595,800
55734,6213,3091,3122,1461,1322,1969,1461
55735,1809,957,852,372,293,599,545
55736,1550,785,765,355,294,496,405
55738,544,301,243,123,82,206,133
55741,3164,1573,1591,662,554,1099,849
55742,344,191,153,71,71,129,73
55744,20164,9944,10220,4953,4114,5911,5186
55746,17228,8383,8845,4132,3915,5064,4117
55748,1476,739,737,384,276,452,364
55749,449,237,212,88,83,168,110
55750,2025,1004,1021,432,385,561,647
55751,1553,837,716,370,285,571,327
55752,395,208,187,60,48,145,142
55753,989,511,478,252,240,290,207
55756,431,229,202,113,82,140,96
55757,866,463,403,211,164,287,204
55758,145,74,71,35,36,47,27
55760,3108,1595,1513,610,462,887,1149
55763,554,286,268,94,91,206,163
55764,569,294,275,153,128,161,127
55765,802,412,390,179,131,287,205
55766,43,25,18,12,8,11,12
55767,4532,2920,1612,780,1366,1373,1013
55768,2843,1437,1406,716,585,873,669
55769,2313,1167,1146,513,466,733,601
55771,1680,901,779,418,282,553,427
55772,76,33,43,26,19,22,9
55775,1205,629,576,214,183,413,395
55779,3755,2030,1725,899,855,1335,666
55780,212,102,110,64,63,51,34
55781,734,376,358,95,66,305,268
55782,480,265,215,94,78,174,134
55783,2437,1261,1176,594,439,752,652
55784,89,49,40,17,13,32,27
55785,263,143,120,70,31,93,69
55786,305,154,151,98,84,86,37
55787,525,259,266,102,89,147,187
55790,1866,955,911,319,241,578,728
55792,10107,4894,5213,2167,2312,2906,2722
55793,615,317,298,143,111,201,160
55795,1629,914,715,362,441,490,336
55797,1441,745,696,383,304,488,266
55798,581,304,277,145,119,161,156
55802,2442,1205,1237,255,491,699,997
55803,17431,8918,8513,4116,3985,5683,3647
55804,14592,7065,7527,3809,3078,4480,3225
55805,10194,5208,4986,1931,4832,2176,1255
55806,9576,4877,4699,2457,3431,2502,1186
55807,9963,4823,5140,2409,2874,2750,1930
55808,5846,2894,2952,1445,1534,1705,1162
55810,8702,4393,4309,2149,2024,2633,1896
55811,26246,12467,13779,6389,6942,6632,6283
55812,10924,5446,5478,3418,4599,1870,1037
55814,772,768,4,13,326,364,69
55901,51917,24715,27202,14214,16275,12905,8523
55902,21968,10583,11385,5772,5197,6619,4380
55904,26332,13388,12944,7049,7749,7291,4243
55905,0,0,0,0,0,0,0
55906,17598,8657,8941,4633,3922,5611,3432
55909,1428,714,714,385,262,370,411
55910,1423,786,637,378,316,467,262
55912,28483,14101,14382,7891,6934,7094,6564
55917,3696,1841,1855,1046,758,1063,829
55918,982,480,502,239,199,302,242
55919,985,516,469,223,182,347,233
55920,7026,3498,3528,2161,1682,2136,1047
55921,4964,2493,2471,1348,1073,1457,1086
55922,1021,526,495,393,218,253,157
55923,4469,2184,2285,1310,984,1237,938
55924,1303,697,606,363,281,411,248
55925,1113,586,527,281,283,362,187
55926,853,428,425,240,176,256,181
55927,4071,2044,2027,1239,1057,1086,689
55929,1209,605,604,379,359,330,141
55931,330,166,164,71,72,81,106
55932,2042,1055,987,644,500,574,324
55933,273,138,135,86,52,81,54
55934,3338,1700,1638,989,746,1039,564
55935,939,482,457,249,216,279,195
55936,1861,930,931,544,416,543,358
55939,1963,980,983,566,357,458,582
55940,2666,1344,1322,807,573,728,558
55941,969,497,472,257,200,330,182
55943,3059,1529,1530,782,595,936,746
55944,7151,3485,3666,2346,1845,1868,1092
55945,1458,762,696,369,299,464,326
55946,3178,1598,1580,812,648,958,760
55947,7513,3693,3820,1882,1472,2483,1676
55949,1808,920,888,431,337,552,488
55950,169,87,82,39,34,37,59
55951,1567,797,770,418,334,451,364
55952,2529,1292,1237,787,555,725,462
55953,894,448,446,244,183,282,185
55954,1442,706,736,325,292,372,453
55955,2746,1386,1360,900,500,1000,346
55956,1962,1015,947,532,413,655,362
55957,756,393,363,207,163,243,143
55959,2321,1216,1105,581,565,720,455
55960,3134,1575,1559,866,653,1072,543
55961,447,216,231,107,71,144,125
55962,763,402,361,189,127,238,209
55963,4988,2456,2532,1401,1120,1533,934
55964,4389,2171,2218,1278,1088,1185,838
55965,2376,1209,1167,590,473,714,599
55967,938,483,455,275,182,309,172
55968,121,62,59,16,16,37,52
55969,1117,582,535,310,230,361,216
55970,1016,504,512,305,184,287,240
55971,2993,1471,1522,796,645,816,736
55972,4995,2485,2510,1586,1169,1325,915
55973,285,152,133,82,54,100,49
55974,2132,1033,1099,504,407,551,670
55975,4335,2143,2192,1108,924,1251,1052
55976,7582,3674,3908,2228,1910,2038,1406
55977,203,107,96,62,53,54,34
55979,1143,601,542,402,261,288,192
55981,3961,1924,2037,829,665,1161,1306
55982,436,231,205,90,84,165,97
55983,1588,809,779,419,394,424,351
55985,1858,953,905,521,441,535,361
55987,35629,17117,18512,8934,11869,8191,6635
55990,925,465,460,231,189,290,215
55991,1490,773,717,363,287,547,293
55992,4693,2286,2407,1265,1056,1409,963
56001,46327,23252,23075,11586,18532,9114,7095
56003,14335,7087,7248,3713,4132,3932,2558
56007,21228,10372,10856,5044,4460,5728,5996
56009,1613,820,793,419,293,508,393
56010,1129,583,546,272,225,359,273
56011,8925,4465,4460,2783,2522,2323,1297
56013,4531,2185,2346,1065,866,1229,1371
56014,797,419,378,208,144,218,227
56016,1096,563,533,300,252,322,222
56017,1620,831,789,429,318,551,322
56019,914,465,449,232,156,267,259
56020,115,60,55,31,39,27,18
56021,1038,539,499,277,255,334,172
56022,70,33,37,22,15,21,12
56023,485,257,228,103,81,147,154
56024,2759,1404,1355,827,823,779,330
56025,507,263,244,122,102,157,126
56026,2012,1023,989,536,421,655,400
56027,902,457,445,256,171,242,233
56028,1372,691,681,309,286,412,365
56029,744,369,375,176,144,234,190
56031,12401,5977,6424,2903,2556,3473,3469
56032,313,159,154,85,77,82,69
56033,345,178,167,70,61,122,92
56034,496,263,233,116,108,171,101
56035,546,270,276,156,127,158,105
56036,1959,987,972,488,365,628,478
56037,1635,831,804,455,344,518,318
56039,957,504,453,250,184,320,203
56041,1066,562,504,285,237,309,235
56042,720,369,351,176,150,225,169
56043,486,255,231,108,104,163,111
56044,2082,1046,1036,568,436,667,411
56045,813,410,403,206,168,252,187
56046,94,50,44,22,22,29,21
56047,117,57,60,28,27,28,34
56048,3898,1930,1968,1073,950,1067,808
56050,1464,735,729,355,322,471,316
56051,703,366,337,142,125,229,207
56052,699,373,326,160,113,248,178
56054,923,480,443,256,199,295,173
56055,3902,1913,1989,1031,909,1172,790
56056,96,57,39,20,26,27,23
56057,3867,2019,1848,1097,953,1084,733
56058,5985,2954,3031,1597,1360,1728,1300
56060,452,234,218,131,85,132,104
56062,3208,1606,1602,857,728,880,743
56063,2724,1421,1303,631,610,892,591
56065,2844,1433,1411,782,673,762,627
56068,1087,539,548,275,234,350,228
56069,4467,2289,2178,1238,1064,1322,843
56071,11817,5839,5978,3816,2775,3377,1849
56072,2389,1208,1181,639,477,704,569
56073,16759,8358,8401,4006,3836,4885,4032
56074,2004,1027,977,594,487,574,349
56075,171,85,86,45,31,51,44
56078,476,250,226,129,111,152,84
56080,770,375,395,268,190,212,100
56081,6098,3024,3074,1745,1267,1620,1466
56082,13597,6797,6800,3813,4445,3089,2250
56083,874,444,430,210,156,254,254
56085,5451,2679,2772,1439,1024,1635,1353
56087,3179,1576,1603,811,573,870,925
56088,1946,972,974,497,319,584,546
56089,155,84,71,32,29,58,36
56090,694,342,352,185,150,205,154
56091,367,193,174,91,70,101,105
56093,12831,5820,7011,3227,3431,3737,2436
56096,3021,1492,1529,730,610,899,782
56097,3715,1851,1864,925,681,1098,1011
56098,2124,1062,1062,500,442,597,585
56101,5867,2887,2980,1441,1198,1614,1614
56110,1843,930,913,534,345,579,385
56111,420,227,193,104,76,141,99
56113,238,116,122,63,47,64,64
56114,361,192,169,94,57,127,83
56115,1366,688,678,371,327,340,328
56116,628,342,286,180,154,178,116
56117,399,204,195,112,100,120,67
56118,421,227,194,128,69,135,89
56119,1017,520,497,289,192,331,205
56120,1121,593,528,277,238,307,299
56121,659,337,322,168,116,215,160
56122,586,302,284,169,117,149,151
56123,514,269,245,98,81,170,165
56125,65,29,36,8,15,14,28
56127,398,209,189,84,74,124,116
56128,1984,987,997,533,343,541,567
56129,741,355,386,170,148,199,224
56131,2293,1126,1167,566,384,697,646
56132,540,282,258,135,88,188,129
56134,462,230,232,132,96,127,107
56136,1118,561,557,232,194,278,414
56137,1149,597,552,288,226,333,302
56138,899,442,457,241,202,213,243
56139,430,230,200,107,79,127,117
56140,59,28,31,8,4,20,27
56141,323,156,167,80,57,99,87
56142,981,484,497,221,187,270,303
56143,4478,2232,2246,1125,988,1276,1089
56144,1053,525,528,292,212,271,278
56145,622,297,325,158,96,187,181
56146,40,21,19,14,8,15,3
56147,192,107,85,54,39,52,47
56149,1268,639,629,323,234,337,374
56150,2742,1361,1381,687,569,775,711
56151,823,421,402,198,159,269,197
56152,1507,748,759,349,238,404,516
56153,224,110,114,43,40,54,87
56155,419,215,204,116,69,129,105
56156,6066,2918,3148,1645,1230,1534,1657
56157,788,402,386,244,182,226,136
56158,434,242,192,146,88,113,87
56159,2928,1443,1485,885,584,751,708
56160,214,111,103,56,44,49,65
56161,400,202,198,115,75,112,98
56162,285,146,139,61,50,92,82
56164,5920,2840,3080,1619,1280,1601,1420
56165,349,173,176,94,73,110,72
56166,253,136,117,63,54,79,57
56167,661,333,328,152,126,209,174
56168,932,489,443,251,163,306,212
56169,681,346,335,172,157,210,142
56170,587,299,288,155,130,190,112
56171,1821,915,906,447,379,532,463
56172,3164,1526,1638,761,584,828,991
56173,424,217,207,151,90,119,64
56174,357,181,176,91,60,109,97
56175,3085,1493,1592,865,609,805,806
56176,1137,550,587,309,195,314,319
56177,45,19,26,9,10,16,10
56178,1746,860,886,445,356,459,486
56180,1408,729,679,468,244,364,332
56181,1147,572,575,289,232,349,277
56183,1263,606,657,270,188,329,476
56185,560,276,284,152,115,179,114
56186,388,204,184,99,67,144,78
56187,14170,7254,6916,4151,3847,3308,2864
56201,23173,11382,11791,6638,6080,5698,4757
56207,251,140,111,73,46,81,51
56208,2066,1020,1046,463,373,540,690
56209,2339,1205,1134,567,505,733,534
56210,13,7,6,3,0,5,5
56211,529,273,256,116,83,170,160
56212,531,278,253,124,75,187,145
56214,725,351,374,171,122,214,218
56215,4693,2304,2389,1165,957,1303,1268
56216,670,360,310,172,131,230,137
56218,628,330,298,165,124,194,145
56219,735,347,388,174,121,194,246
56220,3070,1531,1539,740,616,830,884
56221,773,389,384,162,130,221,260
56222,1984,973,1011,514,398,530,542
56223,1408,715,693,347,282,394,385
56224,333,180,153,91,68,105,69
56225,834,406,428,214,166,218,236
56226,254,144,110,58,57,90,49
56227,223,118,105,38,43,68,74
56228,882,460,422,196,181,290,215
56229,1871,942,929,536,423,572,340
56230,854,428,426,230,174,251,199
56231,390,209,181,96,75,131,88
56232,2415,1197,1218,591,442,699,683
56235,579,303,276,121,97,176,185
56236,359,185,174,86,56,130,87
56237,600,308,292,168,97,181,154
56239,596,309,287,178,172,162,84
56240,1042,505,537,246,197,274,325
56241,4166,2058,2108,1054,879,1187,1046
56243,1725,878,847,509,403,490,323
56244,1496,796,700,449,378,405,264
56245,535,295,240,178,123,158,76
56248,807,401,406,191,140,226,250
56249,296,151,145,58,59,96,83
56251,987,499,488,271,215,287,214
56252,1238,645,593,353,250,370,265
56253,1015,533,482,245,180,325,265
56255,394,201,193,120,80,107,87
56256,2581,1249,1332,536,390,739,916
56257,508,255,253,107,70,170,161
56258,15617,7778,7839,4378,5038,3743,2458
56260,929,466,463,244,168,308,209
56262,724,377,347,181,166,200,177
56263,541,280,261,146,125,164,106
56264,2204,1086,1118,596,420,643,545
56265,7757,3772,3985,1979,1664,2176,1938
56266,1628,820,808,451,347,427,403
56267,6807,3278,3529,1931,2095,1446,1335
56270,1061,538,523,341,223,309,188
56271,1196,651,545,309,239,407,241
56273,4797,2418,2379,1223,920,1472,1182
56274,177,86,91,50,37,43,47
56276,298,162,136,70,37,104,87
56277,3191,1582,1609,841,715,898,737
56278,2601,1257,1344,584,435,735,847
56279,1271,637,634,365,298,399,209
56280,480,257,223,107,102,166,105
56281,619,304,315,176,128,148,167
56282,1510,774,736,422,350,467,271
56283,6636,3249,3387,1743,1358,1818,1717
56284,2111,1048,1063,554,432,565,560
56285,1096,548,548,281,241,336,238
56287,81,46,35,29,17,24,11
56288,4696,2346,2350,1084,866,1538,1208
56289,634,336,298,126,117,207,184
56291,501,262,239,146,102,155,98
56292,636,308,328,192,141,163,140
56293,1223,608,615,301,243,360,319
56294,84,41,43,19,12,32,21
56295,310,172,138,90,62,99,59
56296,2029,989,1040,479,340,523,687
56297,867,458,409,240,203,261,163
56301,32434,16597,15837,9107,12461,7022,3844
56303,25984,13175,12809,6273,8165,6955,4591
56304,16020,8598,7422,3418,6386,3583,2633
56307,5157,2552,2605,1589,1327,1281,960
56308,23961,11907,12054,5814,5378,6453,6316
56309,1185,579,606,280,198,346,361
56310,5120,2638,2482,1410,1059,1726,925
56311,757,386,371,174,147,189,247
56312,2365,1218,1147,657,478,685,545
56313,106,56,50,25,22,39,20
56314,1258,675,583,351,308,360,239
56315,1591,829,762,376,344,467,404
56316,1580,815,765,424,316,399,441
56318,1238,653,585,312,214,390,322
56319,1321,677,644,353,319,372,277
56320,8080,4050,4030,2334,1657,2388,1701
56321,1536,1464,72,655,755,50,76
56323,496,251,245,117,111,136,132
56324,1115,588,527,271,203,369,272
56325,211,109,102,52,47,52,60
56326,1526,779,747,377,345,413,391
56327,803,418,385,208,143,255,197
56328,128,64,64,37,31,31,29
56329,7367,3781,3586,2265,1867,2011,1224
56330,1691,850,841,503,454,489,245
56331,2019,1058,961,612,486,587,334
56332,1407,705,702,369,301,431,306
56334,5497,2716,2781,1223,1073,1568,1633
56335,199,106,93,42,40,57,60
56336,1514,781,733,338,235,508,433
56338,1691,888,803,430,333,520,408
56339,1129,572,557,251,253,299,326
56340,2288,1190,1098,688,526,710,364
56342,2739,1381,1358,593,406,812,928
56343,926,478,448,217,196,293,220
56345,14786,7289,7497,3784,3323,4360,3319
56347,7062,3568,3494,2056,1611,1867,1528
56349,733,381,352,194,187,194,158
56350,570,303,267,110,89,174,197
56352,5868,3008,2860,1739,1310,1523,1296
56353,8996,4636,4360,2583,2140,2503,1770
56354,1367,720,647,332,274,346,415
56355,579,305,274,155,140,183,101
56356,300,153,147,85,71,76,68
56357,1029,523,506,292,247,307,183
56358,3256,1687,1569,926,701,1031,598
56359,3878,1981,1897,1174,766,1085,853
56360,3917,1987,1930,981,703,1043,1190
56361,2403,1201,1202,576,459,674,694
56362,5844,2938,2906,1498,1163,1636,1547
56363,155,83,72,52,41,46,16
56364,5416,2695,2721,1559,1262,1467,1128
56367,6263,3291,2972,1819,1610,1911,923
56368,4239,2187,2052,1083,854,1343,959
56369,528,272,256,158,159,116,95
56371,99,54,45,22,20,32,25
56373,3051,1575,1476,934,766,870,481
56374,9868,4205,5663,2718,3485,2338,1327
56375,852,439,413,276,205,252,119
56376,358,181,177,110,117,79,52
56377,17648,8490,9158,5632,4957,4647,2412
56378,7778,3826,3952,2082,1674,2145,1877
56379,16163,7937,8226,4490,4664,4449,2560
56381,2458,1251,1207,519,509,682,748
56382,1540,815,725,468,322,440,310
56384,328,152,176,89,77,87,75
56385,928,488,440,258,190,275,205
56386,652,331,321,153,105,175,219
56387,6734,3211,3523,1522,2355,1379,1478
56389,111,57,54,29,29,41,12
56401,29439,14631,14808,7921,7529,7953,6036
56425,7655,3705,3950,2257,1708,2116,1574
56431,8931,4456,4475,1739,1321,2530,3341
56433,1840,939,901,412,287,600,541
56434,235,116,119,89,41,67,38
56435,2372,1230,1142,508,420,743,701
56436,67,31,36,22,17,17,11
56437,1380,691,689,483,286,338,273
56438,2949,1548,1401,830,570,893,656
56440,1409,702,707,420,257,349,383
56441,3596,1751,1845,876,732,945,1043
56442,2381,1187,1194,421,310,628,1022
56443,1417,747,670,292,186,494,445
56444,3087,1585,1502,652,403,930,1102
56446,1597,834,763,407,327,447,416
56447,1150,598,552,231,166,323,430
56448,332,169,163,48,30,92,162
56449,1769,930,839,494,369,533,373
56450,1017,522,495,166,159,275,417
56452,1755,925,830,270,217,477,791
56453,871,446,425,222,179,262,208
56455,1488,750,738,394,307,448,339
56456,50,28,22,14,14,17,5
56458,357,184,173,82,63,120,92
56461,3241,1692,1549,836,654,1010,741
56464,4336,2193,2143,1264,782,1174,1116
56465,2062,1061,1001,431,344,652,635
56466,3116,1568,1548,769,604,953,790
56467,2412,1239,1173,483,330,699,900
56468,4589,2362,2227,948,741,1411,1489
56469,998,522,476,200,155,301,342
56470,10334,5081,5253,2404,1890,2864,3176
56472,7459,3757,3702,1975,1526,2070,1888
56473,3380,1766,1614,878,773,1062,667
56474,4244,2145,2099,1043,792,1240,1169
56475,1655,850,805,466,398,485,306
56477,2758,1378,1380,783,534,779,662
56479,5384,2670,2714,1469,1202,1397,1316
56481,2031,1040,991,578,423,580,450
56482,6666,3310,3356,1808,1422,1766,1670
56484,3205,1577,1628,731,554,898,1022
56501,16290,8024,8266,4000,3458,4630,4202
56510,2333,1102,1231,618,463,645,607
56511,1878,968,910,494,391,507,486
56514,3696,1854,1842,1118,827,1024,727
56515,2892,1416,1476,582,331,811,1168
56516,294,157,137,82,51,83,78
56517,279,142,137,73,41,82,83
56518,388,189,199,115,108,96,69
56519,300,156,144,94,46,72,88
56520,3983,1979,2004,1041,794,1140,1008
56521,757,381,376,242,164,223,128
56522,538,276,262,152,100,178,108
56523,539,278,261,164,118,147,110
56524,661,345,316,145,91,208,217
56525,106,60,46,28,25,32,21
56527,840,444,396,213,172,241,214
56528,1673,860,813,335,226,526,586
56529,4026,2012,2014,1246,1068,1055,657
56531,1994,964,1030,492,387,611,504
56533,291,156,135,75,57,113,46
56534,1164,606,558,268,194,414,288
56535,1363,670,693,323,218,373,449
56536,482,242,240,119,110,157,96
56537,18548,8974,9574,4548,3797,5283,4920
56540,1962,985,977,537,337,561,527
56541,24,14,10,4,6,7,7
56542,2829,1379,1450,794,519,737,779
56543,276,137,139,70,56,92,58
56544,5294,2665,2629,1541,1097,1526,1130
56545,682,359,323,181,123,191,187
56546,346,181,165,98,73,107,68
56547,2700,1405,1295,874,648,823,355
56548,771,392,379,191,147,210,223
56549,4508,2295,2213,1352,991,1293,872
56550,414,212,202,111,90,129,84
56551,2237,1125,1112,523,397,576,741
56552,429,245,184,110,81,139,99
56553,293,155,138,66,58,111,58
56554,2709,1384,1325,659,450,839,761
56556,1160,580,580,283,215,317,345
56557,2811,1434,1377,843,597,732,639
56560,40766,19848,20918,11440,13997,9019,6310
56565,107,60,47,28,24,28,27
56566,668,340,328,285,180,131,72
56567,3169,1602,1567,821,706,902,740
56568,142,69,73,26,19,53,44
56569,1357,698,659,431,300,379,247
56570,1238,670,568,281,213,375,369
56571,1800,932,868,358,296,556,590
56572,5454,2755,2699,1320,966,1686,1482
56573,5993,2987,3006,1494,1193,1781,1525
56574,266,141,125,66,36,107,57
56575,763,371,392,256,156,202,149
56576,799,415,384,152,126,232,289
56577,21,12,9,4,2,9,6
56578,747,405,342,164,132,230,221
56579,1136,611,525,312,238,345,241
56580,1171,612,559,374,280,341,176
56581,287,139,148,76,43,79,89
56583,168,95,73,28,29,62,49
56584,1553,777,776,408,256,427,462
56585,1049,523,526,271,205,293,280
56586,1839,968,871,398,303,541,597
56587,1404,734,670,216,237,462,489
56588,568,286,282,127,92,136,213
56589,1975,991,984,634,394,495,452
56590,373,191,182,76,82,93,122
56591,170,87,83,56,48,45,21
56592,516,257,259,184,102,116,114
56593,14,3,11,8,5,0,1
56594,440,224,216,112,86,146,96
56601,32225,16039,16186,8905,9401,7930,5989
56621,4639,2298,2341,1321,985,1233,1100
56623,2749,1392,1357,611,452,903,783
56626,356,171,185,127,75,80,74
56627,309,162,147,40,37,118,114
56628,1681,848,833,293,219,502,667
56629,197,104,93,39,25,78,55
56630,2117,1048,1069,564,444,595,514
56633,4541,2274,2267,1563,1051,1117,810
56634,1639,813,826,433,332,421,453
56636,5137,2629,2508,1419,997,1440,1281
56637,227,118,109,65,36,76,50
56639,459,244,215,95,88,122,154
56641,324,170,154,96,43,100,85
56644,787,401,386,201,158,198,230
56646,355,198,157,82,65,105,103
56647,839,417,422,193,153,249,244
56649,9932,4886,5046,2387,1985,2999,2561
56650,722,370,352,170,121,215,216
56651,538,270,268,143,108,143,144
56652,539,269,270,148,97,151,143
56653,1336,659,677,320,196,446,374
56654,153,79,74,39,19,46,49
56655,1303,666,637,206,133,355,609
56657,304,147,157,38,38,100,128
56658,6,3,3,1,0,1,4
56659,54,28,26,11,10,13,20
56660,240,122,118,49,43,79,69
56661,942,479,463,212,131,303,296
56662,511,284,227,47,34,149,281
56663,220,119,101,55,40,72,53
56666,1066,561,505,495,264,203,104
56667,662,356,306,161,133,217,151
56668,136,65,71,15,14,54,53
56669,375,203,172,48,47,147,133
56670,1440,701,739,614,379,307,140
56671,3371,1625,1746,1383,910,706,372
56672,2097,1042,1055,428,298,620,751
56673,795,426,369,204,148,275,168
56676,1663,889,774,384,355,533,391
56678,1321,685,636,370,279,405,267
56680,117,60,57,17,15,27,58
56681,318,170,148,75,61,75,107
56683,772,408,364,184,142,256,190
56684,282,154,128,52,61,91,78
56685,117,62,55,16,10,37,54
56686,984,513,471,215,159,358,252
56687,73,41,32,18,19,21,15
56688,157,96,61,33,17,53,54
56701,12690,6238,6452,3336,3215,3378,2761
56710,490,245,245,139,122,126,103
56711,96,51,45,11,8,39,38
56713,1022,512,510,279,174,314,255
56714,1157,582,575,298,232,365,262
56715,350,187,163,92,72,90,96
56716,9416,4738,4678,2533,2463,2508,1912
56720,57,31,26,15,14,12,16
56721,10096,4999,5097,2860,2637,2809,1790
56722,386,196,190,102,71,123,90
56723,970,501,469,276,247,268,179
56724,159,85,74,33,25,48,53
56725,978,503,475,293,187,308,190
56726,1631,819,812,441,303,470,417
56727,769,396,373,181,128,261,199
56728,1364,666,698,300,182,432,450
56729,140,71,69,37,33,34,36
56731,93,52,41,20,16,44,13
56732,1136,552,584,273,186,331,346
56733,390,201,189,84,69,130,107
56734,467,258,209,121,74,153,119
56735,816,413,403,196,163,234,223
56736,903,470,433,146,135,314,308
56737,871,447,424,202,152,261,256
56738,1368,704,664,387,325,371,285
56741,23,12,11,1,3,10,9
56742,918,479,439,261,219,241,197
56744,543,274,269,145,124,137,137
56748,600,315,285,169,135,166,130
56750,2539,1279,1260,664,524,768,583
56751,5575,2785,2790,1589,1098,1718,1170
56754,546,280,266,160,122,162,102
56755,102,53,49,18,12,36,36
56756,799,394,405,249,186,258,106
56757,932,480,452,206,177,259,290
56758,418,224,194,87,77,147,107
56759,364,187,177,93,70,116,85
56760,358,180,178,102,74,118,64
56761,488,270,218,121,113,158,96
56762,2494,1235,1259,615,475,724,680
56763,5180,2708,2472,1525,1126,1670,859
57026,66,40,26,14,13,21,18
57030,143,74,69,36,26,63,18
57068,41,18,23,11,5,13,12
58225,71,34,37,11,10,32,18
38326,27,15,12,2,3,11,11
38601,2371,1129,1242,667,572,693,439
38603,2894,1420,1474,682,623,833,756
38606,16127,7689,8438,4965,4128,4218,2816
38610,3542,1729,1813,1032,941,922,647
38611,17202,8480,8722,4555,4071,5359,3217
38614,20418,9321,11097,6762,5177,4970,3509
38617,734,342,392,211,173,226,124
38618,12031,5848,6183,3394,2734,3474,2429
38619,5004,2469,2535,1387,1123,1489,1005
38620,3375,1651,1724,1018,867,975,515
38621,1910,934,976,648,484,474,304
38622,705,330,375,201,147,211,146
38623,259,124,135,100,63,53,43
38625,1058,548,510,270,272,305,211
38626,1353,661,692,344,295,411,303
38627,1120,559,561,307,306,282,225
38629,1774,838,936,519,422,496,337
38630,132,61,71,48,26,40,18
38631,1306,589,717,502,318,315,171
38632,24377,12126,12251,6949,5906,7030,4492
38633,2590,1291,1299,786,622,663,519
38635,15941,7958,7983,4278,4456,4372,2835
38637,26066,12641,13425,8790,8282,6335,2659
38639,1257,570,687,474,340,308,135
38641,2338,1176,1162,682,513,679,464
38642,2321,1124,1197,672,569,671,409
38643,2619,1260,1359,796,650,698,475
38644,208,97,111,53,58,51,46
38645,1329,610,719,432,283,385,229
38646,3073,1468,1605,797,673,886,717
38647,1143,563,580,306,274,344,219
38650,3881,1955,1926,1094,1006,1022,759
38651,7103,3455,3648,1848,1475,2282,1498
38652,16600,8013,8587,4692,4165,4287,3456
38654,45956,22381,23575,14075,11280,13394,7207
38655,36699,18420,18279,8224,15107,7761,5607
38658,2074,1043,1031,550,468,603,453
38659,2841,1416,1425,797,728,775,541
38661,2039,1015,1024,551,471,616,401
38663,11950,5842,6108,3353,2927,3165,2505
38664,3279,1562,1717,1104,1152,745,278
38665,2683,1358,1325,855,662,683,483
38666,6915,3247,3668,1990,1572,1916,1437
38668,14462,6896,7566,4638,3751,3602,2471
38670,1226,561,665,398,321,329,178
38671,35712,17048,18664,10817,10969,8507,5419
38672,11249,5522,5727,3848,3057,3066,1278
38673,746,366,380,213,201,218,114
38674,898,433,465,231,210,249,208
38676,6375,3006,3369,2044,1611,1676,1044
38677,4198,1784,2414,2607,1565,21,5
38680,6194,3116,3078,2080,1774,1598,742
38683,5637,2788,2849,1563,1307,1583,1184
38685,1347,669,678,376,273,437,261
38701,24187,11247,12940,7495,5899,6575,4218
38702,1,1,0,0,0,0,1
38703,14568,6700,7868,4719,3479,3729,2641
38704,41,14,27,11,3,14,13
38720,597,304,293,154,127,164,152
38721,1230,563,667,367,285,352,226
38722,531,241,290,155,133,146,97
38723,33,16,17,4,7,8,14
38725,998,485,513,309,232,236,221
38726,532,252,280,176,131,140,85
38730,1718,824,894,462,412,490,354
38731,129,61,68,27,16,30,56
38732,17981,8381,9600,5015,5556,4248,3162
38736,440,226,214,136,105,125,74
38737,2932,1339,1593,976,758,719,479
38738,3998,3874,124,78,2386,1418,116
38740,466,235,231,134,98,138,96
38744,682,310,372,205,127,215,135
38745,144,79,65,37,35,50,22
38746,616,282,334,217,143,154,102
38748,3901,1868,2033,1157,926,1097,721
38749,26,12,14,5,12,7,2
38751,11638,5401,6237,3592,3054,3096,1896
38753,1456,695,761,403,322,432,299
38754,1532,701,831,473,375,412,272
38756,6462,3068,3394,1847,1637,1865,1113
38759,1194,586,608,331,259,369,235
38760,929,426,503,330,232,236,131
38761,2870,1338,1532,1070,894,589,317
38762,2294,1034,1260,690,579,593,432
38764,430,193,237,108,90,145,87
38765,201,76,125,56,48,57,40
38767,77,41,36,14,18,22,23
38768,182,82,100,58,48,48,28
38769,2214,1021,1193,691,599,593,331
38771,3260,1495,1765,1068,771,795,626
38772,182,85,97,47,48,51,36
38773,3375,1590,1785,899,795,954,727
38774,2522,1123,1399,878,605,656,383
38778,1686,788,898,616,438,432,200
38781,252,105,147,56,56,81,59
38801,29871,13846,16025,9221,7644,7462,5544
38804,17285,8445,8840,4678,4595,4683,3329
38821,12528,5864,6664,3301,2814,3336,3077
38824,7832,3765,4067,2149,1832,2152,1699
38826,4703,2296,2407,1283,1042,1492,886
38827,2733,1320,1413,797,680,666,590
38828,3970,1958,2012,1118,944,1132,776
38829,18707,9142,9565,5032,4732,4900,4043
38833,2370,1203,1167,652,524,673,521
38834,29133,14127,15006,7809,7127,7646,6551
38838,1629,831,798,459,376,454,340
38841,2775,1411,1364,856,733,742,444
38843,11467,5490,5977,3244,2767,2825,2631
38844,131,65,66,29,22,45,35
38846,2446,1219,1227,701,568,708,469
38847,3501,1709,1792,939,809,1028,725
38848,848,438,410,231,189,251,177
38849,5702,2796,2906,1761,1586,1491,864
38850,3141,1536,1605,920,716,885,620
38851,8408,4009,4399,2545,2053,2175,1635
38852,9398,4481,4917,2221,1901,2674,2602
38855,4602,2298,2304,1276,1156,1250,920
38856,1788,922,866,459,447,496,386
38857,3252,1616,1636,978,814,909,551
38858,7176,3487,3689,2047,1754,1981,1394
38859,749,390,359,187,170,221,171
38860,5663,2640,3023,1596,1310,1588,1169
38862,2731,1353,1378,702,666,829,534
38863,19788,9714,10074,5914,5072,5214,3588
38864,1701,843,858,486,402,479,334
38865,4698,2359,2339,1230,1089,1387,992
38866,11897,5744,6153,3451,3131,3263,2052
38868,5481,2678,2803,1611,1383,1574,913
38869,478,211,267,139,102,138,99
38870,3122,1529,1593,859,728,844,691
38871,1640,816,824,445,404,459,332
38873,2719,1295,1424,677,610,779,653
38876,1322,644,678,346,293,383,300
38878,2864,1445,1419,891,740,721,512
38879,785,397,388,245,255,192,93
38901,18403,8660,9743,5144,4363,5131,3765
38913,396,190,206,84,88,115,109
38914,552,272,280,143,121,157,131
38915,4046,1882,2164,1110,919,1093,924
38916,5049,2344,2705,1350,1169,1336,1194
38917,3258,1602,1656,747,671,973,867
38920,804,407,397,188,193,248,175
38921,5061,2332,2729,1570,1204,1303,984
38922,3451,1631,1820,871,783,988,809
38923,1293,633,660,346,248,384,315
38924,771,369,402,218,132,262,159
38925,2363,1140,1223,602,511,681,569
38927,1186,610,576,330,289,325,242
38928,497,239,258,173,131,120,73
38929,1317,641,676,299,250,406,362
38930,25297,12077,13220,7528,6702,6545,4522
38940,2141,1052,1089,592,497,588,464
38941,5282,2598,2684,1737,1804,1130,611
38943,526,264,262,138,110,156,122
38944,504,260,244,124,114,128,138
38945,35,20,15,13,9,5,8
38946,362,150,212,116,95,90,61
38947,445,196,249,138,107,99,101
38948,2288,1102,1186,543,480,669,596
38949,297,131,166,83,57,87,70
38950,334,154,180,70,55,116,93
38951,1316,637,679,320,272,393,331
38952,611,316,295,173,138,178,122
38953,798,393,405,188,186,241,183
38954,1514,741,773,524,425,350,215
38957,734,317,417,201,146,199,188
38958,38,22,16,3,12,13,10
38961,803,395,408,238,175,218,172
38962,149,60,89,42,32,43,32
38963,4015,3099,916,563,2225,919,308
38964,104,59,45,20,16,40,28
38965,9135,4415,4720,2498,2103,2518,2016
38966,1174,528,646,394,302,318,160
38967,7755,3781,3974,2123,1767,2146,1719
39038,6258,2893,3365,2077,1554,1617,1010
39039,2193,1090,1103,574,461,627,531
39040,3295,1611,1684,909,747,938,701
39041,3404,1621,1783,868,730,1134,672
39042,34198,16248,17950,9691,8642,9314,6551
39044,3872,1919,1953,1132,830,1064,846
39045,1353,640,713,418,292,388,255
39046,26398,12754,13644,8381,7234,6668,4115
39047,34539,16774,17765,9425,10082,9620,5412
39051,16569,8139,8430,5095,4234,4097,3143
39054,341,155,186,125,73,101,42
39056,25621,11870,13751,7024,6897,6895,4805
39057,2291,1115,1176,907,578,482,324
39059,12073,5833,6240,3379,2966,3307,2421
39061,88,39,49,35,17,22,14
39062,467,210,257,126,100,135,106
39063,3620,1690,1930,1192,914,852,662
39066,4338,2050,2288,1259,963,1297,819
39067,1434,717,717,374,285,410,365
39069,5409,2673,2736,1468,1524,1518,899
39071,5346,2611,2735,1578,1200,1614,954
39073,19685,9578,10107,5641,4953,5519,3572
39074,14896,7267,7629,4612,4023,3717,2544
39078,755,347,408,208,170,206,171
39079,2037,999,1038,777,612,400,248
39082,1312,638,674,384,274,400,254
39083,10626,5098,5528,3080,2564,2954,2028
39086,1635,777,858,509,396,450,280
39088,135,75,60,28,23,50,34
39090,13398,6285,7113,3898,3048,3375,3077
39092,2934,1417,1517,870,743,768,553
39094,3956,1929,2027,1091,883,1123,859
39095,7324,3390,3934,2367,1649,1933,1375
39096,2338,1132,1206,676,923,434,305
39097,873,437,436,227,197,270,179
39108,1974,966,1008,522,385,557,510
39110,36143,17655,18488,11115,7534,11800,5694
39111,10460,5096,5364,3108,2638,2714,2000
39113,595,418,177,138,240,147,70
39114,9998,4866,5132,2924,2324,2794,1956
39115,155,75,80,45,39,40,31
39116,2538,1243,1295,743,601,720,474
39117,10697,5338,5359,2965,2874,2758,2100
39119,5506,2666,2840,1673,1306,1464,1063
39120,32334,16149,16185,7943,7731,9547,7113
39140,2250,1068,1182,582,490,650,528
39144,867,422,445,239,195,261,172
39145,5170,2580,2590,1494,1157,1507,1012
39146,2841,1377,1464,837,678,793,533
39149,1649,778,871,480,351,461,357
39150,5914,2753,3161,1685,1384,1657,1188
39152,1284,609,675,397,306,330,251
39153,3724,1752,1972,1016,765,1039,904
39154,10526,5618,4908,2789,2680,2946,2111
39156,513,261,252,120,122,145,126
39157,24645,11401,13244,6226,8144,6645,3630
39159,3334,1553,1781,883,720,970,761
39160,2889,1414,1475,810,650,808,621
39162,205,103,102,50,41,71,43
39166,613,293,320,201,124,160,128
39167,47,22,25,11,7,18,11
39168,6643,3216,3427,1961,1533,1847,1302
39169,2957,1362,1595,1043,770,697,447
39170,9407,4577,4830,2380,1868,3203,1956
39174,715,248,467,284,330,50,51
39175,4843,2361,2482,1327,1095,1370,1051
39176,2106,991,1115,537,443,595,531
39177,136,70,66,33,27,42,34
39179,1228,604,624,333,285,369,241
39180,32603,15378,17225,9387,7952,9073,6191
39183,15661,7530,8131,4457,3800,4649,2755
39189,5263,3226,2037,2450,1108,1022,683
39191,8074,3957,4117,2559,2047,2096,1372
39192,1733,795,938,466,320,525,422
39193,968,504,464,55,187,352,374
39194,20925,11750,9175,5818,6731,5287,3089
39201,536,316,220,28,260,200,48
39202,8411,4118,4293,1821,3524,1951,1115
39203,7091,3552,3539,2225,2307,1675,884
39204,19468,8909,10559,7301,5823,4392,1952
39206,25341,11454,13887,7377,7714,6162,4088
39208,31371,15449,15922,8134,10089,8308,4840
39209,29617,13757,15860,9724,8115,7788,3990
39211,24515,11677,12838,6223,7386,6102,4804
39212,33263,15543,17720,12093,9385,8574,3211
39213,22328,10241,12087,6545,5301,5873,4609
39216,3454,1587,1867,654,1068,852,880
39217,1103,423,680,319,784,0,0
39218,6943,3398,3545,2121,1997,1809,1016
39232,7068,3170,3898,1483,2864,1861,860
39269,0,0,0,0,0,0,0
39272,12551,5821,6730,3956,4062,3169,1364
39301,27449,13056,14393,7890,7092,7313,5154
39305,20431,9612,10819,5395,4948,5351,4737
39307,18603,9213,9390,5412,5106,4900,3185
39309,601,453,148,188,408,5,0
39320,1828,873,955,487,395,525,421
39322,1882,898,984,568,476,505,333
39323,1290,644,646,350,318,362,260
39325,5983,2938,3045,1738,1273,1776,1196
39326,720,342,378,182,160,217,161
39327,4190,2022,2168,1352,1119,933,786
39328,4806,2381,2425,1197,1250,1265,1094
39330,2746,1339,1407,763,619,762,602
39332,1923,977,946,584,449,493,397
39335,3160,1565,1595,821,711,953,675
39336,1235,596,639,323,287,341,284
39337,1808,914,894,445,393,548,422
39338,3319,1606,1713,932,734,944,709
39339,15619,7479,8140,4341,3651,4193,3434
39341,7156,3440,3716,2200,1822,1863,1271
39342,1287,550,737,405,437,296,149
39345,6127,2796,3331,1708,1381,1668,1370
39346,2241,1078,1163,595,493,605,548
39347,1497,714,783,365,296,442,394
39348,838,394,444,270,197,219,152
39350,24865,11848,13017,7948,6175,6158,4584
39352,812,400,412,257,196,214,145
39354,2094,1021,1073,560,431,583,520
39355,7131,3377,3754,1925,1575,1937,1694
39356,659,331,328,145,145,193,176
39358,1679,805,874,576,427,385,291
39359,273,124,149,88,67,65,53
39360,3830,1831,1999,1093,871,1057,809
39361,1468,730,738,387,315,437,329
39362,2866,1400,1466,871,722,792,481
39363,1773,844,929,473,352,477,471
39364,2985,1434,1551,815,724,836,610
39365,7547,3687,3860,2202,1663,2026,1656
39366,1380,650,730,395,310,381,294
39367,15096,7170,7926,4403,3664,4020,3009
39401,43366,20921,22445,11681,16409,9345,5931
39402,37492,17823,19669,10178,11910,8800,6604
39406,1759,644,1115,957,801,1,0
39421,2936,1381,1555,841,722,789,584
39422,5146,2427,2719,1446,1154,1411,1135
39423,2690,1299,1391,743,654,779,514
39425,1754,874,880,477,382,509,386
39426,16301,8130,8171,4511,3624,4631,3535
39427,1314,659,655,295,280,375,364
39428,9761,4690,5071,2796,2301,2507,2157
39429,17657,8518,9139,4778,4378,4716,3785
39437,12917,6383,6534,3634,3283,3474,2526
39439,4573,2212,2361,1234,1037,1319,983
39440,21305,10138,11167,6720,5757,4887,3941
39443,21939,10803,11136,5977,5128,6116,4718
39451,7181,5013,2168,1246,2841,2064,1030
39452,26964,13617,13347,8112,6815,7131,4906
39455,9721,4782,4939,2787,2236,2776,1922
39456,1292,636,656,406,306,356,224
39459,3677,1820,1857,1055,904,990,728
39461,582,291,291,158,145,152,127
39462,1122,552,570,341,260,309,212
39464,2482,1253,1229,677,573,700,532
39465,21386,10381,11005,6332,5552,5703,3799
39466,27738,13512,14226,7690,6724,7645,5679
39470,13011,6528,6483,3683,3160,3512,2656
39474,6050,2855,3195,1632,1349,1642,1427
39475,12225,5987,6238,3573,3331,3297,2024
39476,7582,3649,3933,2232,1761,2087,1502
39477,686,319,367,159,139,197,191
39478,2201,1079,1122,614,518,610,459
39479,5796,2910,2886,1640,1430,1588,1138
39480,2770,1361,1409,724,636,757,653
39481,1867,948,919,488,437,533,409
39482,9746,4775,4971,2942,2600,2591,1613
39483,6447,3128,3319,1971,1591,1718,1167
39501,21987,10606,11381,6671,6297,5473,3546
39503,45309,22505,22804,13127,13343,12151,6688
39507,16234,7964,8270,3702,4576,4463,3493
39520,14681,7356,7325,3910,3442,4354,2975
39525,8383,4024,4359,1824,1457,2276,2826
39530,8086,4147,3939,1873,2143,2388,1682
39531,17736,8807,8929,4705,5813,4149,3069
39532,32716,16219,16497,8925,9154,9401,5236
39534,2379,1878,501,876,1503,0,0
39540,8522,4104,4418,2311,2775,2159,1277
39553,17174,8380,8794,5043,4555,4673,2903
39556,7705,3923,3782,2265,1860,2315,1265
39560,16844,8072,8772,4525,4017,5001,3301
39561,1852,905,947,557,499,496,300
39562,17912,8899,9013,4938,4237,5274,3463
39563,13790,6644,7146,3425,3092,4014,3259
39564,36952,17900,19052,10337,9142,10623,6850
39565,19453,9860,9593,5775,4843,5827,3008
39567,10740,5383,5357,2734,2846,2960,2200
39571,13179,6544,6635,3519,2810,4050,2800
39572,1414,700,714,340,278,489,307
39573,8828,4490,4338,2652,2202,2363,1611
39574,13613,6872,6741,4016,3353,4157,2087
39576,5809,2811,2998,1671,1500,1659,979
39577,10374,5161,5213,2884,2644,2857,1989
39581,11595,5778,5817,3647,3414,2969,1565
39601,23536,11143,12393,6792,5590,6240,4914
39629,6519,3206,3313,1896,1595,1803,1225
39630,1115,535,580,345,267,299,204
39631,3732,1744,1988,1171,831,959,771
39633,1094,514,580,283,219,360,232
39635,170,87,83,34,44,54,38
39638,3333,1593,1740,825,689,997,822
39641,4569,2287,2282,1305,1095,1175,994
39643,1102,521,581,305,249,342,206
39645,5016,2432,2584,1219,1023,1480,1294
39647,1023,515,508,291,256,256,220
39648,21710,10103,11607,6880,5260,5415,4155
39652,8315,4106,4209,2305,1936,2294,1780
39653,2799,1347,1452,677,626,823,673
39654,5635,2761,2874,1563,1400,1548,1124
39656,803,412,391,204,142,275,182
39657,2351,1149,1202,615,488,699,549
39661,2997,1482,1515,932,664,883,518
39662,1318,617,701,377,303,378,260
39663,3080,1547,1533,831,692,910,647
39664,2256,1113,1143,572,493,649,542
39665,1196,574,622,302,302,353,239
39666,9588,4660,4928,2737,2189,2682,1980
39667,12837,6161,6676,3759,2979,3353,2746
39668,681,326,355,169,159,205,148
39669,6045,3440,2605,1358,1853,1772,1062
39701,13997,6383,7614,3970,3923,3579,2525
39702,22883,10597,12286,6820,5487,6229,4347
39705,13667,6838,6829,3386,4129,3607,2545
39730,11805,5547,6258,3284,2834,3193,2494
39735,3916,1901,2015,1051,809,1128,928
39736,312,158,154,98,81,101,32
39737,285,141,144,70,42,83,90
39739,2957,1374,1583,878,720,814,545
39740,5038,2530,2508,1481,1211,1486,860
39741,1560,780,780,434,329,468,329
39743,2067,932,1135,638,508,587,334
39744,6008,2908,3100,1609,1326,1736,1337
39745,810,386,424,260,165,196,189
39746,3183,1528,1655,877,756,887,663
39747,1999,974,1025,516,383,585,515
39750,2781,1354,1427,794,652,815,520
39751,1309,633,676,352,297,389,271
39752,2473,1200,1273,697,584,632,560
39755,1051,501,550,262,213,347,229
39756,1943,913,1030,596,461,547,339
39759,42108,21145,20963,10591,17859,8247,5411
39760,23,11,12,5,12,4,2
39762,2207,972,1235,1142,1044,16,5
39766,2630,1294,1336,716,644,762,508
39767,861,443,418,225,196,243,197
39769,1923,961,962,421,440,556,506
39771,127,56,71,40,28,33,26
39772,1793,832,961,468,388,523,414
39773,16670,7781,8889,4822,3996,4391,3461
39776,1674,819,855,447,395,511,321
51640,11,5,6,1,4,6,0
52542,40,20,20,20,10,2,8
52573,25,14,11,14,2,6,3
52626,101,54,47,10,16,43,32
63005,17753,8871,8882,5739,2452,6639,2923
63010,35439,17332,18107,9542,9146,10341,6410
63011,36347,17394,18953,9643,6600,11395,8709
63012,9973,5018,4955,2916,2546,3150,1361
63013,1589,799,790,411,366,537,275
63014,779,389,390,187,143,264,185
63015,2076,1042,1034,561,425,734,356
63016,7582,3775,3807,2037,1667,2577,1301
63017,41470,19621,21849,9255,6777,12420,13018
63019,4449,2163,2286,1297,1181,1182,789
63020,20714,10242,10472,5565,5054,6084,4011
63021,56261,27171,29090,15499,13225,17896,9641
63023,5831,2918,2913,1463,1169,2156,1043
63025,13854,6910,6944,4278,2789,4642,2145
63026,44124,21719,22405,12472,10545,14060,7047
63028,26413,12976,13437,7261,6327,7728,5097
63030,407,217,190,107,114,117,69
63031,48212,22689,25523,12991,12415,13664,9142
63033,43000,19731,23269,11627,10197,11884,9292
63034,17761,8461,9300,4445,3373,6172,3771
63036,1064,558,506,228,175,362,299
63037,3241,1620,1621,793,697,978,773
63038,6914,3522,3392,2104,926,2642,1242
63039,726,370,356,168,163,237,158
63040,8512,4164,4348,2930,1564,2956,1062
63041,534,274,260,142,99,193,100
63042,19602,9202,10400,5019,5976,5319,3288
63043,22367,10930,11437,5117,6609,6340,4301
63044,10568,4941,5627,2287,2305,3051,2925
63045,3,2,1,0,1,1,1
63047,31,16,15,8,7,11,5
63048,3357,1640,1717,866,908,859,724
63049,15896,7950,7946,4280,4184,4943,2489
63050,15716,8016,7700,4366,3728,4895,2727
63051,14495,7266,7229,4041,3761,4563,2130
63052,26431,13376,13055,8121,7063,7875,3372
63053,62,27,35,14,18,20,10
63055,2449,1221,1228,684,449,887,429
63056,2002,1000,1002,534,400,650,418
63057,56,45,11,0,0,6,50
63060,2461,1264,1197,649,513,829,470
63061,95,52,43,17,16,35,27
63068,4909,2414,2495,1313,1090,1489,1017
63069,15647,8304,7343,3916,4000,5004,2727
63070,7438,3628,3810,2228,2175,1915,1120
63071,1103,554,549,329,291,313,170
63072,3194,1668,1526,813,710,1122,549
63073,301,158,143,92,22,121,66
63074,15164,7223,7941,3816,4474,4319,2555
63077,11798,5822,5976,3308,2977,3331,2182
63079,58,32,26,17,14,19,8
63080,13987,6855,7132,3891,3335,3844,2917
63084,17414,8663,8751,5104,4529,4749,3032
63087,769,393,376,212,165,268,124
63088,8269,3866,4403,1906,2845,2075,1443
63089,5965,2979,2986,1717,1318,1895,1035
63090,21524,10521,11003,5722,4775,6500,4527
63091,1264,637,627,315,266,401,282
63101,2620,1454,1166,301,1398,740,181
63102,2316,1779,537,149,1314,654,199
63103,6900,3746,3154,760,3464,1678,998
63104,18656,9160,9496,4291,7117,4917,2331
63105,17667,8959,8708,5092,5533,4010,3032
63106,11883,4916,6967,4845,3160,2357,1521
63107,11912,5495,6417,3630,2953,3146,2183
63108,21568,10497,11071,3451,10067,4451,3599
63109,26946,12672,14274,5117,9128,7869,4832
63110,17107,8171,8936,4314,6328,4162,2303
63111,20313,9857,10456,5462,6111,5663,3077
63112,20368,9471,10897,5131,6851,5080,3306
63113,13167,6296,6871,3864,3027,3638,2638
63114,36201,17673,18528,9520,10425,10295,5961
63115,20775,9343,11432,6020,4942,5677,4136
63116,43540,21509,22031,10067,14804,12342,6327
63117,9163,4305,4858,1749,3110,2635,1669
63118,26704,13170,13534,8062,9049,6843,2750
63119,33969,15868,18101,8351,8216,9552,7850
63120,10296,4767,5529,3554,2499,2471,1772
63121,26602,11896,14706,7272,7060,7089,5181
63122,38495,17848,20647,10079,7873,11531,9012
63123,49308,23520,25788,10601,13023,14297,11387
63124,10417,4882,5535,2674,1329,3131,3283
63125,32201,15524,16677,7160,8499,8923,7619
63126,15112,7156,7956,3469,3183,4431,4029
63127,4939,2322,2617,1094,738,1398,1709
63128,29356,13900,15456,6156,5178,8790,9232
63129,52718,25547,27171,12818,12005,16577,11318
63130,30084,14240,15844,6702,10409,7309,5664
63131,16769,8130,8639,4717,2035,5562,4455
63132,13988,6533,7455,3657,3543,3852,2936
63133,8161,3682,4479,2851,2035,2061,1214
63134,13638,6273,7365,4414,3707,3420,2097
63135,21334,9785,11549,6647,5463,5910,3314
63136,48560,21365,27195,15754,12492,12651,7663
63137,20654,9442,11212,6556,5186,5668,3244
63138,20175,9062,11113,6705,5294,5127,3049
63139,22789,11406,11383,3684,9055,6385,3665
63140,294,136,158,101,74,85,34
63141,20593,9824,10769,5058,4385,5822,5328
63143,9678,4892,4786,1832,3681,2930,1235
63144,8825,4100,4725,1772,3225,2309,1519
63146,29262,13639,15623,5901,8232,7848,7281
63147,11373,5572,5801,3279,3026,3054,2014
63155,0,0,0,0,0,0,0
63301,48514,23886,24628,11551,14169,12844,9950
63303,45834,22485,23349,11028,12761,13823,8222
63304,40336,19826,20510,11899,8767,13295,6375
63330,125,76,49,23,22,52,28
63332,1292,634,658,320,188,461,323
63333,783,414,369,210,151,244,178
63334,8569,5192,3377,1922,2643,2477,1527
63336,1146,586,560,263,206,343,334
63339,1145,573,572,372,239,314,220
63341,3530,1791,1739,895,493,1432,710
63343,4546,2206,2340,1245,1035,1328,938
63344,1663,830,833,497,376,466,324
63345,393,195,198,94,72,110,117
63347,3078,1567,1511,889,726,1002,461
63348,6059,3069,2990,1627,1133,2067,1232
63349,1934,983,951,559,466,618,291
63350,562,283,279,140,98,178,146
63351,1768,853,915,437,347,522,462
63352,1078,556,522,285,206,326,261
63353,4593,2233,2360,1176,973,1266,1178
63357,5534,2844,2690,1459,1193,1717,1165
63359,1296,679,617,333,215,425,323
63361,4525,2250,2275,1193,1023,1309,1000
63362,6350,3142,3208,2079,1684,1805,782
63363,1719,860,859,413,320,569,417
63366,46175,22606,23569,13728,12467,12856,7124
63367,19433,9633,9800,5358,4957,5370,3748
63368,43360,21220,22140,14782,10909,12491,5178
63369,2258,1143,1115,714,509,703,332
63370,33,18,15,8,5,9,11
63373,603,304,299,150,121,216,116
63376,70828,34595,36233,19342,17971,22062,11453
63377,2462,1277,1185,666,494,779,523
63379,23348,11478,11870,7397,6097,6287,3567
63381,532,277,255,159,109,142,122
63382,4897,1643,3254,892,1659,1384,962
63383,15770,7776,7994,4401,3675,4500,3194
63384,1955,975,980,537,385,514,519
63385,35750,17499,18251,12070,9993,9067,4620
63386,538,283,255,128,133,170,107
63387,73,41,32,17,18,23,15
63388,710,379,331,164,121,245,180
63389,6336,3227,3109,1932,1649,1833,922
63390,9760,4861,4899,2697,2425,2863,1775
63401,22067,10608,11459,5899,5618,5969,4581
63430,639,335,304,194,146,177,122
63431,334,171,163,94,79,88,73
63432,513,262,251,131,98,141,143
63433,68,37,31,16,13,18,21
63434,687,343,344,216,170,177,124
63435,4219,2049,2170,1226,1165,969,859
63436,1155,568,587,258,200,350,347
63437,1503,727,776,443,281,396,383
63438,466,237,229,121,114,143,88
63439,127,66,61,29,23,40,35
63440,1407,710,697,358,293,422,334
63441,1121,581,540,279,235,322,285
63443,440,230,210,88,86,154,112
63445,3911,1904,2007,1042,854,1073,942
63446,691,341,350,201,127,199,164
63447,1133,640,493,274,279,308,272
63448,1520,751,769,375,324,467,354
63450,132,66,66,23,21,45,43
63451,244,127,117,66,50,66,62
63452,1167,580,587,296,237,325,309
63453,519,277,242,164,113,129,113
63454,946,474,472,264,186,298,198
63456,4271,2094,2177,1156,887,1216,1012
63457,337,164,173,123,76,87,51
63458,197,111,86,34,54,55,54
63459,4153,2080,2073,1109,846,1303,895
63460,328,162,166,57,64,111,96
63461,5876,2896,2980,1601,1338,1622,1315
63462,1458,755,703,291,266,457,444
63463,652,320,332,185,155,181,131
63464,21,12,9,0,2,5,14
63465,407,213,194,89,70,133,115
63467,75,37,38,22,20,17,16
63468,2644,1276,1368,705,543,698,698
63469,1194,596,598,311,233,347,303
63471,639,323,316,158,127,185,169
63472,587,288,299,156,134,162,135
63473,262,129,133,58,40,95,69
63474,479,246,233,117,93,137,132
63501,21532,10139,11393,5907,7617,4490,3518
63530,868,426,442,240,187,245,196
63531,532,256,276,167,103,137,125
63532,1322,679,643,357,269,380,316
63533,805,402,403,229,149,249,178
63534,804,420,384,202,146,243,213
63535,114,57,57,29,21,29,35
63536,851,422,429,269,171,217,194
63537,1916,929,987,531,354,493,538
63538,283,151,132,69,52,78,84
63539,206,108,98,36,25,55,90
63540,150,78,72,58,36,33,23
63541,409,196,213,99,76,126,108
63543,352,174,178,111,74,84,83
63544,818,399,419,214,135,239,230
63545,1111,554,557,260,225,323,303
63546,1715,866,849,544,331,486,354
63547,459,230,229,126,83,135,115
63548,1287,615,672,364,272,328,323
63549,2742,1337,1405,870,613,643,616
63551,338,167,171,79,59,105,95
63552,7926,3775,4151,2057,1625,2080,2164
63555,3201,1518,1683,939,663,854,745
63556,3779,1945,1834,1047,931,990,811
63557,291,144,147,64,44,83,100
63558,742,385,357,175,124,248,195
63559,1420,722,698,347,274,431,368
63560,239,121,118,61,51,60,67
63561,1206,591,615,316,216,324,350
63563,575,301,274,232,104,127,112
63565,3805,1854,1951,968,716,1032,1089
63566,125,63,62,29,15,43,38
63567,192,106,86,56,35,63,38
63601,16656,8070,8586,4735,4570,4369,2982
63620,1619,790,829,420,344,514,341
63621,1228,600,628,311,259,363,295
63622,1011,536,475,264,241,278,228
63623,882,447,435,189,161,290,242
63624,3757,1831,1926,926,835,1158,838
63625,457,255,202,109,63,115,170
63626,1037,516,521,314,239,332,152
63627,2937,1501,1436,841,634,902,560
63628,16014,9235,6779,3681,4721,4523,3089
63629,1314,650,664,335,273,381,325
63630,4062,2059,2003,1194,1022,1180,666
63631,849,424,425,203,175,277,194
63633,645,318,327,152,139,183,171
63636,608,301,307,161,125,180,142
63637,1329,685,644,371,330,371,257
63638,2920,1442,1478,777,588,817,738
63640,26335,14305,12030,6009,7357,7559,5410
63645,11420,5595,5825,3045,2554,3108,2713
63648,1628,829,799,470,378,462,318
63650,4401,2204,2197,1065,958,1217,1161
63653,1206,601,605,405,308,306,187
63654,706,379,327,173,130,205,198
63655,1523,779,744,393,304,478,348
63656,531,275,256,141,101,178,111
63660,4276,2568,1708,953,1298,1354,671
63662,1185,611,574,338,239,343,265
63663,723,335,388,189,174,164,196
63664,8920,4283,4637,2435,2098,2494,1893
63665,241,136,105,43,48,80,70
63666,93,52,41,30,29,22,12
63670,11295,5664,5631,2833,2409,3410,2643
63673,2068,1056,1012,527,439,669,433
63674,132,64,68,30,26,49,27
63675,144,78,66,24,22,57,41
63701,36812,17835,18977,9362,11775,9024,6651
63703,8182,3691,4491,1979,2308,1807,2088
63730,3430,1683,1747,843,766,933,888
63732,834,421,413,223,184,269,158
63735,847,429,418,254,195,229,169
63736,3310,1682,1628,907,798,987,618
63738,76,36,40,19,21,22,14
63739,464,245,219,94,90,171,109
63740,5339,2618,2721,1466,1280,1448,1145
63742,64,38,26,16,13,15,20
63743,122,62,60,41,25,34,22
63744,111,58,53,24,20,41,26
63745,66,34,32,21,15,12,18
63746,65,38,27,20,17,17,11
63747,469,242,227,136,112,131,90
63748,1015,533,482,228,196,321,270
63750,43,22,21,7,10,4,22
63751,1249,646,603,322,265,342,320
63755,24006,11648,12358,6732,5830,6790,4654
63758,170,80,90,31,50,43,46
63760,614,302,312,174,141,206,93
63763,223,112,111,51,47,61,64
63764,5984,2905,3079,1584,1271,1688,1441
63766,1288,674,614,322,260,405,301
63767,655,313,342,171,142,173,169
63769,1389,698,691,332,287,486,284
63770,192,96,96,62,44,50,36
63771,2862,1434,1428,811,618,846,587
63774,76,38,38,15,15,18,28
63775,16710,8306,8404,4668,3984,4596,3462
63780,6740,3310,3430,1879,1700,1851,1310
63781,1272,658,614,343,301,370,258
63782,274,146,128,66,55,86,67
63783,132,64,68,28,30,41,33
63784,279,150,129,99,49,73,58
63785,1000,528,472,254,211,299,236
63787,719,366,353,175,143,245,156
63801,23123,10841,12282,6289,5478,6382,4974
63820,226,108,118,57,38,58,73
63821,970,487,483,263,200,264,243
63822,2867,1374,1493,750,641,783,693
63823,1247,593,654,275,236,369,367
63824,164,83,81,57,34,51,22
63825,4409,2169,2240,1138,1024,1204,1043
63826,84,42,42,18,12,28,26
63827,829,408,421,182,159,283,205
63828,345,177,168,122,92,80,51
63829,1120,551,569,302,252,313,253
63830,7102,3345,3757,2273,1667,1808,1354
63833,242,123,119,59,50,75,58
63834,7135,4240,2895,1628,2154,2118,1235
63837,1653,806,847,522,409,437,285
63839,485,234,251,156,123,124,82
63841,13123,6187,6936,3225,3008,3690,3200
63845,5814,2784,3030,1553,1380,1520,1361
63846,1554,814,740,379,334,458,383
63847,64,29,35,17,14,15,18
63848,1592,762,830,433,368,428,363
63849,186,94,92,44,46,69,27
63851,4225,1967,2258,1332,935,1110,848
63852,1488,723,765,468,339,395,286
63853,244,135,109,64,57,60,63
63855,1117,561,556,281,269,332,235
63857,12956,6187,6769,3669,3065,3362,2860
63860,131,67,64,32,26,38,35
63862,1705,787,918,479,353,476,397
63863,6359,3039,3320,1723,1402,1740,1494
63866,488,228,260,122,114,150,102
63867,1019,508,511,208,205,342,264
63868,838,400,438,200,188,255,195
63869,3783,1818,1965,1046,871,1023,843
63870,1097,556,541,314,241,302,240
63873,4947,2367,2580,1343,1119,1395,1090
63874,350,174,176,81,87,80,102
63876,2374,1109,1265,695,513,596,570
63877,3931,1878,2053,1187,905,1032,807
63878,138,77,61,34,34,46,24
63879,773,385,388,219,170,227,157
63880,117,57,60,47,40,11,19
63882,431,213,218,116,92,114,109
63901,34665,16532,18133,9126,8259,9465,7815
63902,0,0,0,0,0,0,0
63932,1254,640,614,325,294,333,302
63933,3719,1785,1934,983,793,1045,898
63934,201,109,92,57,54,55,35
63935,10158,5026,5132,2667,2233,2723,2535
63936,754,385,369,195,190,202,167
63937,2922,1435,1487,856,673,804,589
63939,1430,703,727,364,316,423,327
63940,1393,680,713,297,303,409,384
63941,371,187,184,88,71,118,94
63942,652,330,322,152,116,203,181
63943,915,453,462,255,205,248,207
63944,1844,922,922,423,356,531,534
63945,1163,589,574,286,277,300,300
63951,331,170,161,94,68,91,78
63952,408,211,197,96,98,99,115
63953,1635,813,822,408,350,448,429
63954,1219,621,598,340,270,339,270
63955,288,145,143,71,58,85,74
63956,1133,562,571,266,206,321,340
63957,5440,2710,2730,1325,1062,1530,1523
63960,3326,1706,1620,939,803,815,769
63961,1610,802,808,421,338,451,400
63962,41,19,22,12,11,12,6
63964,784,395,389,181,136,221,246
63965,2697,1319,1378,653,523,807,714
63966,2601,1292,1309,459,435,814,893
63967,1906,977,929,422,356,626,502
64001,656,324,332,167,128,177,184
64011,3106,1567,1539,841,607,1080,578
64012,27260,13219,14041,7996,7044,7507,4713
64014,24797,11958,12839,7800,6807,6700,3490
64015,31217,15271,15946,8953,7763,9103,5398
64016,4713,2377,2336,1355,1138,1377,843
64017,464,239,225,123,98,153,90
64018,890,440,450,214,177,315,184
64019,2368,1180,1188,696,597,664,411
64020,3608,1709,1899,959,750,964,935
64021,633,312,321,159,128,180,166
64022,183,97,86,37,35,64,47
64024,16230,7982,8248,4473,3820,4610,3327
64029,16574,8177,8397,5369,5129,3992,2084
64030,24422,11630,12792,7086,7101,6317,3918
64034,7612,3775,3837,2392,1847,2247,1126
64035,971,491,480,276,221,303,171
64036,389,220,169,97,122,111,59
64037,6150,2991,3159,1596,1408,1735,1411
64040,6574,3265,3309,1756,1396,2068,1354
64048,4140,2110,2030,1064,694,1497,885
64050,22178,10627,11551,5888,5728,6015,4547
64052,20911,10336,10575,5034,5580,5975,4322
64053,5319,2683,2636,1412,1426,1565,916
64054,3731,1895,1836,907,1009,1088,727
64055,33858,16009,17849,7539,8092,9170,9057
64056,16576,7944,8632,5503,4520,4116,2437
64057,14141,6601,7540,3225,3493,4073,3350
64058,6659,3357,3302,1946,1634,1912,1167
64060,13042,6372,6670,4096,2842,4007,2097
64061,3387,1718,1669,814,689,1191,693
64062,6121,3075,3046,1804,1258,1884,1175
64063,20374,9774,10600,6219,5602,5729,2824
64064,16223,7796,8427,4775,3462,4848,3138
64065,27,10,17,3,1,16,7
64066,38,19,19,7,11,13,7
64067,5789,2856,2933,1570,1309,1558,1352
64068,36280,17655,18625,10540,8798,10708,6234
64070,3309,1675,1634,850,699,1153,607
64071,828,413,415,212,176,264,176
64072,239,128,111,50,47,97,45
64074,638,324,314,159,122,198,159
64075,11810,5848,5962,3649,2864,3189,2108
64076,9512,4729,4783,2683,2203,2765,1861
64077,1940,979,961,522,411,624,383
64078,8902,4426,4476,2526,2037,2816,1523
64079,12485,6281,6204,3639,3108,3831,1907
64080,12866,6341,6525,3785,3030,3763,2288
64081,23144,10910,12234,6533,4659,6759,5193
64082,14456,7052,7404,4817,3479,4146,2014
64083,20995,10091,10904,6354,5013,5723,3905
64084,1556,815,741,440,309,448,359
64085,8803,4211,4592,2287,1988,2499,2029
64086,21925,10623,11302,6541,5500,6977,2907
64088,1378,697,681,332,270,453,323
64089,11470,5666,5804,3380,2518,3665,1907
64090,116,65,51,34,35,27,20
64092,44,20,24,9,8,19,8
64093,27608,13778,13830,7637,10595,5539,3837
64096,1171,599,572,348,239,317,267
64097,1410,702,708,382,281,434,313
64098,2892,1421,1471,741,553,910,688
64101,339,284,55,7,176,148,8
64102,0,0,0,0,0,0,0
64105,3505,2069,1436,144,2261,732,368
64106,7701,4281,3420,2130,3342,1633,596
64108,7584,3884,3700,1436,3099,1957,1092
64109,9931,4889,5042,2453,2973,3050,1455
64110,15318,7264,8054,3785,5668,3832,2033
64111,16318,8841,7477,1978,7895,4163,2282
64112,8147,4111,4036,864,3906,1853,1524
64113,11328,5522,5806,2913,2346,3836,2233
64114,23158,10990,12168,3773,7566,6358,5461
64116,15318,7482,7836,3283,4616,4218,3201
64117,14017,6804,7213,3927,4232,3645,2213
64118,40191,19424,20767,10189,11751,10662,7589
64119,27341,13344,13997,6966,7152,7817,5406
64120,369,211,158,60,84,131,94
64123,10387,5369,5018,3455,3161,2548,1223
64124,12639,6449,6190,4339,3981,2977,1342
64125,1953,1003,950,632,572,539,210
64126,6514,3259,3255,2416,1900,1467,731
64127,17332,8376,8956,5712,4653,4650,2317
64128,11613,5424,6189,3422,2757,3206,2228
64129,9486,4504,4982,2665,2522,2601,1698
64130,20492,9438,11054,5757,4641,5543,4551
64131,21465,10069,11396,5078,6741,6003,3643
64132,13810,6177,7633,4469,3633,3701,2007
64133,33780,15829,17951,8862,8209,9638,7071
64134,21973,10286,11687,7283,6014,5577,3099
64136,2153,941,1212,633,573,503,444
64137,10554,5006,5548,2667,3482,2564,1841
64138,25294,11890,13404,6895,6415,7099,4885
64139,1762,830,932,508,325,635,294
64145,5389,2518,2871,1044,937,1351,2057
64146,1376,640,736,247,317,414,398
64147,769,308,461,384,342,37,6
64149,343,170,173,57,41,136,109
64150,3048,1562,1486,679,864,904,601
64151,24134,11612,12522,6121,6258,7423,4332
64152,26024,12895,13129,7765,5844,8364,4051
64153,5358,2641,2717,1356,1817,1531,654
64154,9257,4463,4794,2304,3059,2339,1555
64155,21901,10731,11170,6443,6368,6279,2811
64156,5404,2718,2686,1706,1720,1477,501
64157,16122,7919,8203,5866,5484,3625,1147
64158,5161,2502,2659,1811,1667,1385,298
64161,388,205,183,101,94,123,70
64163,689,370,319,149,220,212,108
64164,302,153,149,69,56,120,57
64165,112,55,57,33,28,39,12
64166,278,150,128,58,45,104,71
64167,353,170,183,105,52,139,57
64192,15,9,6,6,5,3,1
64401,1417,715,702,389,306,463,259
64402,2388,1130,1258,597,473,681,637
64420,53,27,26,8,6,13,26
64421,952,496,456,259,228,287,178
64422,337,179,158,103,68,97,69
64423,761,392,369,188,164,229,180
64424,4585,2244,2341,1269,983,1136,1197
64426,356,189,167,79,64,102,111
64427,606,302,304,163,138,190,115
64428,898,460,438,241,194,270,193
64429,13158,8231,4927,2771,4176,3843,2368
64430,764,393,371,174,142,278,170
64431,382,200,182,70,71,115,126
64432,141,47,94,29,23,30,59
64433,210,182,28,29,108,34,39
64434,518,263,255,179,109,151,79
64436,781,395,386,205,149,271,156
64437,792,404,388,160,141,265,226
64438,270,132,138,60,56,88,66
64439,1642,829,813,409,368,475,390
64440,737,373,364,211,153,243,130
64441,178,93,85,40,18,64,56
64442,882,446,436,293,178,230,181
64443,1096,537,559,249,175,376,296
64444,1340,674,666,346,259,479,256
64445,312,162,150,78,71,91,72
64446,1117,568,549,237,226,324,330
64448,1104,561,543,253,224,372,255
64449,451,241,210,144,99,129,79
64451,446,235,211,95,79,156,116
64453,217,107,110,63,49,64,41
64454,2667,1335,1332,783,579,723,582
64455,368,189,179,80,56,117,115
64456,1459,702,757,319,249,419,472
64457,329,169,160,87,62,130,50
64458,145,77,68,35,24,40,46
64459,472,239,233,101,90,165,116
64461,897,446,451,250,193,251,203
64463,1643,806,837,436,325,476,406
64465,4251,2162,2089,1227,933,1268,823
64466,541,268,273,121,124,158,138
64467,186,94,92,45,30,64,47
64468,16023,8043,7980,4371,6396,2863,2393
64469,2339,1144,1195,700,471,682,486
64470,1631,785,846,365,327,439,500
64471,483,245,238,113,92,142,136
64473,1457,706,751,327,302,433,395
64474,820,415,405,189,174,255,202
64475,468,265,203,142,107,125,94
64476,379,181,198,97,91,82,109
64477,3404,1672,1732,834,636,1083,851
64479,906,443,463,257,199,260,190
64480,307,164,143,78,42,115,72
64481,1088,540,548,284,198,316,290
64482,2101,1039,1062,491,400,558,652
64483,709,363,346,220,170,181,138
64484,1229,616,613,307,247,403,272
64485,8124,3869,4255,2211,1810,2271,1832
64486,455,232,223,115,84,138,118
64487,757,399,358,197,140,251,169
64489,2198,1076,1122,695,453,536,514
64490,2056,1040,1016,492,432,645,487
64491,1875,913,962,429,357,547,542
64492,1782,914,868,453,401,580,348
64493,460,239,221,113,92,146,109
64494,1018,526,492,271,211,307,229
64496,154,79,75,38,39,39,38
64497,598,307,291,174,125,156,143
64498,375,188,187,95,73,112,95
64499,119,60,59,34,25,41,19
64501,12503,6252,6251,3606,3990,3197,1710
64503,12921,6354,6567,3632,3487,3447,2355
64504,10763,5440,5323,2968,2574,3232,1989
64505,13161,6394,6767,3665,3207,3663,2626
64506,24030,12366,11664,5559,6904,6039,5528
64507,13738,6680,7058,3759,3799,3684,2496
64601,12438,5401,7037,2990,3104,3358,2986
64620,466,230,236,127,83,135,121
64622,600,311,289,155,127,164,154
64623,609,299,310,146,127,174,162
64624,1662,835,827,476,340,427,419
64625,644,332,312,178,131,214,121
64628,6144,2917,3227,1675,1282,1622,1565
64630,602,310,292,164,113,167,158
64631,902,439,463,194,153,276,279
64632,629,322,307,135,103,197,194
64633,5216,2489,2727,1355,1126,1394,1341
64635,515,266,249,141,139,120,115
64636,299,142,157,83,74,79,63
64637,667,343,324,148,140,180,199
64638,521,268,253,142,115,128,136
64639,240,116,124,50,51,64,75
64640,3140,1528,1612,870,601,824,845
64641,666,338,328,178,135,185,168
64642,855,422,433,224,175,228,228
64643,1072,537,535,306,206,295,265
64644,3024,1465,1559,919,590,811,704
64645,195,105,90,55,38,64,38
64646,297,159,138,64,57,93,83
64647,379,184,195,98,68,107,106
64648,2129,1033,1096,811,480,457,381
64649,864,424,440,252,158,268,186
64650,727,413,314,150,205,214,158
64651,570,277,293,134,116,156,164
64652,441,216,225,113,101,116,111
64653,687,354,333,195,126,218,148
64654,52,24,28,10,17,9,16
64655,264,142,122,63,60,62,79
64656,240,116,124,55,58,58,69
64657,323,169,154,80,50,89,104
64658,3277,1560,1717,886,686,902,803
64659,964,473,491,286,185,267,226
64660,513,249,264,121,93,135,164
64661,916,459,457,248,162,256,250
64664,350,172,178,73,60,117,100
64667,395,204,191,118,78,119,80
64668,1416,702,714,363,288,401,364
64670,1090,592,498,245,282,288,275
64671,2062,1035,1027,535,390,639,498
64672,251,141,110,78,38,53,82
64673,2492,1245,1247,705,489,681,617
64674,428,213,215,105,86,112,125
64676,215,111,104,54,52,65,44
64679,805,405,400,268,164,201,172
64681,192,100,92,34,32,65,61
64682,378,195,183,99,83,109,87
64683,8144,3834,4310,2140,1695,2053,2256
64686,271,142,129,64,50,92,65
64688,548,276,272,164,111,145,128
64689,683,353,330,215,154,179,135
64701,14385,6947,7438,4080,3354,3906,3045
64720,3843,1885,1958,1066,805,1138,834
64722,525,264,261,139,110,155,121
64723,665,336,329,177,135,217,136
64724,1859,913,946,440,375,482,562
64725,2271,1147,1124,717,552,570,432
64726,467,236,231,123,105,137,102
64728,594,297,297,184,137,150,123
64730,7109,3431,3678,1821,1568,1878,1842
64733,1159,587,572,319,256,327,257
64734,2004,1006,998,513,372,699,420
64735,13258,6411,6847,3167,2870,3614,3607
64738,1149,575,574,254,208,317,370
64739,997,513,484,249,221,320,207
64740,1884,956,928,357,316,580,631
64741,351,178,173,94,67,96,94
64742,2193,1102,1091,611,462,669,451
64743,292,154,138,97,82,69,44
64744,7836,3803,4033,2033,1528,2109,2166
64745,117,57,60,33,23,31,30
64746,1428,723,705,379,286,472,291
64747,3910,1971,1939,1126,903,1131,750
64748,1493,766,727,396,322,437,338
64750,423,212,211,114,106,118,85
64752,735,376,359,219,169,197,150
64755,2596,1344,1252,732,589,762,513
64756,742,379,363,172,126,220,224
64759,8244,4003,4241,2342,1703,2238,1961
64761,1493,788,705,444,322,440,287
64762,1604,799,805,483,358,436,327
64763,1568,801,767,341,262,446,519
64765,44,25,19,11,11,7,15
64767,821,416,405,223,170,238,190
64769,611,301,310,182,143,168,118
64770,1056,530,526,233,213,347,263
64771,610,309,301,145,128,178,159
64772,13596,6455,7141,3781,3015,3700,3100
64776,3942,2001,1941,878,675,1174,1215
64778,702,360,342,229,150,182,141
64779,2693,1355,1338,837,539,731,586
64780,639,331,308,139,120,203,177
64781,106,51,55,32,28,25,21
64783,775,391,384,215,143,225,192
64784,1500,754,746,443,360,373,324
64788,1415,698,717,373,272,421,349
64790,861,438,423,236,183,245,197
64801,34753,16930,17823,9155,10268,8903,6427
64804,37521,18069,19452,9571,9540,9963,8447
64830,639,313,326,191,175,167,106
64831,5879,2955,2924,1747,1325,1557,1250
64832,731,381,350,172,141,256,162
64833,125,63,62,39,26,36,24
64834,9556,4658,4898,3166,2247,2622,1521
64835,1899,928,971,573,512,482,332
64836,23940,11859,12081,7199,6052,6019,4670
64840,2813,1421,1392,844,595,806,568
64841,384,181,203,99,118,99,68
64842,829,416,413,250,190,225,164
64843,3259,1654,1605,951,789,889,630
64844,4680,2319,2361,1429,1071,1232,948
64847,437,224,213,133,104,118,82
64848,744,379,365,262,173,195,114
64849,186,90,96,55,45,43,43
64850,24063,11948,12115,7188,6042,6142,4691
64854,4170,2102,2068,1355,1099,1128,588
64855,2795,1415,1380,911,782,681,421
64856,4251,2144,2107,1282,956,1295,718
64857,424,199,225,134,119,106,65
64858,166,81,85,52,41,45,28
64859,1358,683,675,427,265,406,260
64861,1179,595,584,354,286,328,211
64862,3337,1635,1702,975,769,886,707
64863,1828,932,896,637,538,415,238
64865,5997,2978,3019,1800,1351,1622,1224
64866,1484,779,705,484,304,408,288
64867,1440,736,704,425,299,430,286
64870,14325,6994,7331,4581,4148,3433,2163
64873,1072,540,532,304,232,317,219
64874,760,354,406,242,173,200,145
65001,414,206,208,119,89,110,96
65010,5704,2745,2959,1654,1455,1656,939
65011,2374,1181,1193,819,480,580,495
65013,3515,1775,1740,953,787,964,811
65014,2252,1176,1076,509,453,731,559
65016,1376,709,667,401,298,419,258
65017,1549,771,778,465,352,447,285
65018,7714,3756,3958,2185,1847,2076,1606
65020,14286,7039,7247,3443,2857,4095,3891
65023,1730,871,859,421,317,623,369
65024,1086,546,540,287,234,331,234
65025,786,398,388,246,185,217,138
65026,11551,5689,5862,3124,2599,3192,2636
65032,1792,911,881,520,434,526,312
65034,679,322,357,266,137,152,124
65035,1826,926,900,553,423,531,319
65037,4938,2430,2508,715,648,1356,2219
65039,2328,1179,1149,587,390,877,474
65040,1208,620,588,330,270,413,195
65041,5725,2818,2907,1339,1025,1691,1670
65043,9452,4656,4796,2576,2346,2841,1689
65046,1194,621,573,328,249,351,266
65047,1351,645,706,344,342,418,247
65048,154,73,81,47,20,53,34
65049,6618,3323,3295,1310,1227,1975,2106
65050,755,389,366,340,169,152,94
65051,4874,2631,2243,1413,1224,1312,925
65052,3446,1699,1747,908,674,1019,845
65053,1425,721,704,389,262,487,287
65054,835,421,414,234,203,228,170
65058,1017,517,500,278,245,286,208
65059,867,409,458,257,176,245,189
65061,746,375,371,166,110,250,220
65062,49,26,23,13,4,15,17
65063,3412,1708,1704,968,773,1080,591
65064,578,316,262,139,131,196,112
65065,6414,3160,3254,1171,1315,1830,2098
65066,6703,3236,3467,1697,1396,1870,1740
65067,379,189,190,85,76,136,82
65068,827,420,407,240,179,233,175
65069,645,324,321,147,126,216,156
65072,1847,966,881,315,288,640,604
65074,3061,1524,1537,924,637,947,553
65075,784,379,405,229,174,229,152
65076,829,420,409,261,225,205,138
65077,561,282,279,133,106,204,118
65078,3743,1892,1851,829,655,1116,1143
65079,4729,2374,2355,627,545,1462,2095
65080,1015,507,508,254,226,342,193
65081,3928,2448,1480,790,1288,1169,681
65082,1127,590,537,266,266,316,279
65083,375,203,172,109,97,95,74
65084,6797,3351,3446,1930,1423,1786,1658
65085,1240,607,633,343,255,345,297
65101,30587,16637,13950,7707,9189,9134,4557
65109,38090,18036,20054,10274,9654,10499,7663
65201,39417,19082,20335,10294,19929,5458,3736
65202,46547,22700,23847,12927,16761,11070,5789
65203,53307,25869,27438,13600,17341,14045,8321
65215,203,1,202,134,69,0,0
65230,703,352,351,169,150,224,160
65231,3334,1655,1679,953,721,1044,616
65232,249,130,119,50,47,75,77
65233,11703,6324,5379,2814,3404,3116,2369
65236,1404,694,710,351,283,356,414
65237,907,450,457,225,196,316,170
65239,1309,647,662,410,277,370,252
65240,7590,3652,3938,2185,1639,2212,1554
65243,2806,1401,1405,1150,608,645,403
65244,412,208,204,94,70,142,106
65246,101,53,48,16,9,27,49
65247,616,316,300,142,124,193,157
65248,4619,2276,2343,1230,1312,1115,962
65250,617,334,283,174,130,185,128
65251,22437,11892,10545,5677,6902,6028,3830
65254,1810,878,932,476,380,507,447
65255,3731,1862,1869,1126,837,1087,681
65256,1787,892,895,537,412,545,293
65257,1564,793,771,388,322,512,342
65258,500,260,240,124,103,154,119
65259,2858,1463,1395,762,650,878,568
65260,574,307,267,149,125,171,129
65261,1094,553,541,267,189,319,319
65262,955,465,490,310,203,247,195
65263,1948,969,979,558,384,524,482
65264,720,373,347,173,123,230,194
65265,15409,7512,7897,4367,3531,4044,3467
65270,17681,9382,8299,4417,5119,4746,3399
65274,1710,823,887,407,388,502,413
65275,2535,1227,1308,568,484,715,768
65276,1609,780,829,435,320,443,411
65278,123,62,61,31,29,30,33
65279,1766,900,866,412,281,671,402
65280,243,129,114,78,39,77,49
65281,3098,1499,1599,792,609,891,806
65282,178,94,84,41,37,56,44
65283,387,208,179,58,62,125,142
65284,2361,1148,1213,624,524,759,454
65285,695,349,346,185,134,224,152
65286,129,64,65,30,22,43,34
65287,422,208,214,94,77,158,93
65301,34267,16725,17542,9691,8716,9030,6830
65305,2538,1402,1136,1040,1382,110,6
65320,56,26,30,1,7,14,34
65321,417,209,208,97,84,124,112
65322,587,305,282,172,112,171,132
65323,976,497,479,252,200,287,237
65324,1634,812,822,275,202,436,721
65325,3171,1557,1614,811,606,918,836
65326,1996,1028,968,279,233,641,843
65327,227,119,108,53,49,62,63
65329,494,243,251,141,97,145,111
65330,412,220,192,96,99,137,80
65332,1652,814,838,480,349,498,325
65333,759,390,369,202,161,232,164
65334,935,477,458,300,200,265,170
65335,196,100,96,54,48,57,37
65336,5981,3087,2894,1737,1885,1529,830
65337,1899,941,958,595,483,490,331
65338,3046,1484,1562,710,554,826,956
65339,712,349,363,206,138,216,152
65340,15937,7865,8072,4487,4301,3910,3239
65344,332,162,170,82,65,105,80
65345,387,204,183,102,82,121,82
65347,681,340,341,165,121,236,159
65348,1350,676,674,375,309,379,287
65349,2441,1208,1233,604,508,672,657
65350,1822,935,887,526,382,552,362
65351,2525,1280,1245,631,530,728,636
65354,628,326,302,182,129,198,119
65355,10519,5306,5213,1879,1469,3062,4109
65360,4752,2326,2426,1356,1074,1235,1087
65401,32383,17211,15172,8493,10721,7510,5659
65436,91,50,41,19,25,25,22
65438,2980,1485,1495,712,600,907,761
65439,259,129,130,59,67,64,69
65440,527,261,266,135,99,155,138
65441,5194,2628,2566,1434,1190,1528,1042
65443,96,48,48,27,24,23,22
65444,1087,548,539,274,202,315,296
65446,331,163,168,86,57,109,79
65449,351,169,182,91,67,103,90
65452,3315,1646,1669,952,754,927,682
65453,8548,4227,4321,2210,1897,2368,2073
65456,518,269,249,104,83,171,160
65457,338,164,174,95,86,106,51
65459,8233,4076,4157,2250,1831,2454,1698
65461,105,53,52,23,18,29,35
65462,1593,796,797,447,310,484,352
65463,1011,522,489,239,208,335,229
65464,492,249,243,107,75,140,170
65466,1634,808,826,381,319,469,465
65468,102,49,53,22,16,32,32
65470,923,479,444,221,150,323,229
65473,15059,10828,4231,5605,8935,501,18
65479,441,225,216,112,66,141,122
65483,4737,2228,2509,1181,1030,1213,1313
65484,186,89,97,46,31,51,58
65486,3423,1703,1720,1024,805,939,655
65501,163,89,74,35,26,44,58
65529,232,126,106,63,47,76,46
65534,1029,493,536,286,247,320,176
65535,1673,872,801,441,379,541,312
65536,28874,14140,14734,8010,6889,7779,6196
65541,236,120,116,52,27,83,74
65542,6776,4099,2677,1487,2091,1885,1313
65543,431,227,204,132,102,111,86
65548,5908,2826,3082,1599,1245,1537,1527
65550,3127,1556,1571,783,645,981,718
65552,2013,1005,1008,572,515,568,358
65555,1087,537,550,249,186,316,336
65556,5869,2889,2980,1563,1287,1748,1271
65557,166,79,87,44,47,48,27
65559,9385,4748,4637,2614,2036,2610,2125
65560,14392,7117,7275,3696,3049,4002,3645
65564,220,111,109,71,37,56,56
65565,5854,2896,2958,1551,1337,1666,1300
65566,772,376,396,207,177,208,180
65567,1253,631,622,313,259,387,294
65570,528,265,263,117,111,170,130
65571,2134,1046,1088,551,443,563,577
65580,829,429,400,200,145,253,231
65582,2181,1079,1102,555,417,654,555
65583,12307,6032,6275,3857,3798,3124,1528
65584,9855,4991,4864,3091,3608,2264,892
65586,33,14,19,5,5,9,14
65588,2680,1334,1346,795,591,769,525
65589,188,99,89,51,33,49,55
65590,1231,640,591,281,219,433,298
65591,1512,735,777,413,340,483,276
65601,812,419,393,189,147,277,199
65603,206,105,101,44,29,45,88
65604,3746,1865,1881,1009,740,1123,874
65605,12136,5922,6214,3396,2714,3299,2727
65606,3613,1778,1835,969,673,1009,962
65608,9403,4549,4854,2354,1885,2593,2571
65609,778,385,393,227,168,210,173
65610,5239,2581,2658,1457,1110,1590,1082
65611,1969,947,1022,331,283,562,793
65612,1354,696,658,322,296,464,272
65613,17396,8391,9005,5015,4764,3956,3661
65614,591,289,302,154,134,168,135
65616,24284,11694,12590,6056,6156,6420,5652
65617,1630,913,717,493,313,530,294
65618,148,78,70,25,29,52,42
65619,7393,3586,3807,2101,2038,1969,1285
65620,262,139,123,73,69,89,31
65622,8716,4223,4493,2365,1907,2365,2079
65623,36,18,18,16,9,10,1
65624,1577,813,764,258,176,505,638
65625,8328,4086,4242,2273,1796,2282,1977
65626,1637,837,800,378,320,500,439
65627,460,240,220,90,71,153,146
65629,574,290,284,134,120,174,146
65630,310,161,149,69,50,109,82
65631,4678,2271,2407,1420,1364,1191,703
65632,2939,1487,1452,828,639,834,638
65633,4131,2044,2087,1157,907,1184,883
65634,766,367,399,166,123,228,249
65635,541,266,275,131,102,145,163
65637,1135,547,588,304,221,333,277
65638,461,229,232,98,66,149,148
65640,887,447,440,267,177,264,179
65641,1250,627,623,200,181,382,487
65644,2759,1426,1333,739,614,865,541
65646,2046,1039,1007,509,394,642,501
65647,2347,1182,1165,707,524,650,466
65648,5614,2819,2795,1576,1147,1841,1050
65649,1593,814,779,371,286,457,479
65650,1520,763,757,312,212,426,570
65652,4157,2400,1757,999,1162,1336,660
65653,5708,2770,2938,1202,1125,1447,1934
65654,159,81,78,34,30,46,49
65655,3186,1578,1608,731,609,886,960
65656,4929,2432,2497,1145,902,1434,1448
65657,94,46,48,31,23,16,24
65658,1131,582,549,146,95,361,529
65660,182,84,98,46,33,53,50
65661,2562,1268,1294,613,428,746,775
65662,1269,631,638,340,252,400,277
65663,2481,1270,1211,802,510,688,481
65664,159,78,81,51,38,48,22
65667,3305,1629,1676,890,646,955,814
65668,1745,858,887,284,222,429,810
65669,2031,1003,1028,497,422,688,424
65672,9048,4396,4652,2272,2557,2053,2166
65674,2991,1460,1531,867,521,772,831
65676,472,235,237,98,63,116,195
65679,2704,1345,1359,782,647,781,494
65680,1201,598,603,264,224,330,383
65681,2345,1186,1159,417,328,751,849
65682,1980,988,992,555,377,562,486
65685,877,447,430,231,167,246,233
65686,4920,2332,2588,700,589,1264,2367
65689,4859,2388,2471,1276,938,1380,1265
65690,298,146,152,53,53,94,98
65692,1332,665,667,331,289,409,303
65702,473,230,243,114,103,146,110
65704,4047,1978,2069,1121,830,1175,921
65705,3999,1955,2044,1066,866,1033,1034
65706,14439,7027,7412,4176,3182,4050,3031
65707,2299,1193,1106,654,486,643,516
65708,12624,6145,6479,3865,3140,3242,2377
65710,1275,649,626,369,274,376,256
65711,9926,4813,5113,2788,2051,2620,2467
65712,8494,4192,4302,2299,1821,2243,2131
65713,2496,1263,1233,602,532,780,582
65714,29818,14430,15388,8916,7426,8118,5358
65715,92,52,40,21,26,28,17
65717,2568,1326,1242,793,547,712,516
65720,665,332,333,176,163,180,146
65721,28550,13816,14734,8665,7822,7388,4675
65722,1909,965,944,529,410,566,404
65723,3606,1786,1820,1016,809,1017,764
65724,1392,662,730,200,165,374,653
65725,2459,1255,1204,696,557,771,435
65727,218,112,106,57,39,58,64
65728,76,46,30,22,23,21,10
65729,228,116,112,22,20,74,112
65730,196,99,97,49,41,72,34
65731,281,140,141,71,66,74,70
65732,871,436,435,223,160,254,234
65733,503,250,253,97,80,164,162
65734,3497,1759,1738,1135,775,947,640
65735,110,54,56,13,17,21,59
65737,8413,4133,4280,1888,1498,2401,2626
65738,17550,8459,9091,5478,4951,4353,2768
65739,1326,663,663,265,199,429,433
65740,3405,1699,1706,913,797,966,729
65742,11367,5639,5728,3227,2469,3435,2236
65744,142,71,71,34,26,37,45
65745,2693,1343,1350,798,595,789,511
65746,7895,3979,3916,2982,1634,1933,1346
65747,3746,1861,1885,481,377,1110,1778
65752,432,212,220,93,94,143,102
65753,5027,2480,2547,1465,1253,1358,951
65754,950,487,463,282,216,284,168
65755,519,262,257,131,85,157,146
65756,748,371,377,210,156,234,148
65757,6975,3489,3486,1905,1464,2178,1428
65759,1423,690,733,442,285,426,270
65760,739,396,343,168,128,214,229
65761,1180,602,578,184,135,336,525
65762,441,230,211,98,79,138,126
65764,1287,647,640,443,262,328,254
65766,105,54,51,13,11,31,50
65767,2106,1049,1057,518,385,618,585
65768,488,252,236,97,83,156,152
65769,3091,1564,1527,1007,695,787,602
65770,3002,1484,1518,807,646,903,646
65771,1398,711,687,380,269,460,289
65772,2158,1092,1066,592,473,647,446
65773,711,366,345,175,125,204,207
65774,953,465,488,239,155,273,286
65775,24908,11965,12943,6830,5927,6452,5699
65777,328,182,146,94,81,87,66
65778,524,281,243,95,78,182,169
65779,2207,1098,1109,402,320,543,942
65781,8543,4208,4335,2613,2123,2331,1476
65783,225,116,109,67,37,72,49
65784,34,19,15,7,10,13,4
65785,5259,2606,2653,1285,888,1368,1718
65786,2250,1153,1097,597,469,679,505
65787,1864,910,954,357,327,526,654
65788,422,213,209,124,98,124,76
65789,2014,998,1016,542,447,617,408
65790,739,398,341,198,164,205,172
65791,4585,2249,2336,1195,881,1229,1280
65793,6337,3121,3216,1773,1331,1675,1558
65802,44270,21856,22414,11458,14964,10801,7047
65803,40902,20016,20886,10148,11839,11019,7896
65804,36801,17622,19179,7591,10473,9365,9372
65806,10586,5488,5098,1825,5553,2234,974
65807,54952,26351,28601,13084,19969,11571,10328
65809,11257,5477,5780,2719,1771,3651,3116
65810,20984,10058,10926,5605,5037,6133,4209
72644,15,8,7,1,2,8,4
57724,34,21,13,4,7,9,14
59001,1643,824,819,393,266,531,453
59002,165,98,67,47,29,57,32
59003,1160,561,599,405,238,333,184
59006,926,461,465,287,168,263,208
59007,113,60,53,15,12,41,45
59008,410,212,198,85,70,148,107
59010,102,53,49,14,18,44,26
59011,3027,1519,1508,747,516,889,875
59012,249,138,111,92,54,62,41
59013,127,64,63,20,17,52,38
59014,1446,718,728,328,254,442,422
59015,576,292,284,182,117,161,116
59016,1089,530,559,488,259,241,101
59018,602,293,309,134,103,197,168
59019,3972,2021,1951,1010,732,1309,921
59020,77,43,34,8,28,26,15
59022,1945,962,983,810,522,424,189
59024,390,191,199,84,48,136,122
59025,56,33,23,8,16,15,17
59026,194,99,95,47,33,73,41
59027,836,423,413,164,123,312,237
59028,434,230,204,83,74,147,130
59029,733,378,355,162,128,246,197
59030,1263,624,639,226,236,544,257
59031,339,165,174,115,83,83,58
59032,408,215,193,83,75,116,134
59033,334,173,161,104,58,110,62
59034,5189,2559,2630,1645,1186,1396,962
59035,227,134,93,47,41,72,67
59036,1505,732,773,388,281,415,421
59037,1672,831,841,410,328,572,362
59038,656,336,320,139,95,218,204
59039,28,19,9,3,0,10,15
59041,1950,999,951,489,335,614,512
59043,2950,1481,1469,1298,790,578,284
59044,10971,5427,5544,3016,2532,3187,2236
59046,390,198,192,100,60,121,109
59047,11880,5914,5966,2612,2721,3718,2829
59050,1715,833,882,666,397,410,242
59052,139,76,63,23,13,44,59
59053,354,177,177,105,64,97,88
59054,315,158,157,95,40,100,80
59055,59,34,25,13,14,18,14
59057,692,372,320,171,104,291,126
59058,50,25,25,12,10,19,9
59059,146,75,71,19,15,54,58
59061,272,143,129,24,25,114,109
59062,35,17,18,5,3,13,14
59063,2058,1050,1008,581,424,653,400
59064,284,137,147,81,55,89,59
59065,197,97,100,28,41,63,65
59066,701,368,333,245,179,180,97
59067,221,121,100,64,34,70,53
59068,3580,1788,1792,673,634,1234,1039
59069,461,246,215,92,67,179,123
59070,1047,544,503,242,181,385,239
59071,104,52,52,12,6,40,46
59072,4140,2065,2075,932,678,1382,1148
59074,490,264,226,111,64,165,150
59075,289,153,136,106,55,90,38
59076,33,20,13,4,6,8,15
59077,79,43,36,20,15,23,21
59078,145,69,76,30,11,55,49
59079,3481,1796,1685,1029,747,1149,556
59081,9,5,4,0,1,5,3
59082,39,24,15,12,12,11,4
59085,88,51,37,11,14,35,28
59086,727,360,367,139,104,273,211
59087,436,235,201,112,45,150,129
59088,1373,687,686,375,296,421,281
59089,467,237,230,165,124,114,64
59101,39562,19915,19647,10341,12094,11360,5767
59102,46564,21721,24843,10525,12139,11623,12277
59105,29624,14545,15079,8579,7765,8245,5035
59106,12375,6269,6106,3698,2287,4236,2154
59201,5100,2497,2603,1719,1182,1369,830
59211,125,64,61,26,20,45,34
59212,373,198,175,105,81,103,84
59213,772,379,393,288,181,194,109
59214,120,65,55,33,25,37,25
59215,1135,563,572,285,195,324,331
59217,100,52,48,34,16,35,15
59218,927,482,445,220,193,288,226
59219,199,107,92,45,23,66,65
59221,1241,642,599,351,278,341,271
59222,221,110,111,49,32,79,61
59223,364,192,172,60,48,136,120
59225,560,275,285,232,130,123,75
59226,410,195,215,91,56,133,130
59230,4490,2199,2291,1129,832,1293,1236
59231,264,127,137,53,27,65,119
59240,21,11,10,1,0,9,11
59241,413,209,204,118,53,130,112
59242,79,39,40,17,9,31,22
59243,345,187,158,91,74,109,71
59244,65,36,29,6,11,28,20
59247,314,156,158,77,59,106,72
59248,762,399,363,143,119,256,244
59250,198,97,101,35,26,70,67
59252,115,58,57,15,18,35,47
59253,112,61,51,17,14,39,42
59254,2026,985,1041,430,337,644,615
59255,3429,1707,1722,1347,901,812,369
59256,59,30,29,6,10,21,22
59257,61,36,25,8,12,25,16
59258,110,64,46,25,14,32,39
59259,348,178,170,73,60,98,117
59260,110,62,48,19,19,40,32
59261,520,274,246,124,71,175,150
59262,655,337,318,177,115,199,164
59263,1349,669,680,318,222,362,447
59270,7212,3694,3518,1853,1664,2215,1480
59274,206,111,95,36,34,62,74
59275,322,173,149,68,47,110,97
59276,40,24,16,4,1,17,18
59301,11404,5648,5756,2915,2536,3194,2759
59311,159,82,77,23,29,62,45
59312,31,17,14,7,6,8,10
59313,2498,1273,1225,626,580,731,561
59314,112,60,52,23,22,38,29
59315,150,77,73,29,28,53,40
59317,1164,578,586,259,176,340,389
59318,136,78,58,44,30,34,28
59322,85,44,41,18,11,31,25
59323,2294,1188,1106,691,515,819,269
59324,821,406,415,169,118,269,265
59326,265,147,118,59,35,97,74
59327,2945,1471,1474,750,501,889,805
59330,8307,4192,4115,1999,1909,2427,1972
59332,146,77,69,29,35,52,30
59333,21,9,12,5,1,8,7
59336,192,107,85,42,39,67,44
59337,812,403,409,193,152,225,242
59338,142,74,68,44,19,45,34
59339,149,78,71,44,26,50,29
59343,82,43,39,27,9,23,23
59344,300,145,155,69,52,87,92
59347,321,163,158,88,52,99,82
59349,913,452,461,160,145,245,363
59351,200,111,89,45,30,76,49
59353,1017,513,504,231,167,300,319
59354,41,20,21,15,6,11,9
59401,13774,6926,6848,3229,4064,3898,2583
59404,26867,13482,13385,7045,5784,8111,5927
59405,31438,15430,16008,8198,9362,7343,6535
59410,666,348,318,103,96,216,251
59411,460,236,224,127,104,136,93
59412,1747,906,841,485,335,506,421
59414,904,469,435,194,228,290,192
59416,337,187,150,57,53,142,85
59417,7719,3771,3948,2997,1998,1859,865
59418,95,48,47,25,17,28,25
59419,96,56,40,7,15,39,35
59420,243,130,113,67,45,68,63
59421,1831,928,903,368,244,611,608
59422,2643,1272,1371,638,462,748,795
59424,87,47,40,19,7,29,32
59425,3751,1779,1972,936,716,1036,1063
59427,4757,2313,2444,1412,995,1359,991
59430,454,237,217,111,70,138,135
59432,104,52,52,14,11,33,46
59433,594,294,300,138,88,198,170
59434,463,235,228,127,109,152,75
59436,1827,922,905,488,344,537,458
59440,175,85,90,36,29,68,42
59441,82,43,39,15,8,21,38
59442,1789,862,927,365,277,581,566
59443,612,312,300,174,108,167,163
59444,355,182,173,99,86,107,63
59446,564,290,274,152,81,186,145
59447,250,129,121,48,47,79,76
59448,743,346,397,304,193,182,64
59450,467,231,236,119,86,152,110
59451,241,130,111,46,49,88,58
59452,525,255,270,120,77,157,171
59453,362,195,167,73,71,94,124
59454,201,107,94,53,45,62,41
59456,233,126,107,65,45,69,54
59457,9105,4539,4566,1979,1771,2635,2720
59460,233,126,107,58,37,68,70
59461,33,17,16,9,5,13,6
59462,168,84,84,31,21,69,47
59463,169,89,80,27,12,60,70
59464,500,246,254,132,96,146,126
59465,52,29,23,1,3,13,35
59466,97,49,48,22,14,41,20
59467,259,113,146,101,64,52,42
59468,571,299,272,158,99,169,145
59469,157,82,75,40,20,59,38
59471,295,155,140,69,48,96,82
59472,657,317,340,182,130,211,134
59474,3820,2197,1623,817,1033,1211,759
59477,521,257,264,142,95,153,131
59479,826,443,383,187,153,261,225
59480,383,203,180,92,71,142,78
59482,802,395,407,240,181,243,138
59483,530,257,273,139,116,137,138
59484,111,59,52,13,21,46,31
59485,705,364,341,195,129,231,150
59486,1328,669,659,385,262,380,301
59487,1240,656,584,298,243,398,301
59489,396,203,193,101,68,138,89
59501,12638,6384,6254,3613,3295,3360,2370
59520,1030,517,513,252,178,302,298
59521,3475,1687,1788,1556,922,685,312
59522,1755,829,926,430,343,521,461
59523,2287,1157,1130,576,416,670,625
59524,663,341,322,224,137,183,119
59525,384,201,183,119,80,97,88
59526,2435,1186,1249,908,592,572,363
59527,974,495,479,399,241,228,106
59528,208,103,105,41,28,87,52
59529,163,91,72,49,29,41,44
59530,99,55,44,22,16,32,29
59531,241,122,119,43,39,73,86
59532,180,92,88,36,30,68,46
59535,74,40,34,15,16,22,21
59537,96,44,52,20,23,36,17
59538,3037,1470,1567,775,498,940,824
59540,371,186,185,83,61,126,101
59542,192,99,93,54,25,73,40
59544,175,88,87,53,39,50,33
59545,39,20,19,10,11,10,8
59546,129,65,64,20,12,44,53
59547,38,17,21,9,8,10,11
59601,29283,14145,15138,6730,7507,8446,6600
59602,24285,12215,12070,6781,5222,7775,4507
59631,237,120,117,54,54,80,49
59632,1939,973,966,473,417,657,392
59633,206,98,108,35,27,77,67
59634,4819,2406,2413,1308,721,1818,972
59635,7282,3612,3670,2193,1866,2218,1005
59636,12,9,3,0,9,1,2
59638,617,320,297,149,90,232,146
59639,1286,673,613,217,161,453,455
59640,89,48,41,16,16,35,22
59642,62,34,28,12,15,14,21
59643,437,231,206,89,83,151,114
59644,4036,2070,1966,982,714,1199,1141
59645,1635,818,817,366,280,488,501
59647,334,180,154,81,69,119,65
59648,635,320,315,122,110,214,189
59701,33147,16729,16418,8075,8048,9607,7417
59703,43,25,18,14,8,18,3
59710,286,162,124,44,51,111,80
59711,8933,4566,4367,1979,1715,2739,2500
59713,213,107,106,59,35,69,50
59714,18182,9233,8949,5556,5846,4861,1919
59715,31567,16664,14903,7595,11689,7323,4960
59716,1798,1010,788,273,819,472,234
59718,27367,14113,13254,6279,11071,6507,3510
59720,191,103,88,16,17,87,71
59721,433,225,208,103,67,144,119
59722,5781,3663,2118,1109,1522,1909,1241
59724,128,70,58,38,20,38,32
59725,7963,4024,3939,1981,1999,2161,1822
59727,221,130,91,45,29,75,72
59728,343,181,162,69,51,122,101
59729,2141,1066,1075,399,384,684,674
59730,1790,966,824,381,440,645,324
59731,209,119,90,42,27,76,64
59732,128,72,56,28,21,47,32
59733,198,105,93,74,27,55,42
59735,331,183,148,90,57,98,86
59736,127,73,54,29,23,41,34
59739,340,179,161,77,51,101,111
59740,495,259,236,96,70,165,164
59741,4352,2225,2127,1198,878,1365,911
59743,134,69,65,19,26,38,51
59745,134,77,57,31,21,48,34
59746,92,54,38,9,12,37,34
59747,159,87,72,19,14,47,79
59748,254,115,139,69,51,90,44
59749,1513,743,770,309,244,464,496
59750,309,155,154,68,58,115,68
59751,208,110,98,42,26,64,76
59752,3431,1721,1710,944,730,1109,648
59754,964,517,447,231,171,281,281
59755,210,108,102,31,39,70,70
59756,463,382,81,11,212,204,36
59758,1769,934,835,360,445,641,323
59759,3643,1931,1712,831,575,1224,1013
59760,260,131,129,57,57,86,60
59761,265,142,123,48,58,90,69
59762,258,135,123,48,31,86,93
59801,30940,15384,15556,7102,13657,6200,3981
59802,18407,9508,8899,3603,6961,4728,3115
59803,16203,8107,8096,4292,4398,4578,2935
59804,7533,3683,3850,1742,1553,2327,1911
59808,17904,8853,9051,4611,5491,4825,2977
59820,1361,714,647,269,274,435,383
59821,2377,1200,1177,714,519,686,458
59823,1561,820,741,355,338,556,312
59824,1792,924,868,602,413,463,314
59825,2412,1231,1181,573,533,763,543
59826,521,272,249,84,68,174,195
59827,300,148,152,54,42,95,109
59828,5543,2733,2810,1497,979,1666,1401
59829,2679,1446,1233,593,511,805,770
59830,146,75,71,22,15,55,54
59831,454,227,227,133,89,135,97
59832,765,383,382,188,115,238,224
59833,5448,2747,2701,1428,963,1915,1142
59834,2240,1179,1061,660,435,782,363
59837,407,198,209,92,77,145,93
59840,13052,6336,6716,2843,2458,3598,4153
59841,917,436,481,550,201,104,62
59842,90,42,48,18,14,31,27
59843,260,136,124,58,35,87,80
59844,736,394,342,232,97,220,187
59845,1186,603,583,247,178,376,385
59846,1617,838,779,371,292,587,367
59847,5606,2830,2776,1639,1489,1614,864
59848,106,51,55,33,15,30,28
59851,173,93,80,41,58,50,24
59853,699,372,327,133,108,234,224
59854,239,124,115,27,25,92,95
59855,957,481,476,372,276,221,88
59856,347,183,164,68,86,87,106
59858,1538,787,751,255,215,504,564
59859,3270,1644,1626,759,543,951,1017
59860,9913,4807,5106,2523,1943,2779,2668
59863,76,39,37,14,12,33,17
59864,6752,3334,3418,2124,1617,1708,1303
59865,3185,1584,1601,1003,683,874,625
59866,943,501,442,208,157,317,261
59867,28,16,12,1,4,13,10
59868,2054,1087,967,400,299,719,636
59870,9617,4780,4837,2212,1880,3086,2439
59871,218,127,91,18,30,74,96
59872,2309,1177,1132,466,353,737,753
59873,3085,1562,1523,630,503,933,1019
59874,1568,833,735,343,244,485,496
59875,3537,1776,1761,757,563,1148,1069
59901,49693,24588,25105,13784,11832,14242,9835
59910,356,184,172,68,49,108,131
59911,7678,3805,3873,1486,1188,2500,2504
59912,13499,6727,6772,3577,3078,4170,2674
59913,675,348,327,128,139,265,143
59914,234,107,127,52,31,58,93
59915,403,194,209,100,80,100,123
59916,130,68,62,17,8,49,56
59917,4225,2100,2125,1033,707,1314,1171
59918,592,301,291,122,108,205,157
59919,839,430,409,217,171,292,159
59920,1680,850,830,389,331,641,319
59922,2408,1169,1239,529,526,726,627
59923,9856,4998,4858,2140,1793,3062,2861
59925,1435,752,683,416,251,450,318
59926,513,265,248,108,104,191,110
59927,368,187,181,69,78,137,84
59928,88,55,33,6,8,32,42
59929,237,114,123,64,28,83,62
59930,867,460,407,211,142,248,266
59931,328,164,164,65,36,79,148
59932,1648,832,816,411,351,473,413
59933,43,23,20,9,6,20,8
59934,528,270,258,89,83,199,157
59935,3576,1846,1730,689,556,1169,1162
59936,367,186,181,54,67,134,112
59937,12588,6386,6202,2709,2980,4171,2728
82801,12,8,4,6,6,0,0
51557,40,20,20,7,2,14,17
57078,32,17,15,12,12,4,4
66541,28,14,14,10,2,12,4
68001,77,36,41,11,13,32,21
68002,2150,1074,1076,600,421,669,460
68003,4284,2151,2133,1118,904,1295,967
68004,885,439,446,247,172,252,214
68005,22132,10838,11294,6114,5966,5866,4186
68007,7612,3737,3875,2650,2317,1887,758
68008,12285,6038,6247,3549,2790,3546,2400
68010,745,426,319,618,95,29,3
68014,287,163,124,75,56,75,81
68015,1151,596,555,311,208,358,274
68016,413,205,208,92,62,129,130
68017,1692,861,831,486,339,560,307
68018,516,271,245,172,95,155,94
68019,550,278,272,143,93,193,121
68020,749,377,372,144,114,252,239
68022,16422,8079,8343,5222,4207,4680,2313
68023,2536,1306,1230,656,458,881,541
68025,30376,14795,15581,8003,7356,7913,7104
68028,10839,5381,5458,3781,2872,2857,1329
68029,899,460,439,229,202,264,204
68030,835,403,432,245,188,234,168
68031,1745,882,863,433,321,526,465
68033,392,202,190,113,98,111,70
68034,886,449,437,252,165,287,182
68036,402,203,199,102,80,127,93
68037,2286,1113,1173,590,479,663,554
68038,1280,611,669,260,212,370,438
68039,1421,694,727,711,351,261,98
68040,369,187,182,117,70,108,74
68041,955,482,473,276,202,286,191
68042,122,61,61,34,29,36,23
68044,724,377,347,210,158,220,136
68045,1801,887,914,488,309,489,515
68046,25191,12401,12790,8152,6343,7142,3554
68047,1614,790,824,365,279,470,500
68048,12422,6193,6229,3487,2675,3741,2519
68050,609,333,276,147,117,184,161
68055,341,175,166,91,57,114,79
68057,1544,789,755,371,236,463,474
68058,252,124,128,41,34,103,74
68059,3158,1644,1514,860,626,999,673
68061,2504,1222,1282,651,455,693,705
68062,311,169,142,102,58,99,52
68063,234,114,120,53,37,68,76
68064,3376,1680,1696,812,682,1121,761
68065,1510,760,750,397,279,496,338
68066,5640,2796,2844,1634,1211,1567,1228
68067,1288,642,646,530,287,297,174
68068,127,62,65,29,21,40,37
68069,2558,1296,1262,602,429,925,602
68070,836,429,407,235,136,278,187
68071,1934,946,988,902,463,357,212
68072,66,34,32,18,17,19,12
68073,1960,992,968,607,397,619,337
68102,6102,3751,2351,598,3793,1295,416
68104,34664,16582,18082,10298,10339,8978,5049
68105,23842,12359,11483,6795,8323,5713,3011
68106,19936,9714,10222,4260,7093,4868,3715
68107,29491,15020,14471,10777,9109,6417,3188
68108,14664,7512,7152,4796,4837,3309,1722
68110,9173,4996,4177,2717,2556,2690,1210
68111,23393,10906,12487,8682,6187,5563,2961
68112,11508,5478,6030,3483,2752,3164,2109
68113,994,638,356,307,596,87,4
68114,16928,7849,9079,3610,4973,4046,4299
68116,25429,12323,13106,8066,8383,6403,2577
68117,8032,4107,3925,2182,2133,2218,1499
68118,9389,4617,4772,2922,1738,3394,1335
68122,9794,4671,5123,3067,3207,2418,1102
68123,27926,13852,14074,8980,9092,7195,2659
68124,15690,7346,8344,3769,3792,4056,4073
68127,21117,10689,10428,4816,7205,5487,3609
68128,17784,8623,9161,5219,5755,4773,2037
68130,17972,8799,9173,5607,4065,5337,2963
68131,12302,6322,5980,3059,5146,2851,1246
68132,14101,7016,7085,3812,4874,3471,1944
68133,9703,4804,4899,3271,2013,3046,1373
68134,28257,13441,14816,7437,8579,7319,4922
68135,25875,12953,12922,9569,6642,7693,1971
68136,13829,6906,6923,4677,4733,3235,1184
68137,24921,12008,12913,6614,6893,6729,4685
68138,12013,6179,5834,3595,4139,3356,923
68142,3072,1531,1541,845,945,865,417
68144,24233,11836,12397,6187,6194,6629,5223
68147,10351,5194,5157,3180,2862,2644,1665
68152,5837,2764,3073,1337,973,1794,1733
68154,22692,10956,11736,5498,6469,6189,4536
68157,5213,2563,2650,1515,1360,1444,894
68164,27387,13250,14137,7512,8670,7500,3705
68178,1573,651,922,1118,415,10,30
68301,1466,736,730,414,299,430,323
68303,289,142,147,70,44,86,89
68304,330,160,170,92,63,114,61
68305,4389,2085,2304,1134,914,1213,1128
68307,515,268,247,147,108,159,101
68309,121,59,62,28,25,48,20
68310,14546,7049,7497,3566,3139,4134,3707
68313,900,466,434,239,164,308,189
68314,351,192,159,88,64,127,72
68315,129,71,58,31,19,43,36
68316,447,231,216,114,77,163,93
68317,1495,782,713,372,350,473,300
68318,526,268,258,121,89,172,144
68319,552,286,266,143,105,184,120
68320,369,181,188,75,60,113,121
68321,311,158,153,56,41,104,110
68322,440,221,219,99,88,134,119
68323,315,148,167,80,48,94,93
68324,174,91,83,52,26,59,37
68325,198,89,109,45,21,58,74
68326,241,111,130,73,36,64,68
68327,299,145,154,59,42,104,94
68328,429,226,203,91,89,151,98
68329,673,336,337,173,136,220,144
68331,961,493,468,277,199,293,192
68332,146,74,72,27,15,47,57
68333,8327,4189,4138,2642,2342,2022,1321
68335,518,263,255,127,73,154,164
68336,557,280,277,154,99,193,111
68337,383,201,182,82,62,139,100
68338,324,163,161,72,63,86,103
68339,1311,703,608,330,282,449,250
68340,992,479,513,264,155,261,312
68341,1041,549,492,243,218,322,258
68342,530,282,248,128,107,158,137
68343,1050,523,527,281,236,322,211
68344,441,222,219,116,85,164,76
68345,269,150,119,61,38,75,95
68346,493,253,240,128,110,170,85
68347,2570,1329,1241,797,578,831,364
68348,256,124,132,48,35,95,78
68349,1098,550,548,339,215,323,221
68350,216,115,101,40,32,80,64
68351,853,425,428,218,137,260,238
68352,5222,2526,2696,1240,1015,1402,1565
68354,839,413,426,178,119,269,273
68355,5113,2473,2640,1288,981,1385,1459
68357,421,216,205,121,85,130,85
68358,1877,950,927,699,380,543,255
68359,1585,782,803,402,274,458,451
68360,501,267,234,140,77,173,111
68361,2573,1225,1348,730,436,653,754
68362,46,24,22,15,7,17,7
68364,142,76,66,34,35,41,32
68365,245,126,119,66,35,85,59
68366,1047,523,524,275,217,350,205
68367,461,242,219,122,75,150,114
68368,485,248,237,137,100,164,84
68370,2075,1009,1066,449,327,562,737
68371,1467,700,767,337,245,399,486
68372,2827,1448,1379,959,614,852,402
68375,121,68,53,24,14,44,39
68376,1445,707,738,331,214,421,479
68377,425,224,201,85,67,164,109
68378,680,321,359,184,127,194,175
68379,59,30,29,13,13,22,11
68380,81,42,39,26,17,17,21
68381,249,135,114,63,34,85,67
68382,41,22,19,9,8,11,13
68401,717,371,346,201,150,216,150
68402,1210,624,586,346,215,433,216
68403,206,103,103,57,35,71,43
68404,902,465,437,241,148,328,185
68405,3257,1789,1468,1023,741,839,654
68406,458,236,222,111,81,126,140
68407,747,398,349,181,149,240,177
68409,807,411,396,216,147,252,192
68410,8716,4193,4523,2323,1880,2307,2206
68413,533,264,269,142,109,166,116
68414,256,134,122,59,46,73,78
68415,649,323,326,161,118,195,175
68416,226,113,113,56,49,66,55
68417,292,160,132,81,54,87,70
68418,1070,559,511,292,248,345,185
68419,256,136,120,87,50,75,44
68420,1285,623,662,283,173,344,485
68421,1107,589,518,358,447,191,111
68422,513,271,242,127,94,159,133
68423,898,468,430,223,172,303,200
68424,730,361,369,180,140,228,182
68428,1375,707,668,387,230,503,255
68430,1402,722,680,434,234,468,266
68431,353,190,163,74,56,122,101
68433,265,139,126,59,39,98,69
68434,8576,4196,4380,2461,2243,2143,1729
68436,581,297,284,128,84,195,174
68437,261,130,131,54,50,81,76
68438,142,73,69,33,39,41,29
68439,478,251,227,140,114,136,88
68440,110,56,54,13,9,44,44
68441,302,154,148,81,60,80,81
68442,313,159,154,55,44,103,111
68443,1047,513,534,298,176,328,245
68444,97,50,47,23,22,36,16
68445,152,80,72,30,31,52,39
68446,2690,1286,1404,681,514,675,820
68447,464,234,230,116,63,138,147
68448,399,207,192,99,65,119,116
68450,3182,2016,1166,547,995,955,685
68452,86,41,45,14,11,41,20
68453,304,150,154,76,37,89,102
68454,625,310,315,130,125,209,161
68455,681,353,328,163,142,253,123
68456,1127,552,575,310,235,320,262
68457,343,188,155,65,58,122,98
68458,135,71,64,28,22,49,36
68460,788,408,380,171,126,295,196
68461,734,386,348,231,102,262,139
68462,3827,1915,1912,1278,1014,946,589
68463,1517,761,756,419,329,455,314
68464,478,248,230,94,79,153,152
68465,2404,1206,1198,648,567,662,527
68466,1861,893,968,450,324,556,531
68467,9338,4478,4860,2380,2305,2532,2121
68502,26238,13754,12484,6279,9084,7174,3701
68503,15264,8047,7217,4102,6663,3091,1408
68504,16444,7983,8461,3997,7051,3323,2073
68505,15137,7331,7806,3702,4972,3465,2998
68506,27952,13011,14941,6294,7482,6947,7229
68507,13429,6778,6651,3286,3797,3723,2623
68508,14475,7897,6578,4984,6970,1700,821
68510,20514,9843,10671,4899,5978,5154,4483
68512,11659,5754,5905,3432,3368,3188,1671
68514,127,73,54,33,28,44,22
68516,38956,18813,20143,10883,9872,11101,7100
68517,538,278,260,159,109,177,93
68520,1143,552,591,217,162,358,406
68521,31733,16034,15699,9308,11423,7329,3673
68522,12728,7034,5694,3494,5121,3093,1020
68523,1390,689,701,415,187,531,257
68524,5983,3008,2975,2154,2107,1244,478
68526,4800,2370,2430,1603,1086,1476,635
68527,696,354,342,176,69,273,178
68528,6285,3213,3072,1531,2796,1296,662
68531,48,26,22,13,2,19,14
68532,493,260,233,131,73,205,84
68601,28185,14041,14144,8126,6618,7811,5630
68620,2967,1462,1505,768,523,879,797
68621,517,259,258,122,93,158,144
68622,275,138,137,73,50,77,75
68623,313,164,149,81,58,113,61
68624,1062,535,527,296,185,316,265
68626,614,321,293,134,95,210,175
68627,622,324,298,153,108,198,163
68628,826,409,417,217,148,266,195
68629,1344,662,682,334,260,421,329
68631,480,242,238,144,97,140,99
68632,3989,1948,2041,1129,782,1063,1015
68633,1179,597,582,299,185,347,348
68634,345,187,158,95,80,99,71
68635,491,245,246,121,78,167,125
68636,1254,606,648,310,177,386,381
68637,267,128,139,49,29,92,97
68638,1749,861,888,441,308,469,531
68640,1613,814,799,433,354,460,366
68641,1063,548,515,265,182,337,279
68642,1721,899,822,515,332,515,359
68643,903,461,442,206,185,297,215
68644,721,374,347,204,128,225,164
68647,646,332,314,166,121,202,157
68648,484,249,235,124,86,137,137
68649,1835,914,921,484,350,526,475
68651,1470,716,754,397,254,440,379
68652,715,354,361,181,111,237,186
68653,783,412,371,224,151,242,166
68654,541,274,267,118,94,168,161
68655,159,89,70,49,30,41,39
68658,683,350,333,174,122,208,179
68659,215,113,102,57,52,63,43
68660,1137,568,569,292,213,311,321
68661,7282,3799,3483,2575,2025,1656,1026
68662,1231,616,615,355,237,364,275
68663,761,397,364,206,149,217,189
68664,300,149,151,91,54,84,71
68665,940,474,466,265,158,259,258
68666,1611,795,816,424,266,423,498
68667,92,47,45,26,16,27,23
68669,422,220,202,114,78,127,103
68701,30670,15198,15472,8758,7858,8240,5814
68710,830,411,419,251,154,225,200
68711,141,77,64,32,15,45,49
68713,2212,1077,1135,544,371,665,632
68714,1224,607,617,254,224,361,385
68715,1446,706,740,445,284,414,303
68716,1011,501,510,224,164,260,363
68717,198,100,98,50,39,59,50
68718,1765,874,891,377,295,522,571
68719,126,69,57,22,12,40,52
68720,340,180,160,79,60,116,85
68722,555,266,289,137,96,137,185
68723,566,302,264,145,120,165,136
68724,140,72,68,32,23,57,28
68725,501,249,252,114,72,137,178
68726,893,457,436,291,191,233,178
68727,730,360,370,157,97,233,243
68728,254,133,121,72,39,92,51
68729,1745,816,929,451,284,468,542
68730,1860,930,930,498,327,567,468
68731,2637,1352,1285,785,639,741,472
68732,260,118,142,74,45,80,61
68733,1286,630,656,334,247,374,331
68734,155,78,77,58,27,49,21
68735,922,476,446,250,166,296,210
68736,726,381,345,230,124,226,146
68739,3002,1555,1447,921,524,810,747
68740,892,472,420,255,201,294,142
68741,790,405,385,235,158,247,150
68742,243,129,114,53,42,83,65
68743,693,359,334,200,144,225,124
68745,1572,765,807,428,322,413,409
68746,480,238,242,123,68,127,162
68747,174,88,86,49,32,53,40
68748,3260,1671,1589,1075,739,887,559
68749,65,33,32,14,9,22,20
68751,76,38,38,23,14,19,20
68752,789,415,374,180,178,254,177
68753,111,62,49,25,15,41,30
68755,259,131,128,46,40,82,91
68756,2058,998,1060,493,364,549,652
68757,754,387,367,208,143,216,187
68758,1164,569,595,286,176,361,341
68759,295,148,147,65,38,99,93
68760,1364,689,675,444,261,335,324
68761,434,216,218,94,83,136,121
68763,4887,2415,2472,1290,924,1435,1238
68764,753,379,374,186,124,224,219
68765,1380,684,696,416,252,371,341
68766,393,202,191,87,70,128,108
68767,3174,1628,1546,910,645,949,670
68768,642,333,309,151,114,217,160
68769,1806,898,908,459,345,493,509
68770,1552,771,781,398,284,459,411
68771,1637,823,814,424,261,512,440
68773,173,92,81,41,35,62,35
68774,348,192,156,88,66,116,78
68776,15447,7674,7773,5290,4170,3694,2293
68777,774,380,394,172,122,222,258
68778,572,281,291,128,77,161,206
68779,2433,1152,1281,698,465,687,583
68780,1028,510,518,245,181,306,296
68781,1407,699,708,352,325,378,352
68783,1086,529,557,260,144,301,381
68784,2104,1037,1067,586,457,581,480
68785,274,139,135,84,45,91,54
68786,1079,538,541,312,184,260,323
68787,6647,3294,3353,1908,2373,1238,1128
68788,4898,2422,2476,1366,896,1349,1287
68789,176,96,80,33,21,75,47
68790,777,382,395,224,161,232,160
68791,1800,893,907,486,348,508,458
68792,407,205,202,104,61,117,125
68801,30005,15326,14679,9500,8378,7392,4735
68803,22560,10921,11639,6140,5255,6231,4934
68810,1109,565,544,363,274,294,178
68812,785,418,367,215,169,246,155
68813,534,290,244,146,98,155,135
68814,911,472,439,223,156,285,247
68815,596,305,291,146,104,180,166
68816,180,97,83,58,35,56,31
68817,386,191,195,86,64,119,117
68818,5475,2685,2790,1563,1113,1513,1286
68820,391,197,194,84,62,134,111
68821,134,74,60,34,17,43,40
68822,4834,2338,2496,1282,988,1269,1295
68823,2401,1191,1210,539,355,701,806
68824,1414,710,704,401,326,412,275
68825,1024,494,530,251,163,307,303
68826,3955,1894,2061,1103,795,1040,1017
68827,693,346,347,185,125,237,146
68828,240,125,115,56,34,82,68
68831,812,433,379,240,114,256,202
68832,1974,1004,970,544,392,640,398
68833,299,149,150,79,46,95,79
68834,226,119,107,51,44,75,56
68835,485,255,230,119,104,151,111
68836,1688,834,854,510,381,496,301
68837,103,48,55,28,15,30,30
68838,301,156,145,80,63,81,77
68840,2945,1473,1472,895,677,802,571
68841,610,314,296,180,112,187,131
68842,668,342,326,145,123,189,211
68843,806,407,399,214,138,271,183
68844,228,121,107,55,43,70,60
68845,19523,9756,9767,5851,6534,4379,2759
68846,296,160,136,68,44,120,64
68847,16504,8108,8396,4283,5272,3930,3019
68849,384,122,262,112,272,0,0
68850,12295,6356,5939,4257,3250,3019,1769
68852,565,272,293,165,83,171,146
68853,1559,754,805,341,268,429,521
68854,731,379,352,194,111,249,177
68855,417,201,216,106,82,115,114
68856,611,312,299,162,120,184,145
68858,266,140,126,66,57,73,70
68859,509,262,247,111,83,141,174
68860,324,168,156,70,54,107,93
68861,118,58,60,30,26,37,25
68862,3007,1480,1527,723,573,816,895
68863,1151,610,541,338,264,342,207
68864,1027,529,498,243,221,316,247
68865,894,456,438,230,164,321,179
68866,850,440,410,231,179,248,192
68869,2202,1071,1131,594,416,637,555
68870,439,223,216,111,109,131,88
68871,250,131,119,64,36,68,82
68872,853,436,417,238,181,245,189
68873,3289,1635,1654,888,662,867,872
68874,956,482,474,250,156,279,271
68875,658,336,322,182,132,169,175
68876,1545,770,775,477,317,466,285
68878,446,222,224,144,88,127,87
68879,417,208,209,110,71,121,115
68881,73,35,38,25,19,21,8
68882,473,238,235,118,90,133,132
68883,2411,1219,1192,696,505,667,543
68901,26354,13051,13303,7295,6734,6759,5566
68920,1446,708,738,334,235,406,471
68922,1336,637,699,351,223,386,376
68923,131,62,69,39,30,45,17
68924,1180,586,594,348,263,343,226
68925,474,242,232,141,67,167,99
68926,783,390,393,198,123,199,263
68927,1164,584,580,314,207,333,310
68928,426,201,225,127,72,136,91
68929,160,87,73,36,20,48,56
68930,1461,679,782,418,252,418,373
68932,493,245,248,117,89,129,158
68933,932,466,466,238,180,285,229
68934,188,104,84,54,37,58,39
68935,750,381,369,191,138,190,231
68936,243,131,112,69,42,65,67
68937,1836,899,937,384,283,551,618
68938,582,304,278,162,104,191,125
68939,1318,624,694,332,204,351,431
68940,496,265,231,124,97,169,106
68941,832,413,419,226,173,242,191
68942,490,258,232,112,78,141,159
68943,269,143,126,67,50,73,79
68944,1323,656,667,415,262,367,279
68945,213,117,96,67,48,56,42
68946,53,33,20,8,7,23,15
68947,549,276,273,128,103,174,144
68948,363,180,183,88,71,112,92
68949,6567,3198,3369,1698,1348,1799,1722
68950,331,188,143,90,73,94,74
68952,172,93,79,25,29,71,47
68954,94,44,50,22,13,26,33
68955,2025,1034,991,654,360,686,325
68956,1215,600,615,351,241,348,275
68957,631,330,301,167,100,198,166
68958,661,346,315,204,139,184,134
68959,4015,1931,2084,1034,791,1140,1050
68960,183,95,88,36,30,51,66
68961,732,368,364,150,127,203,252
68964,135,70,65,34,26,50,25
68966,674,353,321,157,117,209,191
68967,1142,580,562,306,191,350,295
68969,38,17,21,7,1,19,11
68970,1342,636,706,286,199,360,497
68971,458,234,224,80,52,139,187
68972,209,115,94,38,31,71,69
68973,463,239,224,129,87,156,91
68974,184,97,87,34,28,65,57
68975,160,83,77,49,35,48,28
68976,316,170,146,87,67,91,71
68977,342,165,177,94,53,95,100
68978,2307,1080,1227,482,372,618,835
68979,1888,936,952,520,348,514,506
68980,388,204,184,120,74,119,75
68981,314,166,148,82,56,102,74
68982,649,330,319,164,109,208,168
69001,9449,4679,4770,2494,2142,2541,2272
69020,397,186,211,96,67,124,110
69021,1348,649,699,326,233,378,411
69022,1570,770,800,374,252,445,499
69023,440,229,211,112,81,130,117
69024,1195,592,603,306,217,358,314
69025,1220,605,615,381,306,268,265
69026,220,107,113,60,34,64,62
69027,133,71,62,28,25,43,37
69028,731,370,361,170,101,253,207
69029,316,156,160,67,56,79,114
69030,324,183,141,71,55,98,100
69032,498,250,248,122,96,156,124
69033,2577,1270,1307,702,553,719,603
69034,908,469,439,233,151,298,226
69036,126,69,57,33,24,40,29
69037,115,56,59,31,20,26,38
69038,449,231,218,109,98,133,109
69039,139,70,69,25,28,55,31
69040,634,333,301,140,118,190,186
69041,161,86,75,45,37,45,34
69042,36,16,20,3,2,9,22
69043,549,271,278,124,82,154,189
69044,825,409,416,165,153,239,268
69045,975,485,490,213,163,277,322
69046,194,100,94,35,16,82,61
69101,29904,14741,15163,8166,7300,8073,6365
69120,931,463,468,198,172,261,300
69121,400,199,201,112,77,95,116
69122,619,316,303,124,117,203,175
69123,935,466,469,290,163,267,215
69125,346,182,164,82,66,102,96
69127,739,376,363,136,121,215,267
69128,302,158,144,53,49,107,93
69129,1368,664,704,330,220,400,418
69130,5307,2619,2688,1486,1146,1434,1241
69131,561,289,272,146,102,150,163
69132,117,49,68,41,20,36,20
69133,386,198,188,97,86,110,93
69134,364,196,168,97,60,121,86
69135,65,31,34,14,14,20,17
69138,4489,2171,2318,1319,887,1179,1104
69140,1775,876,899,455,351,470,499
69141,385,203,182,88,64,146,87
69142,137,75,62,42,17,40,38
69143,1460,731,729,397,279,445,339
69144,202,109,93,43,36,57,66
69145,3214,1593,1621,800,583,892,939
69146,334,178,156,37,39,93,165
69147,737,385,352,108,87,223,319
69148,217,118,99,48,44,62,63
69149,699,368,331,139,113,243,204
69150,522,273,249,160,127,123,112
69151,815,418,397,238,154,245,178
69152,886,416,470,210,151,245,280
69153,5769,2846,2923,1431,1114,1673,1551
69154,1291,641,650,289,203,381,418
69155,1034,535,499,277,200,313,244
69156,699,354,345,155,107,253,184
69157,21,11,10,3,0,8,10
69161,81,43,38,18,10,28,25
69162,7765,3813,3952,2097,1972,2145,1551
69163,873,434,439,224,166,255,228
69165,1789,905,884,531,348,488,422
69166,600,307,293,144,108,191,157
69167,441,224,217,133,74,131,103
69168,271,141,130,55,43,92,81
69169,651,313,338,186,121,179,165
69170,372,196,176,98,76,125,73
69171,26,13,13,5,4,10,7
69201,3738,1806,1932,864,744,1075,1055
69210,2484,1197,1287,576,424,715,769
69211,311,157,154,91,60,87,73
69212,159,82,77,38,31,53,37
69214,203,110,93,40,30,87,46
69216,164,91,73,50,25,51,38
69217,533,263,270,143,107,122,161
69218,260,137,123,56,54,75,75
69219,80,43,37,21,21,23,15
69220,59,33,26,8,10,28,13
69221,222,127,95,56,52,45,69
69301,10125,4972,5153,2782,2185,3009,2149
69331,59,25,34,12,10,26,11
69333,239,139,100,59,45,79,56
69334,2351,1188,1163,620,453,682,596
69335,53,32,21,11,10,15,17
69336,2466,1202,1264,650,494,692,630
69337,7365,3700,3665,2080,2418,1536,1331
69339,1462,686,776,301,216,406,539
69340,121,68,53,32,24,35,30
69341,11165,5300,5865,3168,2631,2889,2477
69343,2538,1232,1306,666,457,690,725
69345,455,226,229,119,75,145,116
69346,592,308,284,120,105,188,179
69347,1249,599,650,242,202,374,431
69348,1503,749,754,386,267,489,361
69350,383,197,186,74,56,143,110
69351,235,121,114,60,58,70,47
69352,619,315,304,171,131,172,145
69353,37,18,19,14,7,8,8
69354,97,50,47,22,13,40,22
69355,115,59,56,37,24,28,26
69356,1882,948,934,506,391,573,412
69357,3567,1734,1833,929,729,1036,873
69358,1907,943,964,483,419,582,423
69360,1361,626,735,372,273,344,372
69361,17999,8664,9335,4992,4424,4554,4029
69365,44,24,20,15,6,17,6
69366,253,137,116,74,65,66,48
69367,259,125,134,52,48,80,79
80758,4,1,3,0,2,1,1
82082,19,9,10,4,3,1,11
84034,21,12,9,5,7,4,5
89001,1224,630,594,387,233,305,299
89002,31880,15834,16046,9883,8334,8997,4666
89003,1032,550,482,204,165,335,328
89004,313,148,165,63,47,120,83
89005,15065,7498,7567,3103,2430,4515,5017
89007,1351,691,660,558,288,330,175
89008,1508,803,705,465,303,354,386
89010,384,215,169,90,70,98,126
89011,19550,9833,9717,4994,6182,5414,2960
89012,29085,14322,14763,6824,7113,7787,7361
89013,285,158,127,38,31,74,142
89014,36922,18256,18666,9197,11583,10320,5822
89015,38993,19357,19636,10795,9521,11209,7468
89017,176,90,86,50,30,62,34
89018,1007,521,486,233,200,338,236
89019,2604,1340,1264,532,461,914,697
89020,1456,789,667,441,315,356,344
89021,3605,1840,1765,1366,680,1005,554
89022,69,36,33,6,6,30,27
89025,1400,705,695,511,341,374,174
89026,150,7,143,1,90,57,2
89027,15275,7507,7768,3365,2433,3515,5962
89029,7546,3805,3741,1196,1148,1957,3245
89030,53928,27896,26032,20947,15848,11874,5259
89031,60589,30048,30541,20024,17870,15904,6791
89032,40297,19748,20549,13428,11222,10444,5203
89039,316,160,156,22,16,73,205
89040,3721,1857,1864,1076,672,974,999
89042,1010,503,507,340,178,245,247
89043,1429,852,577,339,354,368,368
89044,14260,6964,7296,2279,2991,3745,5245
89045,1505,784,721,451,390,445,219
89046,660,348,312,83,72,203,302
89047,107,61,46,17,16,41,33
89048,21169,10478,10691,4761,3394,5834,7180
89049,2727,1440,1287,734,656,881,456
89052,47214,22845,24369,10938,10716,12916,12644
89054,105,49,56,16,20,38,31
89060,10197,5164,5033,2183,1506,2955,3553
89061,5201,2645,2556,1104,865,1467,1765
89074,47095,23019,24076,11444,12307,14420,8924
89081,29774,14845,14929,10427,10695,6359,2293
89084,21837,10707,11130,6287,6678,5078,3794
89085,3367,1667,1700,1138,1175,776,278
89086,4726,2340,2386,1775,1800,887,264
89101,46055,27221,18834,13463,14677,12484,5431
89102,35759,18633,17126,10102,10724,8613,6320
89103,50519,26351,24168,10392,16368,13915,9844
89104,39909,20874,19035,11055,10747,10945,7162
89106,25759,12906,12853,8598,7293,6249,3619
89107,36282,18398,17884,10899,9763,9454,6166
89108,70123,35077,35046,20708,20879,17887,10649
89109,7770,4343,3427,1074,2361,2277,2058
89110,70994,35522,35472,25397,19996,17146,8455
89113,23800,11851,11949,5213,8193,6544,3850
89115,58794,29395,29399,22154,19539,12685,4416
89117,55416,27312,28104,11667,15807,16674,11268
89118,19318,9900,9418,3934,6407,5841,3136
89119,49445,26379,23066,12489,17204,12817,6935
89120,23311,11668,11643,5343,6266,6582,5120
89121,64096,32082,32014,15630,17191,17258,14017
89122,45720,22522,23198,12171,13028,11709,8812
89123,56300,28285,28015,12757,17397,16683,9463
89124,941,517,424,165,179,337,260
89128,35669,17241,18428,9316,9657,10118,6578
89129,51252,24875,26377,14383,13841,15099,7929
89130,33015,16196,16819,8915,7627,9789,6684
89131,43072,21291,21781,13502,11224,12626,5720
89134,24040,11174,12866,3285,2338,5356,13061
89135,24144,11681,12463,5437,5392,7002,6313
89138,12118,6081,6037,3815,3693,3439,1171
89139,30477,15363,15114,8307,12057,7363,2750
89141,25150,12598,12552,7416,9010,6221,2503
89142,33731,16600,17131,11460,9754,8915,3602
89143,12786,6302,6484,4610,3657,3295,1224
89144,18714,9122,9592,5180,4254,6012,3268
89145,23186,11323,11863,5585,5939,6934,4728
89146,19071,9804,9267,4504,5502,5295,3770
89147,49778,24522,25256,11830,14186,14741,9021
89148,39712,19739,19973,10994,15144,9748,3826
89149,31143,15324,15819,8551,9701,8440,4451
89156,27794,13822,13972,9191,7671,7353,3579
89161,184,94,90,31,35,76,42
89166,13209,9084,4125,2823,6705,3103,578
89169,23304,12906,10398,5645,7542,6451,3666
89178,27588,13882,13706,7758,11824,6097,1909
89179,2340,1242,1098,704,1083,410,143
89183,36005,17830,18175,10336,13805,8606,3258
89191,857,711,146,202,654,0,1
89301,7606,4429,3177,1707,2053,2302,1544
89310,550,286,264,99,98,176,177
89311,235,119,116,43,48,74,70
89314,158,73,85,43,31,54,30
89316,1408,728,680,399,305,449,255
89317,477,258,219,143,96,125,113
89318,1219,614,605,315,249,345,310
89319,450,229,221,128,109,140,73
89402,71,35,36,8,19,23,21
89403,14158,7086,7072,3897,3204,4183,2874
89404,52,27,25,2,8,15,27
89405,239,131,108,82,50,87,20
89406,24772,12453,12319,6814,5912,6669,5377
89408,19626,9866,9760,5867,4954,5288,3517
89409,283,151,132,58,48,86,91
89410,10557,5192,5365,2476,1943,2997,3141
89411,929,466,463,164,96,297,372
89412,288,160,128,47,40,117,84
89413,655,342,313,62,50,197,346
89414,349,198,151,77,68,126,78
89415,3793,1873,1920,753,674,1129,1237
89418,388,203,185,80,69,113,126
89419,5150,3434,1716,1045,1477,1762,866
89420,48,27,21,6,8,14,20
89421,541,282,259,160,117,135,129
89422,165,85,80,11,15,42,97
89423,10465,5156,5309,2275,1532,3358,3300
89424,341,177,164,93,90,108,50
89425,432,242,190,118,120,108,86
89426,208,112,96,43,37,75,53
89427,746,352,394,202,171,219,154
89428,179,95,84,24,21,63,71
89429,7627,3925,3702,1701,1243,2497,2186
89430,433,226,207,96,68,147,122
89431,36189,18096,18093,10585,10239,9424,5941
89433,20188,10188,10000,6560,5133,5561,2934
89434,25416,12361,13055,6489,6670,6987,5270
89436,36867,18310,18557,10876,9772,10748,5471
89438,48,30,18,5,7,27,9
89439,1337,694,643,211,214,497,415
89440,947,485,462,169,124,343,311
89441,11542,5788,5754,3551,2465,3702,1824
89442,1118,520,598,342,272,298,206
89444,2734,1394,1340,423,344,910,1057
89445,16114,8395,7719,4866,4014,4747,2487
89446,36,17,19,18,14,2,2
89447,7931,3972,3959,2058,1398,2012,2463
89448,1695,896,799,237,281,562,615
89449,2994,1701,1293,526,782,1100,586
89450,86,46,40,5,25,22,34
89451,8930,4621,4309,1734,2029,2715,2452
89460,13236,6504,6732,3241,2582,4071,3342
89501,4252,2715,1537,397,1215,1560,1080
89502,43566,22388,21178,12259,12994,11310,7003
89503,27891,14574,13317,6370,10108,6708,4705
89506,38379,19975,18404,11576,11588,10384,4831
89508,11662,5988,5674,3322,2678,3852,1810
89509,33395,16466,16929,6749,8393,9468,8785
89510,1685,851,834,353,260,632,440
89511,25011,12451,12560,5933,4526,8422,6130
89512,25574,13076,12498,7503,8035,5794,4242
89519,8392,4139,4253,1895,1219,2745,2533
89521,25716,12638,13078,6794,7221,7267,4434
89523,31373,15442,15931,7984,9753,8840,4796
89701,27625,15154,12471,6494,7233,8255,5643
89702,0,0,0,0,0,0,0
89703,9714,4677,5037,1941,1476,2996,3301
89704,4290,2130,2160,808,608,1615,1259
89705,4969,2454,2515,1287,1028,1521,1133
89706,19510,9645,9865,5129,4834,5302,4245
89801,23298,11937,11361,7352,6609,6304,3033
89815,13346,6940,6406,4340,3064,4138,1804
89820,5358,2712,2646,1691,1265,1542,860
89821,482,275,207,98,86,175,123
89822,2513,1387,1126,713,695,786,319
89823,273,140,133,96,50,73,54
89825,1228,619,609,413,282,381,152
89826,42,21,21,5,5,6,26
89828,268,131,137,50,31,93,94
89830,270,140,130,43,39,94,94
89831,78,43,35,12,15,22,29
89832,948,478,470,293,249,251,155
89833,201,114,87,44,46,58,53
89834,126,73,53,33,22,48,23
89835,1822,1002,820,476,429,575,342
89883,4488,2373,2115,1824,1233,1041,390
3031,11247,5537,5710,3176,1707,4153,2211
3032,4953,2504,2449,1279,898,1986,790
3033,4987,2539,2448,1678,864,1900,545
3034,3970,1998,1972,976,721,1543,730
3036,4782,2401,2381,1451,887,1797,647
3037,4219,2079,2140,1082,877,1557,703
3038,33269,16516,16753,9103,8400,11160,4606
3042,6341,3121,3220,1584,1590,2128,1039
3043,1573,791,782,371,240,587,375
3044,4263,2113,2150,1158,933,1510,662
3045,13560,6465,7095,3247,3186,4531,2596
3046,2758,1380,1378,729,519,1086,424
3047,1767,911,856,435,389,636,307
3048,3426,1724,1702,858,707,1221,640
3049,7688,3810,3878,2096,924,3016,1652
3051,24480,12121,12359,6701,5694,8185,3900
3052,8258,4133,4125,2492,1619,2937,1210
3053,23957,11875,12082,7094,4726,8629,3508
3054,25477,12679,12798,6766,5700,8723,4288
3055,15086,7377,7709,4126,3660,4700,2600
3057,2500,1243,1257,737,409,960,394
3060,29357,14310,15047,7450,9074,7850,4983
3062,26694,13199,13495,6455,6340,8601,5298
3063,16216,8115,8101,3806,4600,4866,2944
3064,14227,7037,7190,3656,3740,4450,2381
3070,5254,2637,2617,1532,1095,1894,733
3071,5109,2611,2498,1597,1212,1591,709
3076,12897,6429,6468,3659,2639,4533,2066
3077,10155,5091,5064,2449,2641,3522,1543
3079,28776,14253,14523,6939,5958,9698,6181
3082,1615,830,785,364,307,628,316
3084,1366,681,685,328,252,509,277
3086,3728,1847,1881,950,791,1309,678
3087,13592,6698,6894,4057,2298,4754,2483
3101,3049,1766,1283,459,1145,908,537
3102,31096,15039,16057,7490,10341,7792,5473
3103,36476,18329,18147,9880,11299,10015,5282
3104,32798,16007,16791,7334,10163,9302,5999
3106,13374,6469,6905,3462,3268,4326,2318
3109,10314,5130,5184,2588,2583,3318,1825
3110,21203,10367,10836,6439,3290,7277,4197
3215,247,124,123,44,20,92,91
3216,2159,1099,1060,616,435,677,431
3217,2076,996,1080,407,555,619,495
3218,960,485,475,244,216,326,174
3220,7430,3675,3755,1806,1700,2402,1522
3221,2091,1036,1055,484,395,767,445
3222,5353,2657,2696,1194,1122,1764,1273
3223,3427,1715,1712,755,759,1162,751
3224,2318,1147,1171,533,378,852,555
3225,3660,1841,1819,968,886,1174,632
3226,1117,545,572,215,186,363,353
3227,925,450,475,165,122,324,314
3229,5589,2732,2857,1412,892,1911,1374
3230,1231,626,605,273,262,452,244
3231,202,105,97,42,33,72,55
3233,115,54,61,22,13,36,44
3234,4572,2242,2330,1153,892,1541,986
3235,8562,4094,4468,2135,2119,2498,1810
3237,2254,1135,1119,503,476,789,486
3238,75,36,39,16,12,25,22
3240,1340,698,642,271,276,487,306
3241,876,452,424,154,147,257,318
3242,4836,2442,2394,1262,1401,1467,706
3243,1085,548,537,271,211,412,191
3244,8092,4068,4024,2068,2000,2646,1378
3245,2027,1018,1009,425,365,665,572
3246,15963,7605,8358,3631,3697,4644,3991
3249,7113,3459,3654,1618,1144,2406,1945
3251,1662,852,810,334,312,543,473
3253,6219,3004,3215,1259,1100,2026,1834
3254,4049,2009,2040,828,542,1346,1333
3255,2090,1068,1022,459,348,724,559
3256,2169,1111,1058,534,474,693,468
3257,4455,1930,2525,1104,797,914,1640
3258,2517,1289,1228,653,446,964,454
3259,368,184,184,64,46,145,113
3260,809,414,395,194,159,260,196
3261,4246,2147,2099,1079,899,1467,801
3262,1231,617,614,275,275,417,264
3263,4114,2042,2072,1056,1044,1321,693
3264,7468,3889,3579,2271,3019,1283,895
3266,2163,1121,1042,479,412,722,550
3268,1272,644,628,329,292,412,239
3269,2966,1452,1514,658,523,1103,682
3273,312,162,150,50,49,108,105
3275,11437,5605,5832,2915,2787,3816,1919
3276,8324,4189,4135,2008,1968,2707,1641
3278,2952,1459,1493,686,602,1010,654
3279,829,429,400,184,169,283,193
3280,1123,587,536,264,177,369,313
3281,8785,4472,4313,2571,1983,3216,1015
3282,902,455,447,179,188,276,259
3284,999,499,500,264,193,318,224
3285,2479,1246,1233,509,514,906,550
3287,1295,637,658,302,209,472,312
3290,4731,2394,2337,1239,1094,1694,704
3291,39,22,17,7,8,8,16
3293,143,77,66,25,21,45,52
3301,33008,16520,16488,7488,8979,9776,6765
3303,15524,7597,7927,3739,4167,4810,2808
3304,7519,3660,3859,2168,1040,2835,1476
3307,5334,2644,2690,1356,1150,1901,927
3431,25280,11900,13380,6177,7638,6295,5170
3440,2692,1331,1361,695,526,926,545
3441,395,197,198,107,98,126,64
3442,1491,774,717,424,372,490,205
3443,742,381,361,173,132,256,181
3444,1590,788,802,365,294,545,386
3445,691,348,343,147,159,245,140
3446,6285,3064,3221,1479,1458,2044,1304
3447,2422,1202,1220,565,494,847,516
3448,811,411,400,174,185,283,169
3449,1654,784,870,319,241,587,507
3450,961,447,514,157,138,362,304
3451,4077,2041,2036,974,912,1318,873
3452,5457,2637,2820,1425,1184,1637,1211
3455,2086,1016,1070,458,485,662,481
3456,742,390,352,138,130,296,178
3457,852,435,417,194,165,287,206
3458,6643,3109,3534,1548,1157,2018,1920
3461,6014,3056,2958,1783,1764,1551,916
3462,1562,792,770,323,296,565,378
3464,1109,558,551,247,200,365,297
3465,2156,1075,1081,549,592,649,366
3466,1332,667,665,304,232,499,297
3467,1842,925,917,356,367,626,493
3470,5033,2487,2546,1268,1121,1582,1062
3561,5939,2824,3115,1390,1256,1780,1513
3570,10051,5303,4748,2043,2332,3078,2598
3574,2526,1279,1247,581,489,925,531
3575,124,74,50,10,55,34,25
3576,3238,1637,1601,674,616,1070,878
3579,358,193,165,41,62,134,121
3580,1369,658,711,232,164,469,504
3581,3230,1622,1608,671,577,1100,882
3582,2577,1307,1270,591,511,814,661
3583,1107,554,553,229,178,386,314
3584,3774,1816,1958,921,744,1119,990
3585,2519,1256,1263,563,488,886,582
3586,547,272,275,104,62,216,165
3588,1641,838,803,335,286,650,370
3590,1052,525,527,229,192,333,298
3592,1145,590,555,186,162,354,443
3593,313,155,158,37,37,123,116
3595,639,319,320,123,125,200,191
3597,521,253,268,115,112,133,161
3598,3285,1616,1669,731,653,1085,816
3601,477,248,229,98,93,167,119
3602,2654,1316,1338,609,541,847,657
3603,5412,2681,2731,1252,1118,1784,1258
3604,69,30,39,22,15,18,14
3605,1160,593,567,249,220,451,240
3607,322,168,154,47,51,124,100
3608,2811,1379,1432,626,499,948,738
3609,854,412,442,242,217,244,151
3740,911,482,429,208,179,294,230
3741,4208,2100,2108,952,992,1448,816
3743,14103,6906,7197,3330,3508,4115,3150
3745,1424,714,710,282,248,529,365
3746,216,107,109,46,35,78,57
3748,4762,2317,2445,1013,1132,1585,1032
3750,870,427,443,241,92,326,211
3751,583,270,313,127,129,185,142
3752,810,409,401,162,159,290,199
3753,2971,1445,1526,665,511,945,850
3754,86,41,45,20,39,17,10
3755,10538,5161,5377,2918,4009,1828,1783
3765,503,242,261,109,79,172,143
3766,8958,4273,4685,1819,2655,2692,1792
3768,1716,838,878,411,233,605,467
3770,524,264,260,148,110,188,78
3771,754,367,387,167,113,270,204
3773,7841,3842,3999,1881,1682,2474,1804
3774,1966,1009,957,389,430,618,529
3777,1237,602,635,281,267,393,296
3779,790,390,400,164,153,278,195
3780,410,190,220,82,102,111,115
3781,1840,918,922,427,287,721,405
3782,2945,1481,1464,645,570,931,799
3784,4086,1916,2170,844,1261,993,988
3785,2400,1177,1223,522,525,730,623
3801,21532,10451,11081,3868,6689,6220,4755
3809,3716,1848,1868,930,696,1226,864
3810,1538,790,748,297,240,526,475
3811,6753,3283,3470,1561,1058,2406,1728
3812,824,421,403,163,153,262,246
3813,3250,1633,1617,710,644,1116,780
3814,2329,1173,1156,528,439,771,591
3816,1368,678,690,321,224,465,358
3817,574,295,279,102,98,209,165
3818,3807,1867,1940,882,837,1226,862
3819,4377,2219,2158,1223,866,1652,636
3820,30039,14716,15323,6668,9710,8307,5354
3823,1719,888,831,488,355,611,265
3824,14638,6756,7882,5191,6233,1803,1411
3825,8512,4276,4236,2235,1918,3090,1269
3826,2470,1221,1249,561,434,958,517
3827,3150,1537,1613,779,521,1134,716
3830,1610,811,799,319,277,521,493
3832,395,205,190,53,66,134,142
3833,20955,10110,10845,5404,3841,7057,4653
3835,6786,3370,3416,1786,1693,2191,1116
3836,1489,750,739,262,186,483,558
3837,1519,743,776,430,318,500,271
3838,1031,504,527,199,176,333,323
3839,3735,1815,1920,971,990,1152,622
3840,3566,1741,1825,908,652,1263,743
3841,6334,3147,3187,1629,1043,2278,1384
3842,15345,7656,7689,2978,3049,5315,4003
3844,2238,1124,1114,580,343,833,482
3845,991,498,493,169,191,344,287
3846,799,413,386,112,104,270,313
3847,294,158,136,57,56,92,89
3848,6020,2963,3057,1414,1232,2208,1166
3849,1585,795,790,365,282,578,360
3850,372,185,187,53,41,126,152
3851,4040,2007,2033,1013,928,1395,704
3852,558,256,302,149,121,186,102
3853,602,311,291,95,90,156,261
3854,968,443,525,162,84,322,400
3855,2638,1348,1290,672,507,960,499
3856,1680,854,826,516,234,677,253
3857,9006,4464,4542,1956,3085,2609,1356
3858,4603,2264,2339,1259,1017,1633,694
3860,4056,1973,2083,783,906,1201,1166
3861,4330,2190,2140,1162,921,1556,691
3862,4278,2087,2191,954,584,1622,1118
3864,1696,837,859,350,319,527,500
3865,7609,3749,3860,1965,1653,2600,1391
3867,20758,10008,10750,4922,5083,6273,4480
3868,5323,2585,2738,1307,1314,1506,1196
3869,2469,1216,1253,617,534,831,487
3870,5162,2519,2643,1112,751,1851,1448
3871,136,64,72,35,13,45,43
3872,3809,1888,1921,877,737,1275,920
3873,5711,2879,2832,1584,1225,2141,761
3874,8776,4360,4416,1816,1921,2832,2207
3875,833,422,411,158,125,299,251
3878,11824,5641,6183,2984,3335,3503,2002
3882,1465,728,737,317,272,559,317
3883,178,89,89,29,30,82,37
3884,3964,1998,1966,1048,694,1573,649
3885,7261,3539,3722,2064,1150,2708,1339
3886,2112,1032,1080,461,392,711,548
3887,2154,1116,1038,546,536,739,333
3890,327,173,154,49,52,138,88
3894,6314,3020,3294,1241,821,1949,2303
7001,16305,9180,7125,3494,5227,5300,2284
7002,63031,30149,32882,15770,17177,18278,11806
7003,47312,22363,24949,11244,14130,13739,8199
7004,7440,3613,3827,1839,1369,2185,2047
7005,15269,7621,7648,3747,3360,4968,3194
7006,24812,11904,12908,6262,4848,7910,5792
7008,22844,11088,11756,6529,6446,6417,3452
7009,12411,5773,6638,2689,2330,3581,3811
7010,23594,11392,12202,4490,7134,6449,5521
7011,39710,19309,20401,11057,11520,11005,6128
7012,11703,5590,6113,2479,3337,3317,2570
7013,27051,12931,14120,5615,6852,7926,6658
7014,5184,2503,2681,1313,1483,1438,950
7016,22625,10825,11800,5856,4443,7203,5123
7017,35945,16198,19747,10130,9931,9615,6269
7018,28322,12609,15713,8188,8159,7527,4448
7020,11513,5460,6053,2145,4417,3038,1913
7021,2091,1014,1077,655,248,716,472
7022,13835,7288,6547,3055,5000,3539,2241
7023,7318,3566,3752,2127,1450,2337,1404
7024,35353,16436,18917,6515,8709,9967,10162
7026,30555,14580,15975,7877,9356,8427,4895
7027,4226,2047,2179,882,1130,1320,894
7028,7618,3726,3892,2589,1181,2756,1092
7029,16026,8214,7812,3719,5897,4215,2195
7030,50005,25231,24774,7159,29728,8742,4376
7031,15392,7370,8022,3020,4375,4537,3460
7032,40684,20936,19748,9517,12934,11845,6388
7033,7914,3832,4082,1918,1927,2376,1693
7034,9360,4648,4712,2181,2777,2843,1559
7035,10607,5153,5454,2185,2507,3518,2397
7036,41970,19989,21981,10229,11401,12322,8018
7039,29358,14267,15091,8412,4692,9440,6814
7040,23876,11351,12525,7263,4839,7968,3806
7041,6868,3323,3545,2045,1318,2369,1136
7042,25599,11858,13741,6554,6692,8141,4212
7043,12138,5765,6373,3756,1972,4339,2071
7044,13584,6378,7206,3318,2584,4197,3485
7045,10127,4854,5273,2621,1473,3475,2558
7046,4194,2097,2097,1536,429,1584,645
7047,60773,29514,31259,14594,18354,16684,11141
7050,30074,14177,15897,8247,9291,7767,4769
7052,46182,21650,24532,11874,10804,13429,10075
7054,29305,14457,14848,6468,8098,8751,5988
7055,69816,35071,34745,24222,22125,15493,7976
7057,11335,5505,5830,2275,3457,3374,2229
7058,5372,2693,2679,1561,1278,1659,874
7059,15311,7480,7831,4564,2153,5621,2973
7060,44998,23091,21907,12337,14607,12038,6016
7062,12949,6174,6775,3550,3477,3809,2113
7063,13538,6697,6841,4162,4174,3532,1670
7064,3723,1824,1899,934,857,1130,802
7065,27346,13036,14310,6640,7521,8058,5127
7066,14756,7096,7660,3420,3143,4616,3577
7067,18036,8704,9332,4548,3832,5939,3717
7068,5819,2761,3058,1310,990,1795,1724
7069,6157,2953,3204,1523,974,1923,1737
7070,18061,8686,9375,4273,4667,5603,3518
7071,20554,9880,10674,4308,5885,5970,4391
7072,6127,2987,3140,1387,1628,1836,1276
7073,8913,4294,4619,1800,2949,2457,1707
7074,2708,1335,1373,556,651,915,586
7075,7626,3681,3945,1800,1670,2529,1627
7076,23480,11216,12264,6500,4938,7454,4588
7077,2766,1332,1434,670,684,899,513
7078,13250,6494,6756,4770,1565,4768,2147
7079,16316,7888,8428,4559,4360,4815,2582
7080,23377,11349,12028,5890,5733,7280,4474
7081,15808,7435,8373,3580,3699,4787,3742
7082,5384,2655,2729,1592,890,1917,985
7083,53053,25224,27829,13033,13746,16037,10237
7086,12554,6121,6433,2267,4674,3528,2085
7087,66515,33328,33187,17658,21992,17181,9684
7088,3606,1568,2038,945,895,996,770
7090,30338,14593,15745,9604,5027,10114,5593
7092,6730,3236,3494,1657,924,2126,2023
7093,60884,30116,30768,14140,21359,15601,9784
7094,16264,7910,8354,3489,4591,4688,3496
7095,19844,9576,10268,4820,6244,5518,3262
7102,12579,6871,5708,2909,4569,3085,2016
7103,32698,15149,17549,10781,10109,7780,4028
7104,50478,24713,25765,14953,16266,12682,6577
7105,46983,25777,21206,10413,18886,12405,5279
7106,31298,14358,16940,9247,9137,8263,4651
7107,37650,18009,19641,12366,11898,9171,4215
7108,24386,10811,13575,8335,6790,6074,3187
7109,35897,17310,18587,8700,10911,10182,6104
7110,28351,13345,15006,6452,7368,8742,5789
7111,53942,25288,28654,15326,16393,14648,7575
7112,26417,11891,14526,8135,7463,6980,3839
7114,14748,9581,5167,3033,6405,4155,1155
7201,26263,13168,13095,7507,8436,7072,3248
7202,40849,20432,20417,10901,13060,10715,6173
7203,21085,10021,11064,5536,5891,5984,3674
7204,13297,6477,6820,3323,3762,4029,2183
7205,21398,9942,11456,5653,5650,6299,3796
7206,26636,13161,13475,9072,8732,6250,2582
7208,31219,15277,15942,8136,9442,8921,4720
7302,36352,18613,17739,5501,19114,7952,3785
7304,41233,19557,21676,11615,12787,11124,5707
7305,60104,27728,32376,16926,17813,15812,9553
7306,52669,27413,25256,11909,20031,13185,7544
7307,43812,21884,21928,10800,15468,11450,6094
7310,12838,6789,6049,1577,9049,1703,509
7311,522,284,238,55,336,112,19
7401,6494,3136,3358,1995,857,2325,1317
7403,7603,3739,3864,1755,1828,2441,1579
7405,17701,8856,8845,4683,3575,6100,3343
7407,19403,9271,10132,4493,5363,5577,3970
7410,32457,15568,16889,7798,7022,10186,7451
7416,5781,2816,2965,1446,1330,1927,1078
7417,10580,5209,5371,3116,1402,3564,2498
7418,2249,1116,1133,640,428,858,323
7419,9160,4426,4734,2193,2174,2944,1849
7420,4942,2439,2503,1140,1270,1482,1050
7421,7439,3803,3636,1897,1664,2890,988
7422,6616,3346,3270,1705,1487,2516,908
7423,4078,1992,2086,1255,579,1353,891
7424,26222,12151,14071,6249,7763,6738,5472
7430,25890,12051,13839,6687,6135,7909,5159
7432,7128,3421,3707,1853,1425,2290,1560
7435,2405,1239,1166,569,485,816,535
7436,12754,6241,6513,3560,2211,4439,2544
7438,11559,5749,5810,3227,2267,4066,1999
7439,2456,1231,1225,670,533,826,427
7440,4494,2165,2329,1164,908,1435,987
7442,11097,5374,5723,2712,2793,3577,2015
7444,11046,4984,6062,2511,1762,3168,3605
7446,14484,7046,7438,4169,2543,5057,2715
7450,24985,12060,12925,8138,3946,8410,4491
7452,11601,5635,5966,3707,1700,4028,2166
7456,12211,6115,6096,3278,2409,4401,2123
7457,3559,1743,1816,720,1060,1030,749
7458,11360,5514,5846,3380,1420,3997,2563
7460,3457,1728,1729,873,678,1265,641
7461,19563,9815,9748,5439,4031,6735,3358
7462,6885,3482,3403,1832,1773,2368,912
7463,9615,4755,4860,2601,2022,3079,1913
7465,6244,2910,3334,1404,1189,1858,1793
7470,54717,26208,28509,13979,11284,16931,12523
7480,16122,7847,8275,3909,3243,5607,3363
7481,16716,8019,8697,4951,2293,5695,3777
7495,0,0,0,0,0,0,0
7501,33543,16482,17061,10507,10359,8206,4471
7502,15406,7385,8021,4647,4475,4165,2119
7503,18723,9420,9303,5901,5626,4779,2417
7504,12882,6057,6825,3654,3610,3689,1929
7505,2256,1218,1038,483,636,738,399
7506,18791,9042,9749,4411,4931,5705,3744
7508,22600,10744,11856,6173,5900,6291,4236
7512,10804,5254,5550,2403,2486,3278,2637
7513,11508,5665,5843,3501,3463,3156,1388
7514,18289,8360,9929,5457,5163,4774,2895
7522,20883,9761,11122,7400,6263,4965,2255
7524,12709,6321,6388,4148,3910,3191,1460
7601,43010,21289,21721,8866,14321,12148,7675
7603,8187,3918,4269,2174,2085,2539,1389
7604,11842,5698,6144,2869,2733,3753,2487
7605,8950,4309,4641,2171,1847,2989,1943
7606,2310,1130,1180,554,611,659,486
7607,9555,4536,5019,2171,2385,2894,2105
7608,67,31,36,17,13,28,9
7620,1849,933,916,453,261,598,537
7621,26761,12806,13955,7078,6729,7964,4990
7624,8373,4103,4270,2425,1289,3048,1611
7626,8537,4010,4527,2463,1262,2878,1934
7627,4881,2357,2524,1454,685,1774,968
7628,17433,8371,9062,4326,3906,5502,3699
7630,7379,3539,3840,1881,1331,2338,1829
7631,27119,12846,14273,6614,7390,7659,5456
7632,5309,2569,2740,1212,851,1566,1680
7640,4664,2255,2409,1384,641,1646,993
7641,3382,1662,1720,1019,436,1199,728
7642,10207,4993,5214,2917,1712,3476,2102
7643,10626,5166,5460,2305,2978,3326,2017
7644,24136,11454,12682,5645,7181,6815,4495
7645,7832,3828,4004,2228,1444,2566,1594
7646,16341,7922,8419,3762,4019,5058,3502
7647,5152,2491,2661,1343,932,1650,1227
7648,5730,2684,3046,1443,870,1934,1483
7649,7978,3814,4164,2237,1248,2652,1841
7650,19601,9783,9818,3607,7333,5397,3264
7652,26342,12825,13517,6261,4465,8231,7385
7656,8669,4184,4485,2122,1479,2848,2220
7657,11032,5287,5745,2662,2597,3595,2178
7660,12729,6168,6561,3104,3412,3937,2276
7661,11340,5457,5883,3133,2264,3693,2250
7662,5530,2662,2868,1103,1314,1669,1444
7663,13659,6523,7136,3011,3525,4060,3063
7666,39776,18732,21044,11193,9049,11140,8394
7670,14573,7037,7536,4837,1996,5064,2676
7675,26339,12699,13640,7009,4815,8589,5926
7676,9075,4342,4733,2222,1600,2834,2419
7677,5730,2737,2993,1707,755,1992,1276
7701,23813,11703,12110,5619,6283,6704,5207
7702,3809,1780,2029,1096,554,1254,905
7703,690,472,218,310,248,125,7
7704,6133,3015,3118,2226,917,2101,889
7711,1533,769,764,333,281,533,386
7712,39158,18841,20317,9663,10381,11598,7516
7716,8574,4113,4461,1905,1784,3002,1883
7717,1901,898,1003,344,354,589,614
7718,6263,3039,3224,1731,1415,2000,1117
7719,21538,10613,10925,4957,4759,7283,4539
7720,4298,2134,2164,695,1373,1347,883
7721,2974,1423,1551,801,921,889,363
7722,10209,5004,5205,3156,1468,3645,1940
7723,1020,483,537,224,220,232,344
7724,21710,10489,11221,5208,5176,7022,4304
7726,42508,20475,22033,11787,8244,14268,8209
7727,7050,3531,3519,1986,1576,2382,1106
7728,56257,28047,28210,15027,13069,17543,10618
7730,17396,8271,9125,4378,3599,5529,3890
7731,38304,18871,19433,11364,8784,13446,4710
7732,5189,2619,2570,834,1334,1975,1046
7733,16849,8152,8697,4742,2572,5924,3611
7734,13269,6508,6761,3375,3551,4181,2162
7735,19569,9703,9866,4800,5183,6223,3363
7737,4264,2102,2162,1118,927,1456,763
7738,6095,2944,3151,1731,889,2063,1412
7739,5938,2847,3091,1760,836,1974,1368
7740,31038,15542,15496,7564,10582,7853,5039
7746,18666,9104,9562,5496,2984,6489,3697
7747,30770,14865,15905,7753,7264,10006,5747
7748,28030,13670,14360,7654,5619,9457,5300
7750,3279,1552,1727,707,466,1135,971
7751,19736,9733,10003,6505,3348,7258,2625
7753,37554,17051,20503,8425,8416,10772,9941
7755,6363,3126,3237,1717,1239,2010,1397
7756,3342,1518,1824,304,709,1155,1174
7757,5356,2575,2781,1342,836,1846,1332
7758,4967,2407,2560,1315,1121,1663,868
7760,9283,4548,4735,2903,1349,3382,1649
7762,8403,3836,4567,1668,1317,2486,2932
7764,8097,3862,4235,2810,1710,2087,1490
7801,25386,13048,12338,6390,7885,7335,3776
7803,3651,1798,1853,900,905,1170,676
7820,39,22,17,7,12,13,7
7821,9193,4623,4570,2576,1724,3328,1565
7822,887,462,425,242,150,336,159
7823,7571,3657,3914,1648,1322,2352,2249
7825,9555,4717,4838,2444,1597,3314,2200
7826,6180,3057,3123,1493,1129,2204,1354
7827,4244,2133,2111,1055,915,1400,874
7828,14150,6976,7174,3736,3991,4553,1870
7830,6503,3180,3323,1838,902,2490,1273
7832,3903,1954,1949,1013,664,1445,781
7833,157,86,71,33,35,54,35
7834,17722,8441,9281,4477,3340,5937,3968
7836,12568,6252,6316,3659,2738,4295,1876
7838,3568,1807,1761,961,765,1304,538
7840,29849,14200,15649,7726,7202,9173,5748
7842,130,65,65,39,31,40,20
7843,12241,6164,6077,3022,3067,4178,1974
7846,89,45,44,17,18,30,24
7847,1670,856,814,375,434,551,310
7848,5026,2484,2542,1172,855,1787,1212
7849,9054,4605,4449,2413,2116,3132,1393
7850,6436,3129,3307,1785,1529,2086,1036
7851,119,69,50,36,12,41,30
7852,3609,1709,1900,992,713,1212,692
7853,13325,6655,6670,4227,1864,5116,2118
7856,3944,1794,2150,683,792,1231,1238
7857,3244,1596,1648,675,940,1018,611
7860,26288,12869,13419,6491,5258,8765,5774
7863,4332,2088,2244,1075,843,1483,931
7865,2189,1098,1091,525,402,838,424
7866,22098,10775,11323,5631,4580,7446,4441
7869,25291,12427,12864,7571,5012,8830,3878
7870,26,15,11,8,6,6,6
7871,21165,10423,10742,6626,3458,7602,3479
7874,8905,4386,4519,2357,2121,3017,1410
7876,10619,5220,5399,2856,1893,3758,2112
7878,934,445,489,242,167,349,176
7880,192,100,92,61,39,61,31
7881,16,8,8,2,5,3,6
7882,14492,7093,7399,3898,3159,4912,2523
7885,10078,4944,5134,2543,2578,3142,1815
7901,22806,11228,11578,6954,4542,7407,3903
7920,26747,12810,13937,8161,3801,9734,5051
7921,7621,3435,4186,1380,1990,2682,1569
7922,12246,5817,6429,3485,1934,3961,2866
7924,7534,3734,3800,2302,1334,2548,1350
7926,120,60,60,38,20,49,13
7927,3403,1648,1755,707,760,1092,844
7928,19144,9125,10019,6225,3126,6375,3418
7930,8559,4273,4286,2707,1045,3144,1663
7931,3296,1621,1675,996,468,1140,692
7932,9868,4662,5206,2347,1995,2912,2614
7933,3251,1604,1647,860,571,1124,696
7934,1501,755,746,448,239,537,277
7935,313,156,157,65,42,127,79
7936,11157,5330,5827,2607,2025,3549,2976
7939,228,216,12,1,21,141,65
7940,17278,8151,9127,5209,4532,4603,2934
7945,9539,4650,4889,3038,1112,3401,1988
7946,3144,1546,1598,949,403,1175,617
7950,19564,9578,9986,4715,4482,6373,3994
7960,43747,21718,22029,10032,11898,12779,9038
7961,4,0,4,0,0,0,4
7970,117,54,63,33,23,43,18
7974,11768,5700,6068,3436,2176,3948,2208
7976,754,370,384,173,79,266,236
7977,669,313,356,186,129,238,116
7979,589,241,348,205,79,171,134
7980,2307,1138,1169,605,446,775,481
7981,8865,4187,4678,2117,1688,2831,2229
8001,844,439,405,245,187,270,142
8002,22274,10530,11744,5159,5441,6359,5315
8003,30629,14809,15820,8276,5334,9777,7242
8004,12350,6051,6299,3161,3134,3798,2257
8005,22448,10750,11698,5216,4381,5768,7083
8006,518,253,265,47,71,136,264
8007,5250,2537,2713,1228,1383,1526,1113
8008,6975,3431,3544,848,1001,1919,3207
8009,12854,6238,6616,3121,3040,3929,2764
8010,11539,5508,6031,2673,3059,3440,2367
8011,33,20,13,7,11,9,6
8012,38992,18810,20182,9692,10404,11500,7396
8014,504,253,251,115,126,171,92
8015,20763,10170,10593,5656,5322,6201,3584
8016,33540,15905,17635,9438,7591,10576,5935
8019,925,473,452,235,230,312,148
8020,2201,1060,1141,474,470,727,530
8021,44833,21344,23489,11341,14003,12546,6943
8022,8783,4170,4613,2003,1214,2595,2971
8023,451,236,215,110,121,141,79
8026,2274,1111,1163,592,475,739,468
8027,4888,2391,2497,1110,1107,1462,1209
8028,20078,9847,10231,5235,7175,4683,2985
8029,4784,2277,2507,1094,1161,1361,1168
8030,13410,6585,6825,3623,3610,3848,2329
8031,11584,5670,5914,2624,2975,3381,2604
8033,16261,7763,8498,4439,3011,5113,3698
8034,18151,8749,9402,4410,3780,5447,4514
8035,7566,3617,3949,1889,1634,2386,1657
8036,5917,2848,3069,1639,1127,1961,1190
8037,24308,12321,11987,5951,5807,7373,5177
8038,124,59,65,30,20,39,35
8039,137,62,75,34,35,40,28
8041,1002,512,490,270,180,356,196
8042,203,101,102,64,61,55,23
8043,29131,13837,15294,7038,6437,9017,6639
8045,2909,1330,1579,785,622,816,686
8046,31587,14558,17029,8394,6984,9248,6961
8048,12495,6031,6464,3767,2813,4177,1738
8049,5350,2614,2736,1305,1449,1588,1008
8050,24285,11690,12595,6069,4592,7243,6381
8051,10758,5024,5734,2707,2823,3233,1995
8052,19172,9320,9852,3955,6232,5395,3590
8053,45538,21738,23800,11700,10698,14597,8543
8054,41864,19524,22340,10107,9752,12921,9084
8055,27179,13220,13959,7706,4449,9267,5757
8056,4736,2356,2380,1455,1038,1488,755
8057,21090,10049,11041,6242,3263,6922,4663
8059,5612,2710,2902,1350,1489,1712,1061
8060,24713,12102,12611,6604,6438,7740,3931
8061,2672,1313,1359,873,901,699,199
8062,15756,7719,8037,5227,2906,5487,2136
8063,3102,1512,1590,793,784,1004,521
8064,311,131,180,24,25,77,185
8065,7398,3606,3792,1614,1987,2319,1478
8066,8437,4026,4411,2375,2351,2255,1456
8067,1635,797,838,415,351,544,325
8068,6727,3422,3305,1580,1908,1910,1329
8069,13076,6188,6888,3608,3349,3447,2672
8070,13059,6348,6711,3178,2996,3925,2960
8071,9551,4442,5109,2333,2242,2791,2185
8072,225,107,118,61,48,67,49
8073,203,92,111,47,40,74,42
8074,58,31,27,16,10,16,16
8075,28894,14248,14646,7581,7687,8543,5083
8077,18307,8958,9349,4522,3522,5816,4447
8078,8385,4030,4355,1960,2227,2499,1699
8079,10987,5201,5786,3006,2413,3112,2456
8080,37433,17999,19434,10243,7921,12496,6773
8081,50589,24322,26267,15919,12934,15628,6108
8083,9455,4641,4814,2297,2281,2833,2044
8084,7040,3444,3596,1827,1784,2076,1353
8085,18737,9285,9452,6199,4702,5770,2066
8086,7699,3709,3990,1764,1864,2303,1768
8087,24104,11663,12441,5418,5125,6792,6769
8088,24664,12163,12501,5719,4071,8092,6782
8089,4253,2102,2151,944,955,1385,969
8090,8358,4135,4223,2199,1917,2620,1622
8091,5357,2668,2689,1338,1385,1573,1061
8092,3673,1859,1814,973,721,1195,784
8093,9741,4813,4928,2430,2831,2997,1483
8094,39940,19383,20557,11219,9414,11712,7595
8095,236,126,110,49,59,82,46
8096,36116,17335,18781,8783,9321,10444,7568
8097,3293,1604,1689,824,757,1040,672
8098,9090,4546,4544,2220,2011,2715,2144
8102,7565,3692,3873,2328,2370,1837,1030
8103,15190,7954,7236,4464,4917,3714,2095
8104,23851,10869,12982,9095,7045,5163,2548
8105,29077,14289,14788,10486,9225,6510,2856
8106,9874,4744,5130,2206,2548,3104,2016
8107,13675,6688,6987,3440,3901,4059,2275
8108,18045,8626,9419,4053,4801,5357,3834
8109,22407,10674,11733,5520,5664,6579,4644
8110,19008,9168,9840,5692,5150,5338,2828
8201,10007,4788,5219,2367,2462,2985,2193
8202,1444,693,751,143,156,371,774
8203,9454,4616,4838,1734,1924,2999,2797
8204,18557,8964,9593,3806,3710,5187,5854
8205,28626,13548,15078,7379,6835,8907,5505
8210,17167,8349,8818,4072,3385,5443,4267
8212,294,134,160,17,11,57,209
8215,13442,6614,6828,3318,3046,4229,2849
8217,70,29,41,13,12,24,21
8221,7092,3361,3731,1935,1007,2382,1768
8223,4125,1953,2172,971,741,1379,1034
8224,573,284,289,137,133,202,101
8225,8659,4129,4530,2320,1640,2830,1869
8226,11701,5499,6202,1874,1953,3339,4535
8230,5599,2678,2921,1435,985,1874,1305
8232,19292,9276,10016,5955,5210,5073,3054
8234,42532,20745,21787,12310,9598,13621,7003
8240,2371,1032,1339,918,1452,1,0
8241,1103,532,571,260,194,393,256
8242,3216,1585,1631,692,736,898,890
8243,2114,1046,1068,257,289,617,951
8244,10849,5099,5750,2557,2658,3372,2262
8246,92,44,48,20,14,35,23
8247,925,439,486,113,107,227,478
8248,158,80,78,14,19,53,72
8251,10364,4894,5470,2599,2384,2883,2498
8260,13661,6802,6859,2571,2985,3816,4289
8270,8492,4446,4046,2232,1874,2909,1477
8302,46872,24988,21884,13213,14131,11868,7660
8310,1670,799,871,333,307,414,616
8311,2057,1041,1016,589,484,621,363
8312,7875,3798,4077,2287,2092,2243,1253
8314,2511,2330,181,94,1414,896,107
8316,400,206,194,109,109,95,87
8317,1344,681,663,356,273,520,195
8318,12702,6330,6372,3311,2782,4096,2513
8319,1253,622,631,341,219,482,211
8320,1256,1251,5,11,826,399,20
8321,247,126,121,22,22,67,136
8322,10524,5257,5267,2921,2409,3630,1564
8323,804,404,400,174,147,250,233
8324,526,263,263,140,124,164,98
8326,1761,869,892,512,495,507,247
8327,3070,2656,414,205,1613,1046,206
8328,1347,677,670,329,328,464,226
8329,221,107,114,35,42,86,58
8330,28167,13918,14249,7380,7408,8470,4909
8332,36768,17558,19210,10544,9382,10056,6786
8340,979,476,503,232,177,359,211
8341,2239,1043,1196,623,551,581,484
8343,5030,2547,2483,1353,1079,1696,902
8344,5847,2825,3022,1510,1315,1802,1220
8345,805,392,413,165,171,250,219
8346,843,413,430,246,197,266,134
8348,275,131,144,46,67,73,89
8349,2347,1155,1192,667,540,687,453
8350,825,411,414,225,190,258,152
8352,448,227,221,145,114,128,61
8353,516,238,278,119,122,157,118
8360,43355,21098,22257,12340,11905,11316,7794
8361,17352,8124,9228,4100,3764,5421,4067
8401,39554,19394,20160,10840,10855,10768,7091
8402,6354,2979,3375,987,845,1914,2608
8403,997,486,511,126,93,321,457
8406,10650,5160,5490,2159,2398,3219,2874
8501,6582,3212,3370,1869,983,2272,1458
8502,11317,5594,5723,3906,1826,4358,1227
8505,17736,8629,9107,4624,4455,5521,3136
8510,5231,2615,2616,1616,811,2102,702
8511,826,427,399,209,219,287,111
8512,10105,4929,5176,2525,2066,3309,2205
8514,4477,2207,2270,1114,801,1608,954
8515,4637,2255,2382,1398,1190,1403,646
8518,4986,2364,2622,1173,1252,1595,966
8520,27869,13674,14195,7566,7541,8313,4449
8525,4767,2374,2393,1173,762,1846,986
8527,54392,26413,27979,14706,11124,17253,11309
8528,315,164,151,69,79,98,69
8530,8071,4408,3663,1421,2149,2785,1716
8533,6945,3517,3428,2104,1429,2500,912
8534,12929,6242,6687,3759,1997,4519,2654
8535,5385,2679,2706,1636,811,2186,752
8536,20073,10046,10027,5441,6763,6175,1694
8540,47115,22972,24143,12708,12418,13264,8725
8542,5189,2718,2471,1225,2547,867,550
8550,19445,9446,9999,5847,2872,7043,3683
8551,5532,2810,2722,1613,809,2125,985
8553,682,346,336,170,115,224,173
8554,3818,1798,2020,1022,990,1157,649
8555,877,435,442,240,141,302,194
8558,6629,3145,3484,2040,690,2430,1469
8559,4982,2450,2532,1068,714,1918,1282
8560,3656,1811,1845,904,522,1347,883
8561,226,123,103,51,48,85,42
8562,5371,2662,2709,1461,1276,1679,955
8608,983,476,507,145,326,342,170
8609,13546,6878,6668,4094,4222,3464,1766
8610,30468,14858,15610,7580,8400,8854,5634
8611,28038,15676,12362,7608,10990,6517,2923
8618,38229,17819,20410,11156,11716,9667,5690
8619,22723,10790,11933,4754,5622,6887,5460
8620,14693,8716,5977,3028,5284,3837,2544
8628,9054,4303,4751,1578,2442,2753,2281
8629,12331,6112,6219,3779,3868,3339,1345
8638,22832,11196,11636,5285,6628,6587,4332
8640,7716,6477,1239,985,3047,3076,608
8641,3553,1945,1608,1444,1782,308,19
8648,32263,14963,17300,8009,9201,8977,6076
8690,18567,8805,9762,4222,3653,5949,4743
8691,15104,7160,7944,4238,2990,5106,2770
8701,92843,46115,46728,41035,27029,10913,13866
8720,843,395,448,209,110,282,242
8721,20512,10055,10457,5183,4898,6173,4258
8722,11045,5478,5567,3127,2882,3468,1568
8723,31641,15251,16390,7260,7225,9791,7365
8724,42352,20007,22345,9914,9118,13156,10164
8730,4774,2354,2420,1337,653,1617,1167
8731,20009,9862,10147,5035,4567,6086,4321
8732,1484,711,773,300,278,487,419
8733,2752,1424,1328,867,847,738,300
8734,7651,3725,3926,2065,1611,2517,1458
8735,3114,1452,1662,306,388,782,1638
8736,12578,6132,6446,3189,2118,4152,3119
8738,1042,486,556,58,94,251,639
8740,2010,964,1046,500,500,604,406
8741,2488,1207,1281,605,498,802,583
8742,24405,11939,12466,5674,5079,8179,5473
8750,3528,1664,1864,764,406,1180,1178
8751,4212,2163,2049,785,1198,1322,907
8752,2074,1001,1073,242,369,622,841
8753,63678,30981,32697,15690,15169,19852,12967
8755,25302,11743,13559,5811,4638,7262,7591
8757,33217,14353,18864,3871,4062,6111,19173
8758,7043,3517,3526,1244,1318,1896,2585
8759,33263,13802,19461,2361,2460,5005,23437
8801,8551,4790,3761,2096,2303,2840,1312
8802,4067,2025,2042,1212,582,1646,627
8804,2771,1387,1384,750,494,1030,497
8805,12254,6327,5927,3028,3792,3456,1978
8807,37972,18166,19806,10506,7426,12643,7397
8808,86,46,40,7,23,31,25
8809,6421,2774,3647,1311,1689,2486,935
8810,8401,4049,4352,2570,1981,2826,1024
8812,14296,7042,7254,3882,3397,4696,2321
8816,46298,22367,23931,12212,9299,15869,8918
8817,44621,22168,22453,11198,14442,12184,6797
8820,39590,19067,20523,10112,9240,12300,7938
8821,354,166,188,83,82,131,58
8822,30354,14955,15399,8167,5930,10732,5525
8823,9016,4150,4866,2083,3086,2765,1082
8824,12115,5878,6237,3653,2272,4239,1951
8825,4707,2358,2349,1171,861,1767,908
8826,5838,2928,2910,1449,1023,2170,1196
8827,4629,2315,2314,1246,789,1739,855
8828,2178,1053,1125,503,569,769,337
8829,3725,1873,1852,978,884,1347,516
8830,18459,9026,9433,4306,5273,5194,3686
8831,45620,21283,24337,9765,7188,11151,17516
8832,2863,1362,1501,824,991,755,293
8833,8796,4320,4476,2389,1256,3335,1816
8835,10344,5185,5159,2333,2887,3142,1982
8836,3845,1844,2001,1033,514,1515,783
8837,15847,7705,8142,3481,4651,4449,3266
8840,16558,7993,8565,4265,3777,5249,3267
8844,38367,18695,19672,10953,8257,13599,5558
8846,13635,6602,7033,3390,3287,4334,2624
8848,8435,4170,4265,2216,1389,3017,1813
8850,8281,4076,4205,1986,1888,2667,1740
8852,17220,8355,8865,5210,4547,5531,1932
8853,5247,2582,2665,1471,901,1899,976
8854,55961,27876,28085,15602,17888,14371,8100
8857,39898,19394,20504,9999,9963,12754,7182
8858,144,77,67,31,20,50,43
8859,21526,10551,10975,5340,6036,6496,3654
8861,53099,26169,26930,16050,16269,13587,7193
8863,12320,5956,6364,2957,3327,3769,2267
8865,29840,14363,15477,8024,6790,8970,6056
8867,5042,2510,2532,1483,702,1888,969
8869,6881,3372,3509,1724,1710,2229,1218
8872,18811,9216,9595,4788,5365,5633,3025
8873,49921,23979,25942,12041,13858,13694,10328
8876,22179,11204,10975,5601,5962,7075,3541
8879,23537,11564,11973,5499,6427,7522,4089
8880,4563,2340,2223,1090,1481,1340,652
8882,16008,8133,7875,3999,4613,4768,2628
8884,8257,3950,4307,1911,1765,2573,2008
8886,7077,3434,3643,2309,1357,2466,945
8887,1106,522,584,233,312,346,215
8889,10063,4894,5169,2715,1529,3659,2160
8890,17,6,11,2,2,1,12
8901,55223,28281,26942,16464,26603,8162,3994
8902,41153,20337,20816,10559,13152,11586,5856
8904,13982,6700,7282,3179,4862,3647,2294
79837,60,31,29,14,10,23,13
81137,156,80,76,52,42,42,20
86504,754,363,391,277,192,184,101
86515,1585,800,785,580,434,350,221
87001,3684,1788,1896,1346,1001,901,436
87002,22517,11076,11441,6193,4902,6208,5214
87004,10136,5099,5037,2801,2509,2870,1956
87005,799,410,389,228,161,246,164
87006,703,362,341,148,117,215,223
87007,1080,532,548,326,256,246,252
87008,2552,1278,1274,482,365,1003,702
87010,1139,585,554,145,165,472,357
87011,84,44,40,10,12,29,33
87012,261,136,125,59,48,86,68
87013,5200,2583,2617,1850,1230,1262,858
87014,654,332,322,161,117,229,147
87015,13105,6584,6521,3433,2350,4931,2391
87016,3730,2097,1633,922,1051,1003,754
87017,429,232,197,119,95,134,81
87018,522,257,265,180,153,95,94
87020,11347,5385,5962,3068,3011,3039,2229
87021,3472,2336,1136,736,1322,1007,407
87022,907,440,467,267,214,245,181
87023,665,356,309,193,167,179,126
87024,2214,1077,1137,669,566,578,401
87025,1237,628,609,191,176,496,374
87026,4063,2009,2054,1411,1094,1042,516
87027,309,165,144,54,50,94,111
87028,145,84,61,18,22,52,53
87029,237,126,111,42,30,91,74
87031,44075,22510,21565,13644,11240,12335,6856
87032,291,134,157,68,49,89,85
87034,2207,1032,1175,722,581,573,331
87035,7268,3683,3585,2149,1551,2182,1386
87036,1868,906,962,427,300,551,590
87037,677,341,336,242,162,154,119
87038,616,295,321,214,143,171,88
87040,496,232,264,139,101,146,110
87041,881,452,429,308,208,225,140
87042,3644,1825,1819,937,734,1163,810
87043,5052,2488,2564,589,530,2032,1901
87044,387,192,195,92,67,121,107
87045,1751,877,874,639,419,440,253
87046,186,92,94,30,28,74,54
87047,4894,2451,2443,987,617,2004,1286
87048,8682,4181,4501,1744,1003,3299,2636
87049,973,457,516,292,240,274,167
87051,969,482,487,279,192,311,187
87052,3182,1563,1619,1196,915,705,366
87053,998,487,511,324,249,260,165
87056,954,465,489,216,158,368,212
87059,9604,4914,4690,2144,1493,3975,1992
87061,371,199,172,73,65,110,123
87062,1869,958,911,634,409,492,334
87063,323,165,158,98,60,92,73
87064,161,75,86,36,31,46,48
87068,4755,2352,2403,1184,869,1535,1167
87070,42,21,21,5,9,15,13
87072,660,307,353,218,166,152,124
87083,569,276,293,88,85,189,207
87102,21204,11201,10003,4748,7775,5404,3277
87104,12123,5758,6365,2788,3092,3350,2893
87105,57680,28460,29220,17369,14829,15302,10180
87106,27013,13561,13452,6559,11312,5673,3469
87107,31183,15257,15926,7694,7559,9163,6767
87108,38647,19504,19143,9973,12143,10366,6165
87109,40432,19202,21230,9196,11769,10430,9037
87110,38587,18609,19978,7963,10284,11113,9227
87111,56490,26996,29494,11827,13094,16368,15201
87112,43584,20847,22737,10059,11280,12252,9993
87113,14477,6995,7482,4030,4237,4141,2069
87114,61623,29766,31857,19046,18477,15753,8347
87116,4117,2148,1969,1588,1986,476,67
87117,310,269,41,52,256,0,2
87120,58023,27842,30181,16560,16749,16649,8065
87121,76721,38603,38118,28282,25831,16541,6067
87122,17977,8811,9166,4747,2489,6574,4167
87123,41468,20056,21412,10954,11270,11099,8145
87124,51404,24909,26495,14797,12646,14626,9335
87144,37719,18516,19203,12577,10036,10394,4712
87301,23674,11330,12344,7960,6196,5885,3633
87305,3350,1604,1746,1158,803,931,458
87310,938,464,474,294,248,229,167
87311,4208,2061,2147,1643,1053,1016,496
87312,579,271,308,195,137,151,96
87313,5662,2787,2875,1973,1492,1423,774
87315,149,71,78,25,18,49,57
87316,1304,620,684,453,339,345,167
87317,1956,982,974,676,508,507,265
87319,1832,894,938,639,446,502,245
87320,765,361,404,266,203,186,110
87321,2226,1091,1135,663,469,605,489
87322,247,121,126,92,77,45,33
87323,4558,2208,2350,1695,1140,1087,636
87325,3034,1445,1589,991,735,813,495
87326,1688,825,863,556,385,485,262
87327,7883,3846,4037,2693,2196,2108,886
87328,2483,1154,1329,1094,588,530,271
87347,309,161,148,66,46,123,74
87357,604,294,310,211,162,147,84
87364,1111,570,541,352,257,294,208
87375,3193,1577,1616,1124,881,793,395
87401,46293,22882,23411,14625,13224,11323,7121
87402,11034,5488,5546,3348,2811,3134,1741
87410,17603,8717,8886,5324,4305,4896,3078
87412,966,504,462,259,201,294,212
87413,16792,8339,8453,5453,4284,4367,2688
87415,1791,909,882,439,410,540,402
87416,5454,2684,2770,1958,1467,1373,656
87417,6910,3504,3406,2431,1932,1730,817
87418,1059,555,504,305,242,319,193
87419,464,253,211,84,59,178,143
87420,11967,5827,6140,4178,3172,3010,1607
87421,1871,906,965,635,484,480,272
87455,1750,890,860,543,411,450,346
87461,1315,672,643,438,298,354,225
87499,453,245,208,143,99,131,80
87501,15147,7023,8124,1968,2966,4758,5455
87505,31013,14653,16360,5760,6638,9463,9152
87506,12580,6215,6365,2714,2226,3974,3666
87507,45890,22567,23323,13931,13154,12396,6409
87508,18183,9236,8947,3596,3683,6280,4624
87510,1096,554,542,233,230,346,287
87511,2747,1386,1361,823,699,799,426
87512,199,96,103,34,24,76,65
87513,1007,505,502,221,221,314,251
87514,1345,685,660,254,271,495,325
87515,311,141,170,77,57,104,73
87516,130,68,62,20,25,41,44
87517,356,194,162,29,43,160,124
87518,91,48,43,20,17,26,28
87519,460,226,234,112,85,153,110
87520,1419,715,704,281,235,430,473
87521,1003,499,504,247,176,316,264
87522,3384,1658,1726,844,765,1027,748
87523,405,192,213,72,92,149,92
87524,260,128,132,57,47,97,59
87525,72,41,31,5,9,35,23
87527,880,440,440,175,170,286,249
87528,3417,1662,1755,1284,965,770,398
87529,3600,1746,1854,744,734,1139,983
87530,974,458,516,224,194,303,253
87531,368,191,177,49,53,105,161
87532,18223,8888,9335,5109,4512,5078,3524
87533,185,73,112,73,60,36,16
87535,1270,633,637,276,260,446,288
87537,2957,1479,1478,935,777,777,468
87538,493,255,238,101,87,179,126
87539,269,142,127,56,56,77,80
87540,923,427,496,141,112,325,345
87543,247,126,121,49,46,71,81
87544,17950,9029,8921,4608,3325,6116,3901
87548,928,444,484,269,186,301,172
87549,1118,532,586,326,283,293,216
87551,305,153,152,45,44,88,128
87552,3325,1667,1658,849,713,1078,685
87553,1209,590,619,326,229,359,295
87554,61,35,26,9,14,24,14
87556,2417,1216,1201,557,476,747,637
87557,6359,3171,3188,1586,1461,1909,1403
87558,606,316,290,121,163,189,133
87560,1445,726,719,357,305,421,362
87562,576,297,279,144,124,220,88
87564,332,164,168,69,72,90,101
87565,478,235,243,127,76,166,109
87566,3000,1472,1528,848,774,807,571
87567,1634,797,837,488,476,438,232
87569,442,227,215,114,93,132,103
87571,11706,5638,6068,2728,2471,3454,3053
87573,36,21,15,5,4,19,8
87574,187,93,94,38,19,70,60
87575,789,446,343,170,189,239,191
87577,454,251,203,72,82,168,132
87578,611,307,304,132,134,186,159
87579,890,423,467,186,145,297,262
87580,449,226,223,86,95,157,111
87581,141,77,64,25,25,33,58
87582,1350,682,668,350,317,381,302
87583,234,120,114,52,51,63,68
87701,20081,9952,10129,5366,4977,5457,4281
87710,1768,925,843,323,246,611,588
87711,753,382,371,208,147,218,180
87712,283,144,139,62,58,78,85
87713,283,142,141,64,48,92,79
87714,1151,580,571,259,215,386,291
87715,532,261,271,103,113,182,134
87718,467,244,223,104,65,159,139
87722,376,199,177,74,53,121,128
87723,408,208,200,133,85,117,73
87724,88,43,45,35,16,22,15
87728,417,213,204,111,82,114,110
87729,126,62,64,21,11,41,53
87730,27,14,13,4,5,10,8
87731,223,120,103,45,31,67,80
87732,1672,852,820,400,340,481,451
87733,158,82,76,23,28,37,70
87734,181,96,85,26,24,61,70
87735,90,47,43,16,8,41,25
87736,233,123,110,56,53,67,57
87740,8068,4001,4067,2013,1695,2216,2144
87742,609,309,300,139,74,167,229
87743,361,193,168,52,39,120,150
87745,654,315,339,157,116,203,178
87746,120,71,49,17,21,40,42
87747,1624,921,703,305,392,461,466
87749,75,33,42,12,13,17,33
87750,11,7,4,4,5,0,2
87752,431,226,205,86,72,134,139
87753,254,123,131,79,42,81,52
87801,10221,5327,4894,2745,2951,2556,1969
87820,161,87,74,23,15,56,67
87821,672,347,325,97,62,208,305
87823,884,427,457,219,178,289,198
87824,194,103,91,38,24,57,75
87825,2999,1474,1525,973,654,809,563
87827,276,147,129,33,22,94,127
87828,429,217,212,148,65,123,93
87829,922,482,440,167,136,302,317
87830,999,532,467,205,153,249,392
87831,195,91,104,35,38,64,58
87832,600,312,288,140,92,203,165
87901,7139,3532,3607,1328,1184,1979,2648
87930,829,440,389,283,141,212,193
87931,634,321,313,85,67,200,282
87933,106,48,58,40,24,19,23
87935,1770,905,865,156,141,448,1025
87936,515,262,253,138,117,143,117
87937,3303,1688,1615,1272,729,792,510
87939,125,68,57,19,9,48,49
87940,669,348,321,239,125,189,116
87941,1216,614,602,508,283,262,163
87942,898,458,440,154,127,264,353
87943,228,120,108,33,19,78,98
88001,37484,18276,19208,11266,13284,7284,5650
88002,1656,917,739,645,784,190,37
88003,894,452,442,539,350,5,0
88004,699,697,2,3,475,208,13
88005,27116,13433,13683,6962,7071,7158,5925
88007,24048,11722,12326,7102,5419,6505,5022
88008,5747,2769,2978,1882,1530,1455,880
88009,88,42,46,32,19,29,8
88011,27698,13323,14375,6283,7461,6949,7005
88012,25961,12722,13239,8572,7636,6298,3455
88020,882,446,436,237,149,302,194
88021,18421,8886,9535,6841,4644,4361,2575
88022,1343,674,669,320,277,369,377
88023,2406,1154,1252,701,501,610,594
88024,236,108,128,100,66,56,14
88025,256,137,119,48,34,97,77
88026,1658,787,871,476,329,448,405
88027,493,236,257,151,119,135,88
88028,492,249,243,95,81,152,164
88029,1873,939,934,630,335,445,463
88030,23222,11535,11687,6748,4963,5469,6042
88032,195,98,97,59,40,53,43
88033,11,7,4,1,3,5,2
88034,96,51,45,10,13,29,44
88038,431,219,212,81,52,152,146
88039,465,230,235,53,59,139,214
88040,116,71,45,23,25,31,37
88041,1243,627,616,198,133,378,534
88042,250,127,123,21,13,76,140
88043,1621,800,821,422,325,383,491
88044,3896,1872,2024,1126,859,1096,815
88045,3662,1827,1835,1075,789,957,841
88046,697,346,351,115,179,208,195
88047,1967,983,984,647,479,542,299
88048,3862,1921,1941,1431,1031,904,496
88049,408,209,199,59,60,112,177
88051,94,50,44,10,11,39,34
88052,270,138,132,69,48,90,63
88053,133,72,61,12,14,52,55
88055,37,19,18,2,4,11,20
88056,233,122,111,39,35,70,89
88061,18585,9086,9499,4576,3835,4754,5420
88063,12772,6088,6684,4887,3283,2968,1634
88065,624,300,324,185,144,138,157
88072,2501,1259,1242,977,661,574,289
88081,15708,8125,7583,5777,4422,3783,1726
88101,45006,22475,22531,14221,13240,10486,7059
88103,278,239,39,63,215,0,0
88112,123,59,64,18,19,37,49
88113,103,64,39,25,15,40,23
88114,35,19,16,6,8,8,13
88115,44,25,19,11,12,14,7
88116,455,216,239,110,90,130,125
88118,180,91,89,51,27,60,42
88119,1932,949,983,463,336,531,602
88120,239,116,123,60,33,77,69
88121,152,82,70,30,27,43,52
88124,1165,591,574,289,241,333,302
88125,90,43,47,26,16,26,22
88126,30,15,15,7,5,8,10
88130,18651,9381,9270,5958,5702,4055,2936
88132,199,99,100,49,39,59,52
88134,46,25,21,9,6,16,15
88135,1804,942,862,607,479,463,255
88136,44,18,26,9,9,14,12
88201,25490,12467,13023,7317,5447,6527,6199
88203,31561,15425,16136,10634,8335,7428,5164
88210,17217,8664,8553,5180,4478,4561,2998
88220,33721,16736,16985,9504,7939,9284,6994
88230,5179,2671,2508,1757,1179,1429,814
88231,3238,1659,1579,986,845,905,502
88232,2525,1464,1061,780,697,658,390
88240,37149,19122,18027,12150,10885,8873,5241
88242,6141,3133,3008,1868,1456,1875,942
88250,270,145,125,67,53,74,76
88252,2160,1082,1078,624,477,565,494
88253,935,470,465,300,205,286,144
88254,191,96,95,23,27,41,100
88255,128,73,55,34,34,43,17
88256,1925,978,947,616,440,544,325
88260,14343,7200,7143,4855,3957,3280,2251
88262,30,13,17,6,5,4,15
88263,175,89,86,52,41,60,22
88264,39,18,21,5,4,13,17
88265,243,127,116,68,60,63,52
88267,1349,672,677,409,303,358,279
88268,7,2,5,3,1,2,1
88301,1386,751,635,243,247,448,448
88310,35776,17705,18071,9146,9067,9318,8245
88311,854,430,424,170,175,272,237
88312,2586,1282,1304,398,307,818,1063
88314,210,113,97,51,34,64,61
88316,2351,1159,1192,541,335,774,701
88317,1751,862,889,318,207,541,685
88318,381,201,180,67,54,125,135
88321,187,96,91,30,21,74,62
88323,14,8,6,2,3,4,5
88324,210,105,105,31,33,62,84
88325,899,469,430,126,83,349,341
88330,3054,1730,1324,1166,1692,175,21
88336,267,123,144,74,40,85,68
88337,2295,1132,1163,523,383,710,679
88338,189,91,98,27,21,58,83
88339,618,322,296,91,71,201,255
88340,3616,1751,1865,1424,1077,808,307
88341,538,280,258,87,57,196,198
88342,52,30,22,5,6,22,19
88343,48,27,21,16,16,10,6
88344,159,89,70,50,29,36,44
88345,8845,4263,4582,1758,1609,2652,2826
88346,3132,1507,1625,910,751,850,621
88347,100,53,47,7,17,51,25
88348,314,158,156,74,58,89,93
88349,70,40,30,16,15,28,11
88350,368,202,166,29,22,125,192
88351,256,129,127,56,36,64,100
88352,5188,2561,2627,1277,1021,1517,1373
88353,473,236,237,124,68,142,139
88354,108,52,56,11,2,39,56
88355,29,15,14,6,5,9,9
88401,6944,3392,3552,1771,1397,1916,1860
88410,129,69,60,30,23,35,41
88411,82,43,39,14,12,35,21
88414,39,21,18,13,3,13,10
88415,3569,2081,1488,794,1001,963,811
88416,189,106,83,10,14,61,104
88417,25,13,12,6,3,8,8
88418,294,143,151,66,58,99,71
88419,229,121,108,51,40,71,67
88421,19,12,7,0,1,6,12
88422,68,36,32,9,7,20,32
88424,128,73,55,35,19,38,36
88426,1212,598,614,212,159,401,440
88427,119,65,54,30,23,33,33
88430,153,86,67,34,29,38,52
88431,49,27,22,10,5,20,14
88434,369,182,187,87,56,123,103
88435,3559,2071,1488,821,1033,1030,675
88436,185,93,92,50,36,60,39
6390,236,118,118,42,34,98,62
10001,21102,10184,10918,2946,9104,5378,3674
10002,81410,38570,42840,15041,26016,21742,18611
10003,56024,26750,29274,9026,26764,11908,8326
10004,3089,1610,1479,416,1761,716,196
10005,7135,3443,3692,464,5537,997,137
10006,3011,1519,1492,179,2346,418,68
10007,6988,3958,3030,1247,3526,1847,368
10009,61347,28433,32914,8544,26354,15620,10829
10010,31834,14755,17079,3761,15628,6759,5686
10011,50984,25998,24986,5737,20606,15376,9265
10012,24090,11840,12250,2379,11985,5561,4165
10013,27700,13951,13749,4550,10490,7665,4995
10014,31959,15631,16328,2914,14768,8674,5603
10016,54183,24814,29369,4285,29728,11379,8791
10017,16575,7485,9090,1125,7665,4234,3551
10018,5229,2795,2434,439,2945,1326,519
10019,42870,21379,21491,3843,19908,10984,8135
10020,0,0,0,0,0,0,0
10021,43631,18894,24737,5889,15402,10487,11853
10022,31924,14487,17437,3333,10508,8147,9936
10023,60998,27578,33420,9074,20862,16395,14667
10024,59283,27436,31847,9907,18030,17218,14128
10025,94600,43291,51309,15632,32445,25624,20899
10026,34003,15877,18126,7953,11778,9731,4541
10027,59707,27465,32242,14652,23059,14018,7978
10028,45141,19961,25180,6883,16091,11681,10486
10029,76003,34808,41195,19724,25040,18242,12997
10030,26999,12560,14439,7173,8820,7426,3580
10031,56438,27491,28947,12920,20451,14396,8671
10032,57331,27659,29672,12582,20019,14690,10040
10033,53926,26461,27465,11930,18539,14160,9297
10034,38908,18260,20648,9085,12705,10996,6122
10035,33969,17014,16955,8687,11027,9042,5213
10036,24711,13786,10925,1980,11861,7070,3800
10037,17416,7307,10109,3697,5072,4679,3968
10038,20300,9410,10890,3304,9226,3960,3810
10039,24527,10992,13535,6949,7622,6238,3718
10040,41905,19326,22579,9611,13458,11131,7705
10044,11661,5710,5951,2030,3792,3343,2496
10065,32270,14360,17910,4173,11721,7898,8478
10069,5199,2451,2748,929,2277,1358,635
10075,26121,11205,14916,3807,8966,6654,6694
10103,3,1,2,0,0,3,0
10110,0,0,0,0,0,0,0
10111,0,0,0,0,0,0,0
10112,0,0,0,0,0,0,0
10115,0,0,0,0,0,0,0
10119,92,61,31,3,18,46,25
10128,60453,26876,33577,9581,23282,15595,11995
10152,0,0,0,0,0,0,0
10153,0,0,0,0,0,0,0
10154,0,0,0,0,0,0,0
10162,1685,765,920,430,438,427,390
10165,2,0,2,0,0,2,0
10167,0,0,0,0,0,0,0
10168,0,0,0,0,0,0,0
10169,0,0,0,0,0,0,0
10170,2,1,1,0,0,1,1
10171,0,0,0,0,0,0,0
10172,0,0,0,0,0,0,0
10173,2,2,0,0,1,1,0
10174,0,0,0,0,0,0,0
10177,0,0,0,0,0,0,0
10199,9,6,3,0,1,1,7
10271,0,0,0,0,0,0,0
10278,0,0,0,0,0,0,0
10279,0,0,0,0,0,0,0
10280,7853,3786,4067,1365,3239,2342,907
10282,4783,2331,2452,1112,2286,985,400
10301,39706,19279,20427,10342,11460,11035,6869
10302,19088,9605,9483,5875,5558,4974,2681
10303,26337,12625,13712,8737,7616,7142,2842
10304,42193,20206,21987,11937,11209,11750,7297
10305,41749,20292,21457,10014,11449,12494,7792
10306,55909,26688,29221,13175,13403,17124,12207
10307,14096,6981,7115,3980,3536,4526,2054
10308,27357,13288,14069,6630,6493,8369,5865
10309,32519,16352,16167,8505,8776,10115,5123
10310,24962,12058,12904,7778,6678,6914,3592
10311,0,0,0,0,0,0,0
10312,59304,28776,30528,14663,14796,17905,11940
10314,85510,41139,44371,20444,21803,24811,18452
10451,45713,20567,25146,14119,12990,11063,7541
10452,75371,35560,39811,25235,22935,19036,8165
10453,78309,36524,41785,26542,23451,20277,8039
10454,37337,17724,19613,12886,11344,8348,4759
10455,39665,18779,20886,13347,12193,9157,4968
10456,86547,40285,46262,30147,24869,21581,9950
10457,70496,32837,37659,24516,20918,17272,7790
10458,79492,38432,41060,26607,26459,18566,7860
10459,47308,22233,25075,16305,14110,11254,5639
10460,57311,26496,30815,19760,16766,13786,6999
10461,50502,24060,26442,11413,15427,13524,10138
10462,75784,35475,40309,20124,23570,20703,11387
10463,67970,30647,37323,15259,19135,17699,15877
10464,4534,2208,2326,871,874,1482,1307
10465,42230,20186,22044,10423,11024,11782,9001
10466,67813,30460,37353,20015,18223,18768,10807
10467,97060,45318,51742,28494,29859,24949,13758
10468,76103,35897,40206,23493,23667,19400,9543
10469,66631,30422,36209,18079,17199,18362,12991
10470,15293,7136,8157,3610,4779,4044,2860
10471,22922,10272,12650,4851,5402,5869,6800
10472,66358,31908,34450,20966,20279,16076,9037
10473,58519,26158,32361,18001,15322,15107,10089
10474,12281,6300,5981,4170,4180,2807,1124
10475,40931,17258,23673,8479,8679,12174,11599
10501,1219,621,598,392,170,427,230
10502,5487,2585,2902,1526,768,1868,1325
10503,108,42,66,4,5,28,71
10504,7987,3968,4019,2643,1025,2810,1509
10505,851,422,429,351,129,294,77
10506,5790,2877,2913,1906,693,2058,1133
10507,6408,2591,3817,1485,1847,2087,989
10509,19507,9916,9591,5104,4226,6690,3487
10510,9988,4794,5194,3049,1499,3349,2091
10511,2246,1129,1117,592,522,693,439
10512,25590,12615,12975,6495,5426,8839,4830
10514,11946,5920,6026,4196,1379,4464,1907
10516,5289,2592,2697,1305,902,1916,1166
10517,539,263,276,142,105,181,111
10518,1268,602,666,413,160,526,169
10519,316,151,165,90,61,112,53
10520,12810,6112,6698,3187,2111,4284,3228
10522,10875,5192,5683,3011,2186,3356,2322
10523,7444,3723,3721,1887,2162,2166,1229
10524,4421,2159,2262,1047,762,1561,1051
10526,1809,869,940,490,318,660,341
10527,908,459,449,284,124,339,161
10528,12280,5868,6412,3334,2670,3814,2462
10530,12604,5733,6871,2200,2716,3866,3822
10532,4931,2423,2508,1227,999,1597,1108
10533,7322,3480,3842,2107,1167,2502,1546
10535,555,266,289,157,120,194,84
10536,10739,5257,5482,3313,1418,4003,2005
10537,2416,1214,1202,606,616,846,348
10538,16597,7997,8600,5142,2789,5419,3247
10541,26339,13053,13286,7268,5284,8981,4806
10543,20135,9809,10326,5259,4761,6044,4071
10545,141,140,1,0,2,13,126
10546,1277,629,648,376,218,467,216
10547,7647,3757,3890,2178,1639,2533,1297
10548,3487,1724,1763,757,540,1074,1116
10549,16638,8534,8104,4537,3952,5049,3100
10550,37144,16954,20190,10505,10230,10176,6233
10552,19786,8980,10806,3883,5083,6037,4783
10553,10170,4554,5616,2746,2637,2911,1876
10560,4737,2303,2434,1220,657,1664,1196
10562,31796,16436,15360,7249,9227,9560,5760
10566,23570,11517,12053,5794,6878,6849,4049
10567,19929,9844,10085,5649,3630,6867,3783
10570,12680,6155,6525,3933,2387,4104,2256
10573,38352,19599,18753,9710,11552,10370,6720
10576,5116,2524,2592,1460,599,1848,1209
10577,6552,2877,3675,2579,2556,836,581
10578,681,328,353,200,132,243,106
10579,8675,4366,4309,2292,1647,3098,1638
10580,17208,8270,8938,5800,2442,5513,3453
10583,38982,18773,20209,11970,5675,12894,8443
10588,2282,1086,1196,605,452,769,456
10589,8475,3789,4686,1589,893,2125,3868
10590,6767,3352,3415,1974,912,2629,1252
10591,22540,10698,11842,5778,6038,6366,4358
10594,5117,2566,2551,1448,987,1558,1124
10595,8195,4572,3623,1639,2646,2362,1548
10596,1729,829,900,452,393,543,341
10597,968,485,483,294,88,376,210
10598,28647,13868,14779,7866,4775,9603,6403
10601,11376,5320,6056,2035,4159,2870,2312
10603,17045,7891,9154,3979,4717,4935,3414
10604,11250,5391,5859,2982,2740,3480,2048
10605,18126,8647,9479,4061,4102,5289,4674
10606,16499,8274,8225,3971,5236,4505,2787
10607,6824,3364,3460,1581,1549,2126,1568
10701,63393,30471,32922,17920,18855,16234,10384
10703,20301,9577,10724,5366,5413,5350,4172
10704,30165,14438,15727,6416,8361,8432,6956
10705,38777,18546,20231,11522,11352,9730,6173
10706,8679,4079,4600,2290,1286,2906,2197
10707,10097,4789,5308,2504,2379,3002,2212
10708,21225,9482,11743,4949,4684,6245,5347
10709,9292,4432,4860,2489,1728,2842,2233
10710,25120,11717,13403,5361,5824,7145,6790
10801,40827,19901,20926,11277,12091,10450,7009
10803,12435,6099,6336,3939,2192,4042,2262
10804,14146,6849,7297,3932,2139,4532,3543
10805,18414,8446,9968,3893,5155,4972,4394
10901,23465,11246,12219,6005,4672,7079,5709
10910,21,12,9,3,7,7,4
10911,2,1,1,0,0,2,0
10913,5532,2684,2848,1691,1089,1700,1052
10914,414,207,207,121,88,126,79
10915,119,66,53,31,29,33,26
10916,4540,2245,2295,1282,877,1576,805
10917,1968,996,972,614,456,616,282
10918,11647,5724,5923,3336,2474,3991,1846
10919,1040,528,512,302,206,374,158
10920,8554,4154,4400,2274,1758,2771,1751
10921,4135,2010,2125,1189,864,1330,752
10922,1559,793,766,348,356,568,287
10923,8732,4236,4496,2344,2253,2637,1498
10924,13120,6529,6591,3422,2754,3999,2945
10925,4539,2264,2275,997,1032,1614,896
10926,3203,1578,1625,820,888,1040,455
10927,11910,5782,6128,3583,3626,2937,1764
10928,4175,2064,2111,1016,1029,1332,798
10930,8958,4435,4523,2979,1709,3055,1215
10931,1023,535,488,265,240,353,165
10932,60,25,35,10,15,19,16
10933,473,235,238,140,111,173,49
10940,48418,23553,24865,13917,12913,13547,8041
10941,13779,6684,7095,3916,3500,4193,2170
10950,47226,23854,23372,21050,11177,10195,4804
10952,38917,19621,19296,18918,8889,6548,4562
10953,252,138,114,49,60,98,45
10954,23045,10843,12202,5478,5201,6996,5370
10956,31521,15515,16006,8359,5451,10216,7495
10958,3291,1742,1549,895,715,1142,539
10960,15093,7122,7971,3402,4231,4459,3001
10962,5950,3012,2938,1394,1167,1988,1401
10963,4298,3028,1270,771,1474,1558,495
10964,1472,718,754,359,203,464,446
10965,14791,7232,7559,3950,2974,4533,3334
10968,2353,1111,1242,396,508,796,653
10969,1267,653,614,351,239,447,230
10970,9993,4793,5200,2222,2478,3101,2192
10973,2126,1068,1058,602,427,731,366
10974,3152,1599,1553,880,706,970,596
10975,281,156,125,34,78,110,59
10976,2258,861,1397,612,463,421,762
10977,59048,29933,29115,22419,16932,12481,7216
10979,234,121,113,43,50,92,49
10980,13383,6586,6797,3444,2622,4348,2969
10983,5532,2684,2848,1477,958,1767,1330
10984,2842,1414,1428,721,611,887,623
10985,58,26,32,17,6,26,9
10986,1974,990,984,547,369,700,358
10987,3395,1679,1716,791,589,1145,870
10988,896,439,457,276,193,276,151
10989,9293,4458,4835,2036,1937,2978,2342
10990,20631,10340,10291,5375,3683,7359,4214
10992,9621,4745,4876,2701,1962,3276,1682
10993,4769,2271,2498,1349,1205,1236,979
10994,7085,3479,3606,1903,1246,2351,1585
10996,6756,4887,1869,2415,3836,472,33
10998,3122,1561,1561,976,614,1054,478
11001,26883,13073,13810,6798,6154,8366,5565
11003,41356,19847,21509,10951,11115,12318,6972
11004,14016,6537,7479,2492,3500,4066,3958
11005,1806,577,1229,13,52,142,1599
11010,23821,11336,12485,5578,5251,7289,5703
11020,5914,2846,3068,1598,939,1896,1481
11021,17729,8101,9628,3814,3595,5071,5249
11023,9027,4379,4648,2653,1585,2421,2368
11024,8002,4319,3683,2474,1818,2016,1694
11030,17962,8592,9370,5087,2528,5503,4844
11040,40782,19677,21105,9819,8366,12538,10059
11042,520,144,376,0,19,3,498
11050,30171,14606,15565,7823,5946,9328,7074
11096,8344,4053,4291,2497,2343,2193,1311
11101,25484,12742,12742,5471,10017,6607,3389
11102,34133,17040,17093,6632,14635,8037,4829
11103,38780,19375,19405,6282,17657,9342,5499
11104,27232,13245,13987,4811,10406,7493,4522
11105,36688,17881,18807,5775,15308,8965,6640
11106,38875,18904,19971,6805,16065,9506,6499
11109,3523,1939,1584,262,2437,615,209
11201,51128,24484,26644,8786,21253,12802,8287
11203,76174,33843,42331,18443,20780,21245,15706
11204,78134,38514,39620,23512,21731,18975,13916
11205,40366,18829,21537,12335,16315,7456,4260
11206,81677,38855,42822,26075,29203,16284,10115
11207,93386,42314,51072,29981,27303,23525,12577
11208,94469,44378,50091,31037,27752,24424,11256
11209,68853,33179,35674,13844,21937,19187,13885
11210,62008,28616,33392,18679,17068,16137,10124
11211,90117,44522,45595,25854,38018,15984,10261
11212,84500,36528,47972,27218,23582,21507,12193
11213,63767,28822,34945,18841,19205,16007,9714
11214,88630,43258,45372,19866,25711,24073,18980
11215,63488,30083,33405,11935,26705,16497,8351
11216,54316,25117,29199,12033,20213,14374,7696
11217,35881,16688,19193,6257,15780,8824,5020
11218,75220,37470,37750,22023,23926,18520,10751
11219,92221,46092,46129,35165,26595,17523,12938
11220,99598,50308,49290,26791,34976,24739,13092
11221,78895,37205,41690,22646,26084,19982,10183
11222,36934,18415,18519,4611,18234,8758,5331
11223,78731,38184,40547,20252,22182,20195,16102
11224,47621,21120,26501,10681,10426,12037,14477
11225,56829,25416,31413,13784,18357,15185,9503
11226,101572,45453,56119,27107,31501,27879,15085
11228,41788,20213,21575,9384,11207,12017,9180
11229,80018,37973,42045,18930,20542,22228,18318
11230,86408,41937,44471,25333,23913,20220,16942
11231,33336,15584,17752,7107,13048,8622,4559
11232,28265,15438,12827,6980,11814,6761,2710
11233,67053,29784,37269,20715,20024,17451,8863
11234,87757,40229,47528,22471,22413,25315,17558
11235,79132,37466,41666,14637,20152,21825,22518
11236,93877,41239,52638,25445,25767,27427,15238
11237,49896,25949,23947,13821,20682,10808,4585
11238,49262,22667,26595,8258,21721,12054,7229
11239,13393,5206,8187,2999,3025,3132,4237
11351,0,0,0,0,0,0,0
11354,54878,25655,29223,9389,15325,16815,13349
11355,85871,41433,44438,16472,25654,27572,16173
11356,23438,11424,12014,5872,7134,6710,3722
11357,39150,18574,20576,7900,9011,11334,10905
11358,37546,18220,19326,7708,10488,11501,7849
11359,0,0,0,0,0,0,0
11360,18884,8581,10303,3110,3759,5455,6560
11361,28606,13687,14919,5966,7961,8714,5965
11362,17823,8450,9373,3570,3997,5332,4924
11363,6988,3322,3666,1530,1359,2302,1797
11364,34555,16332,18223,7387,7943,11189,8036
11365,42252,19921,22331,9708,11231,12449,8864
11366,13532,6523,7009,2942,3703,3783,3104
11367,41047,19559,21488,10748,12725,10050,7524
11368,109931,58421,51510,30657,42378,25162,11734
11369,38615,19285,19330,10312,12110,10372,5821
11370,39688,24539,15149,8002,15285,11386,5015
11371,0,0,0,0,0,0,0
11372,66636,33683,32953,14124,22064,18837,11611
11373,100820,51175,49645,22566,35607,27752,14895
11374,43600,20464,23136,7725,12799,12576,10500
11375,68733,31722,37011,11678,20140,19517,17398
11377,89830,45234,44596,19249,32078,24401,14102
11378,34981,17124,17857,8197,10565,9889,6330
11379,34821,16529,18292,7035,9068,10486,8232
11385,98592,48510,50082,25174,32469,26696,14253
11411,18556,8308,10248,4275,4546,5363,4372
11412,34882,15589,19293,9163,9231,10027,6461
11413,38912,17667,21245,10020,10084,11395,7413
11414,26148,12295,13853,5182,6033,7405,7528
11415,19341,9255,10086,3816,6323,5349,3853
11416,24861,12369,12492,7266,7684,6805,3106
11417,28967,14008,14959,7743,8279,8629,4316
11418,36256,18172,18084,9810,11397,10063,4986
11419,47211,23557,23654,12796,13977,14236,6202
11420,44354,21457,22897,11945,12705,13222,6482
11421,39127,19312,19815,10510,11800,11195,5622
11422,30425,13815,16610,8348,8329,9123,4625
11423,29987,14160,15827,7222,8253,8872,5640
11424,0,0,0,0,0,0,0
11425,0,0,0,0,0,0,0
11426,17590,8542,9048,4068,4483,5537,3502
11427,23593,11420,12173,5280,6287,7217,4809
11428,19168,9289,9879,4792,5472,5678,3226
11429,25105,11551,13554,6444,6799,7223,4639
11430,184,68,116,76,77,27,4
11432,60809,29988,30821,15715,18466,16174,10454
11433,32687,14819,17868,9669,9314,8485,5219
11434,59129,25829,33300,15977,15467,16679,11006
11435,53687,26353,27334,13674,17526,14487,8000
11436,17949,8379,9570,5114,4994,5143,2698
11451,0,0,0,0,0,0,0
11501,19148,9390,9758,4059,5369,5765,3955
11507,7406,3597,3809,1794,1437,2369,1806
11509,2653,1280,1373,536,356,826,935
11510,33048,15790,17258,8845,7542,10552,6109
11514,4673,2298,2375,1091,1128,1474,980
11516,7556,3655,3901,2417,1756,1741,1642
11518,10549,5032,5517,2577,2240,3464,2268
11520,43341,21094,22247,11434,11992,12350,7565
11530,27273,12916,14357,8117,4656,8346,6154
11542,27633,13475,14158,6270,7249,7906,6208
11545,12065,5832,6233,3330,1763,4134,2838
11547,793,384,409,235,145,264,149
11548,2780,1261,1519,960,1129,406,285
11549,2922,1297,1625,1079,1842,1,0
11550,56435,27780,28655,15960,18372,14246,7857
11552,23616,11491,12125,6613,5333,7116,4554
11553,26034,12544,13490,7336,7817,6537,4344
11554,38132,18893,19239,8735,9294,11549,8554
11556,17,17,0,0,3,8,6
11557,7823,3809,4014,2076,1379,2411,1957
11558,8370,4106,4264,1794,1921,2756,1899
11559,8176,3933,4243,2648,1683,1999,1846
11560,6464,3129,3335,1774,1133,2098,1459
11561,37280,18033,19247,6860,10009,11667,8744
11563,22666,10709,11957,5345,5047,6957,5317
11565,8690,4172,4518,1944,1708,2889,2149
11566,35321,17122,18199,9519,6856,11823,7123
11568,4555,2209,2346,1397,1291,1115,752
11569,1398,677,721,297,208,464,429
11570,26646,12502,14144,7125,5019,8226,6276
11572,30574,14713,15861,7509,6277,9799,6989
11575,16272,7826,8446,4799,4942,4196,2335
11576,12366,6026,6340,3251,1829,3979,3307
11577,12337,5931,6406,3419,2169,3860,2889
11579,5055,2443,2612,1315,870,1804,1066
11580,40113,19105,21008,10312,9916,12333,7552
11581,20844,10013,10831,5476,4453,6437,4478
11590,45768,22457,23311,11324,12866,12370,9208
11596,10480,5066,5414,2772,2035,3346,2327
11598,13328,6549,6779,4172,2631,3591,2934
11691,60035,28160,31875,19591,16310,14062,10072
11692,18540,8465,10075,5920,5221,4712,2687
11693,11916,5541,6375,3119,3121,3606,2070
11694,20408,9962,10446,4546,4356,6434,5072
11697,4079,1886,2193,861,665,1225,1328
11701,27109,12708,14401,6897,6844,7735,5633
11702,14498,7069,7429,3542,3215,4993,2748
11703,16415,7941,8474,4022,4014,5208,3171
11704,40222,19160,21062,10074,10077,12122,7949
11705,8030,3915,4115,2306,1571,2732,1421
11706,62543,30990,31553,17377,17274,18124,9768
11709,6669,3224,3445,1575,1172,2379,1543
11710,34496,16735,17761,8924,7354,11263,6955
11713,10401,5127,5274,3055,2824,2940,1582
11714,22658,10762,11896,5354,4898,6969,5437
11715,4752,2327,2425,1228,997,1579,948
11716,10700,5261,5439,2608,2334,3585,2173
11717,60745,30910,29835,18386,19572,15560,7227
11718,3103,1533,1570,853,499,1156,595
11719,3589,1735,1854,797,643,1171,978
11720,29189,14578,14611,7966,7183,9190,4850
11721,6292,3013,3279,1767,859,2320,1346
11722,35177,17461,17716,10473,11038,9154,4512
11724,3220,1561,1659,1079,413,1160,568
11725,29150,14015,15135,8025,5066,9583,6476
11726,19857,9807,10050,5164,5755,5757,3181
11727,29030,14037,14993,6964,8226,8396,5444
11729,28032,13582,14450,7193,6515,8542,5782
11730,14712,7229,7483,4076,2960,5014,2662
11731,30184,14879,15305,8500,5526,10119,6039
11732,3430,1630,1800,797,642,1108,883
11733,18949,9480,9469,4995,3858,5927,4169
11735,32098,15698,16400,7916,7699,10067,6416
11738,17638,8754,8884,4964,4613,5503,2558
11739,1223,617,606,331,173,445,274
11740,9454,4552,4902,2666,1556,3132,2100
11741,27655,13316,14339,7044,6734,8713,5164
11742,13261,6407,6854,3614,3307,4240,2100
11743,42230,20668,21562,10468,8179,14139,9444
11746,67094,33809,33285,18704,15664,20854,11872
11747,19803,9405,10398,4882,3305,5896,5720
11749,3345,1568,1777,744,890,1004,707
11751,14961,7288,7673,3999,3348,4873,2741
11752,9531,4740,4791,2589,2226,3163,1553
11753,12014,5852,6162,3304,1802,4237,2671
11754,18958,9209,9749,4966,3525,6270,4197
11755,12387,6155,6232,3303,2989,3803,2292
11756,42791,20867,21924,10861,10007,13984,7939
11757,45700,22352,23348,11538,11443,14996,7723
11758,53804,26056,27748,13681,10928,17525,11670
11762,22360,10900,11460,5942,4411,7173,4834
11763,28506,14011,14495,7594,7450,8463,4999
11764,13200,6554,6646,4022,2694,4425,2059
11765,737,351,386,169,107,272,189
11766,12635,6164,6471,3562,2338,3969,2766
11767,14530,7075,7455,4092,3025,4652,2761
11768,21902,10863,11039,5825,3111,7925,5041
11769,9506,4518,4988,2225,1824,2926,2531
11770,137,75,62,21,22,51,43
11771,10007,4890,5117,2455,1952,3203,2397
11772,44837,22049,22788,10962,12348,13238,8289
11776,24235,11729,12506,6493,6116,7102,4524
11777,8968,4427,4541,2045,1930,2739,2254
11778,12709,6305,6404,3729,3260,3964,1756
11779,38421,18870,19551,9918,9519,11950,7034
11780,15524,7479,8045,4277,2571,5038,3638
11782,15814,7537,8277,4191,3042,5116,3465
11783,21288,10326,10962,5522,4319,7141,4306
11784,24655,12194,12461,6740,6538,7518,3859
11786,6344,3182,3162,1983,1188,2199,974
11787,35772,17375,18397,9782,6397,11590,8003
11788,16821,8296,8525,4427,3456,5372,3566
11789,7895,3885,4010,2238,2088,2568,1001
11790,18511,9079,9432,5259,5725,4322,3205
11791,25076,12367,12709,7207,4146,8408,5315
11792,8523,4281,4242,2480,1630,2879,1534
11793,32298,15553,16745,8871,6258,10559,6610
11794,3165,1642,1523,1574,1588,2,1
11795,26030,12749,13281,7284,5146,8683,4917
11796,4056,1898,2158,1004,781,1319,952
11797,9041,4218,4823,2176,1233,2825,2807
11798,15347,7503,7844,5041,4417,4036,1853
11801,39553,19431,20122,9223,9780,12247,8303
11803,28127,13594,14533,7265,4993,9144,6725
11804,5010,2409,2601,1348,839,1621,1202
11901,27172,14118,13054,6032,7554,7293,6293
11930,1343,687,656,241,207,398,497
11931,151,79,72,24,29,43,55
11932,1398,703,695,258,258,440,442
11933,6844,3355,3489,1459,1210,2037,2138
11934,7263,3641,3622,1963,1709,2333,1258
11935,3304,1665,1639,688,472,1080,1064
11937,15398,7775,7623,3543,3733,4667,3455
11939,926,468,458,151,153,256,366
11940,5210,2582,2628,1353,919,1706,1232
11941,1986,981,1005,470,396,624,496
11942,4603,2256,2347,1224,860,1511,1008
11944,4299,2054,2245,792,1014,1084,1409
11946,14068,7246,6822,3382,3847,4020,2819
11947,416,216,200,95,83,136,102
11948,1123,581,542,271,204,350,298
11949,14573,7225,7348,4358,2937,4784,2494
11950,16268,8124,8144,5152,4694,4637,1785
11951,13680,6791,6889,4272,3511,4164,1733
11952,4637,2296,2341,1069,799,1499,1270
11953,13553,6552,7001,3093,3475,3947,3038
11954,3326,1661,1665,636,596,1165,929
11955,3285,1598,1687,574,903,888,920
11956,349,160,189,44,42,114,149
11957,743,351,392,122,71,210,340
11958,635,342,293,118,113,195,209
11959,939,450,489,173,122,306,338
11960,1084,529,555,237,139,366,342
11961,12834,5886,6948,2563,2416,3440,4415
11962,494,244,250,110,57,172,155
11963,6622,3164,3458,1428,1208,2177,1809
11964,1858,929,929,342,260,579,677
11965,534,250,284,87,85,148,214
11967,26583,13256,13327,7970,7358,7967,3288
11968,11593,5804,5789,2592,2647,3413,2941
11970,522,237,285,74,68,137,243
11971,5818,2828,2990,1263,849,1757,1949
11972,1321,646,675,391,259,466,205
11973,9,9,0,7,2,0,0
11975,408,226,182,107,60,116,125
11976,1565,785,780,322,219,550,474
11977,2467,1204,1263,548,445,739,735
11978,3255,1704,1551,804,822,947,682
11980,4990,2739,2251,1004,1454,1665,867
12007,60,35,25,10,12,21,17
12008,497,253,244,143,101,168,85
12009,7164,3570,3594,1758,1351,2587,1468
12010,28937,13889,15048,7249,6774,8167,6747
12015,3010,1460,1550,696,568,978,768
12017,435,224,211,94,71,154,116
12018,7930,3958,3972,2080,1555,2828,1467
12019,14740,7329,7411,3791,2884,4790,3275
12020,31192,15449,15743,8109,7665,9707,5711
12022,929,445,484,218,181,282,248
12023,2196,1119,1077,492,442,781,481
12024,31,15,16,6,5,14,6
12025,5505,2725,2780,1453,1133,1807,1112
12027,3882,1854,2028,1077,611,1303,891
12028,1172,594,578,305,243,352,272
12029,1113,608,505,320,155,364,274
12031,175,91,84,57,28,56,34
12032,836,450,386,179,141,296,220
12033,7851,3810,4041,1996,1555,2568,1732
12035,802,406,396,216,172,249,165
12036,228,116,112,51,44,73,60
12037,4015,1974,2041,934,708,1261,1112
12040,113,58,55,20,19,40,34
12041,481,256,225,119,99,152,111
12042,271,141,130,55,52,86,78
12043,8509,4176,4333,2445,2277,2153,1634
12045,584,288,296,182,149,169,84
12046,817,404,413,193,169,274,181
12047,19664,9360,10304,4641,5193,5781,4049
12051,7070,4832,2238,1607,2558,1859,1046
12052,1568,806,762,377,372,554,265
12053,4587,2326,2261,1171,869,1678,869
12054,16918,8073,8845,4414,2913,5730,3861
12056,2310,1136,1174,548,399,893,470
12057,1835,915,920,447,370,601,417
12058,1445,746,699,352,291,485,317
12059,1632,838,794,352,295,666,319
12060,1507,761,746,312,271,497,427
12061,9050,4302,4748,2122,2106,2866,1956
12062,1776,920,856,401,343,664,368
12063,444,214,230,102,90,163,89
12064,563,309,254,167,114,152,130
12065,41776,20318,21458,10620,9683,13374,8099
12066,2143,1073,1070,530,446,716,451
12067,1506,755,751,315,292,543,356
12068,3201,1598,1603,831,688,988,694
12069,256,135,121,67,77,72,40
12070,1410,694,716,323,301,444,342
12071,270,138,132,67,58,88,57
12072,2890,1478,1412,822,736,822,510
12074,2963,1529,1434,715,557,1062,629
12075,3418,1715,1703,778,585,1100,955
12076,1500,749,751,316,254,486,444
12077,6246,3050,3196,1777,1206,2002,1261
12078,23773,11543,12230,6006,5540,6864,5363
12083,3795,1848,1947,916,735,1244,900
12084,4271,2042,2229,839,1460,1045,927
12085,479,178,301,81,102,118,178
12086,1865,935,930,405,345,613,502
12087,1073,551,522,274,238,324,237
12089,69,34,35,12,11,25,21
12090,6262,2977,3285,1613,1331,1894,1424
12092,1304,642,662,295,318,426,265
12093,1666,857,809,401,307,530,428
12094,2268,1136,1132,606,509,738,415
12095,12606,6249,6357,3055,3176,3555,2820
12106,2193,1058,1135,464,379,716,634
12108,416,211,205,78,67,130,141
12110,21908,10630,11278,5469,5764,6191,4484
12115,189,90,99,30,33,48,78
12116,1920,942,978,419,372,625,504
12117,3256,1649,1607,716,700,1051,789
12118,13897,6703,7194,3450,3516,4041,2890
12120,613,312,301,151,105,193,164
12121,1916,945,971,470,338,694,414
12122,4582,2286,2296,1014,969,1393,1206
12123,5124,2580,2544,1214,1173,1708,1029
12124,606,301,305,129,104,221,152
12125,1373,709,664,278,294,473,328
12130,987,499,488,255,222,323,187
12131,115,62,53,29,17,27,42
12132,338,158,180,69,67,105,97
12134,3516,1762,1754,785,714,1054,963
12136,804,402,402,149,113,281,261
12137,1679,834,845,384,340,623,332
12138,3168,1612,1556,772,650,1030,716
12139,295,143,152,65,42,96,92
12140,1702,813,889,445,346,567,344
12143,5137,2562,2575,1326,1258,1611,942
12144,20555,9869,10686,4750,5596,6141,4068
12147,499,250,249,92,85,187,135
12148,4569,2204,2365,1264,815,1513,977
12149,2474,1200,1274,620,518,750,586
12150,914,436,478,207,197,297,213
12151,708,336,372,149,139,261,159
12153,814,407,407,175,145,308,186
12154,2818,1450,1368,725,574,976,543
12155,1977,974,1003,497,385,635,460
12156,848,431,417,207,176,291,174
12157,4061,1976,2085,876,823,1364,998
12158,6309,3127,3182,1706,1414,2043,1146
12159,7896,3721,4175,2036,1293,2767,1800
12160,944,483,461,220,216,314,194
12161,160,81,79,42,30,50,38
12164,365,177,188,47,67,108,143
12165,175,92,83,25,22,55,73
12166,1363,705,658,312,279,461,311
12167,2438,1151,1287,515,461,720,742
12168,1952,974,978,458,389,653,452
12169,306,162,144,62,68,118,58
12170,4945,2483,2462,1324,1081,1633,907
12172,405,213,192,129,106,116,54
12173,1753,913,840,431,383,547,392
12174,345,172,173,111,69,104,61
12175,797,484,313,178,245,197,177
12176,198,103,95,60,32,68,38
12177,518,256,262,115,115,176,112
12180,53606,27035,26571,13840,17453,13079,9234
12182,14733,7113,7620,3661,3694,4248,3130
12183,2620,1239,1381,539,830,717,534
12184,7148,3539,3609,1666,1313,2287,1882
12185,2037,1015,1022,541,417,694,385
12186,6277,3047,3230,1504,1092,2167,1514
12187,697,362,335,158,136,217,186
12188,10980,5404,5576,2563,2816,3489,2112
12189,17568,8448,9120,3955,5562,4821,3230
12190,674,340,334,141,124,210,199
12192,1722,843,879,420,297,570,435
12193,2016,1030,986,495,383,693,445
12194,207,103,104,59,50,56,42
12195,154,76,78,34,31,45,44
12196,3031,1485,1546,781,605,1017,628
12197,2233,1091,1142,488,399,712,634
12198,7903,3870,4033,2032,1728,2512,1631
12202,9628,4552,5076,2831,3178,2501,1118
12203,29952,14353,15599,5608,11199,6896,6249
12204,7349,3521,3828,1637,2337,1958,1417
12205,26977,12804,14173,5717,6410,8197,6653
12206,16395,8103,8292,4708,5405,4089,2193
12207,1948,1007,941,531,506,508,403
12208,20702,9982,10720,3392,8362,4981,3967
12209,10121,4854,5267,2557,3242,2711,1611
12210,10158,5138,5020,2322,4319,2436,1081
12211,11303,5403,5900,2475,1716,3580,3532
12222,6489,3127,3362,3416,3071,2,0
12302,27582,13339,14243,6491,5677,8523,6891
12303,29857,14268,15589,8033,6623,9125,6076
12304,21482,10136,11346,5699,5446,6059,4278
12305,5716,3272,2444,714,2442,1733,827
12306,25636,12462,13174,6032,6210,7845,5549
12307,7692,3720,3972,2932,2108,1875,777
12308,15335,7306,8029,4648,5083,3469,2135
12309,29343,14076,15267,7244,5776,9357,6966
12401,35040,16916,18124,8135,8703,10360,7842
12404,3385,1717,1668,818,667,1201,699
12405,780,378,402,195,146,262,177
12406,823,400,423,187,154,240,242
12407,173,85,88,48,32,50,43
12409,804,368,436,139,82,310,273
12410,397,206,191,63,73,163,98
12411,497,245,252,117,101,171,108
12412,673,342,331,158,119,242,154
12413,2948,1408,1540,653,655,909,731
12414,10510,5191,5319,2345,2352,3191,2622
12416,277,140,137,74,57,92,54
12417,581,276,305,146,131,188,116
12418,537,261,276,129,84,179,145
12419,722,354,368,176,139,269,138
12420,363,183,180,57,60,124,122
12421,470,239,231,84,60,159,167
12422,339,179,160,70,59,125,85
12423,1097,566,531,232,192,346,327
12424,250,132,118,40,32,82,96
12427,576,261,315,171,129,173,103
12428,6602,3286,3316,1807,1593,1924,1278
12429,281,142,139,48,65,86,82
12430,1194,612,582,272,216,357,349
12431,1381,709,672,343,259,454,325
12432,492,230,262,111,123,141,117
12433,483,240,243,93,46,195,149
12434,751,368,383,178,162,204,207
12435,326,170,156,56,68,115,87
12436,417,208,209,92,64,145,116
12438,59,27,32,11,8,19,21
12439,305,165,140,52,47,127,79
12440,1980,973,1007,368,405,719,488
12441,114,62,52,17,12,43,42
12442,953,496,457,178,148,341,286
12443,3825,1874,1951,877,647,1268,1033
12444,497,253,244,64,64,168,201
12446,5061,2540,2521,1263,1115,1687,996
12448,388,197,191,53,46,135,154
12449,3367,1611,1756,657,646,1083,981
12450,183,94,89,21,37,65,60
12451,1674,810,864,345,352,525,452
12452,213,91,122,34,33,72,74
12453,366,170,196,86,72,129,79
12454,297,153,144,66,45,98,88
12455,1988,973,1015,328,283,625,752
12456,639,319,320,177,140,180,142
12457,763,397,366,122,136,279,226
12458,3232,2095,1137,532,985,1125,590
12459,161,82,79,23,14,61,63
12460,277,137,140,83,38,84,72
12461,1634,816,818,347,282,558,447
12463,1484,720,764,315,294,539,336
12464,1020,490,530,169,177,382,292
12465,266,134,132,37,39,93,97
12466,2471,1153,1318,520,495,792,664
12468,1036,516,520,228,176,301,331
12469,677,343,334,144,126,209,198
12470,536,258,278,132,106,158,140
12471,215,96,119,41,45,64,65
12472,1572,767,805,305,393,495,379
12473,861,426,435,171,173,313,204
12474,1162,572,590,242,193,346,381
12475,354,184,170,75,89,122,68
12477,18787,9188,9599,4379,3985,6145,4278
12480,634,325,309,125,105,205,199
12481,1356,674,682,276,215,490,375
12482,680,337,343,163,153,187,177
12483,259,123,136,66,54,86,53
12484,2733,1330,1403,595,467,984,687
12485,865,457,408,178,197,267,223
12486,1523,732,791,340,350,530,303
12487,3268,1581,1687,793,709,1060,706
12489,1292,1008,284,161,578,432,121
12490,110,56,54,29,22,26,33
12491,1675,810,865,350,250,583,492
12492,271,122,149,47,41,85,98
12493,495,263,232,122,142,154,77
12494,764,377,387,129,111,286,238
12495,265,133,132,32,26,99,108
12496,1634,812,822,336,281,499,518
12498,4851,2267,2584,808,630,1688,1725
12501,2457,1224,1233,626,566,735,530
12502,1164,600,564,233,205,391,335
12503,775,401,374,171,142,256,206
12504,1395,606,789,670,683,24,18
12507,167,88,79,34,38,63,32
12508,19880,10348,9532,4389,5562,6382,3547
12512,127,65,62,26,13,53,35
12513,651,326,325,104,114,201,232
12514,2938,1480,1458,747,466,1069,656
12515,1549,797,752,425,367,497,260
12516,1833,892,941,358,384,588,503
12517,509,260,249,130,98,157,124
12518,5870,2776,3094,1644,1158,1856,1212
12520,3109,1537,1572,788,628,998,695
12521,1644,841,803,355,298,590,401
12522,5172,2662,2510,1213,1105,1641,1213
12523,1798,901,897,390,383,620,405
12524,15598,8067,7531,3388,4124,4770,3316
12525,3311,1648,1663,827,710,1149,625
12526,3686,1847,1839,821,757,1205,903
12527,147,73,74,43,41,42,21
12528,13344,6522,6822,3417,3146,4094,2687
12529,2859,1451,1408,594,419,941,905
12530,124,65,59,21,28,54,21
12531,3601,1839,1762,941,705,1323,632
12533,25307,12583,12724,7543,4773,8890,4101
12534,17867,9055,8812,4069,4150,5265,4383
12538,14578,7200,7378,3693,3742,4005,3138
12540,7802,3920,3882,2318,1284,2833,1367
12542,5913,2879,3034,1530,1290,1875,1218
12543,3001,1392,1609,857,774,915,455
12545,4763,2334,2429,1287,767,1429,1280
12546,3039,1544,1495,671,641,1007,720
12547,2891,1456,1435,741,677,989,484
12548,1494,755,739,382,370,494,248
12549,10201,4995,5206,2907,2138,3307,1849
12550,54447,26539,27908,16552,14783,14621,8491
12553,24438,11936,12502,6520,6014,7509,4395
12561,18308,8473,9835,4868,5897,4354,3189
12563,8084,4159,3925,1935,2199,2810,1140
12564,7338,3762,3576,2037,1359,2414,1528
12565,1487,723,764,417,335,437,298
12566,10753,5390,5363,2996,2262,3629,1866
12567,2854,1404,1450,635,569,949,701
12569,9826,4794,5032,2533,1943,3505,1845
12570,7699,3824,3875,2392,1392,2748,1167
12571,9918,4938,4980,2546,1924,3336,2112
12572,9123,4241,4882,1733,1473,2918,2999
12574,329,176,153,47,82,121,79
12575,2258,1098,1160,650,463,773,372
12577,2029,1011,1018,614,388,710,317
12578,2411,1210,1201,611,432,929,439
12580,4402,2212,2190,1064,805,1497,1036
12581,2246,1115,1131,487,417,831,511
12582,6191,4189,2002,1139,1727,2572,753
12583,2451,1217,1234,591,635,763,462
12585,885,451,434,241,160,307,177
12586,12540,6184,6356,3568,3131,3886,1955
12589,17228,9488,7740,3957,5237,5592,2442
12590,35102,17336,17766,8794,8518,10979,6811
12592,1486,731,755,303,312,526,345
12594,4275,2131,2144,1246,926,1525,578
12601,43398,21014,22384,12029,13571,10649,7149
12603,42810,20520,22290,11419,10186,12787,8418
12604,586,248,338,186,396,0,4
12701,11324,5647,5677,3168,2751,3163,2242
12719,1207,631,576,261,250,443,253
12720,172,82,90,29,33,49,61
12721,6627,3383,3244,1900,1536,2223,968
12722,158,79,79,34,42,56,26
12723,1826,902,924,498,365,474,489
12724,245,123,122,42,53,71,79
12725,277,140,137,54,64,94,65
12726,1162,585,577,242,227,391,302
12729,1874,974,900,492,430,644,308
12732,786,375,411,149,144,248,245
12733,1446,988,458,489,446,420,91
12734,867,462,405,170,239,261,197
12736,118,63,55,19,12,37,50
12737,1910,963,947,493,403,597,417
12738,320,155,165,74,69,120,57
12740,1886,936,950,428,326,639,493
12741,351,179,172,90,80,89,92
12742,181,91,90,45,39,58,39
12743,389,198,191,87,74,132,96
12745,178,86,92,42,43,52,41
12746,937,463,474,253,202,306,176
12747,1714,838,876,448,390,546,330
12748,2076,1034,1042,477,433,639,527
12749,300,155,145,46,56,103,95
12750,187,88,99,46,32,68,41
12751,1054,523,531,498,224,183,149
12752,242,128,114,39,55,74,74
12754,7221,3462,3759,1822,1679,2057,1663
12758,4042,2065,1977,961,811,1244,1026
12759,1649,811,838,540,427,438,244
12760,482,258,224,90,74,177,141
12762,512,258,254,122,117,170,103
12763,942,498,444,232,184,323,203
12764,1802,935,867,365,301,588,548
12765,885,426,459,247,190,281,167
12766,437,217,220,118,85,130,104
12767,126,64,62,30,28,38,30
12768,1131,649,482,238,273,368,252
12769,253,131,122,48,50,102,53
12770,296,139,157,69,68,110,49
12771,14511,7052,7459,4049,3473,4236,2753
12775,2297,1148,1149,573,464,746,514
12776,2180,1105,1075,431,369,683,697
12777,764,378,386,136,139,259,230
12778,633,308,325,116,103,218,196
12779,2460,1244,1216,765,732,636,327
12780,2312,1189,1123,546,475,782,509
12781,307,158,149,64,71,105,67
12783,1668,965,703,322,400,575,371
12784,94,47,47,27,25,28,14
12785,1024,516,508,250,225,338,211
12786,665,329,336,141,111,200,213
12787,452,223,229,98,98,157,99
12788,2908,1863,1045,579,753,1100,476
12789,1838,927,911,517,486,513,322
12790,4518,2240,2278,1004,994,1454,1066
12791,737,350,387,172,133,234,198
12792,335,174,161,82,66,96,91
12801,14707,7138,7569,3578,4279,4210,2640
12803,7567,3651,3916,1876,1700,2375,1616
12804,26540,12706,13834,6478,5074,8533,6455
12808,306,156,150,37,42,92,135
12809,3528,1764,1764,852,679,1186,811
12810,627,332,295,134,124,228,141
12811,127,62,65,31,29,39,28
12812,150,67,83,23,14,55,58
12814,1574,798,776,267,246,492,569
12815,871,433,438,161,172,267,271
12816,4610,2279,2331,1078,874,1474,1184
12817,2274,1136,1138,448,389,773,664
12819,403,199,204,102,79,118,104
12821,2750,2594,156,314,1445,863,128
12822,6200,3042,3158,1622,1463,1865,1250
12823,238,119,119,48,34,79,77
12824,894,450,444,173,114,317,290
12827,3877,1988,1889,929,864,1302,782
12828,9448,4574,4874,2331,2133,2924,2060
12831,17416,8815,8601,4815,4047,5714,2840
12832,7106,3529,3577,1810,1479,2072,1745
12833,4401,2200,2201,1128,952,1586,735
12834,6594,3269,3325,1590,1352,2188,1464
12835,2603,1316,1287,552,528,844,679
12836,574,282,292,81,72,195,226
12837,857,437,420,215,184,276,182
12838,608,304,304,154,122,223,109
12839,13588,6724,6864,3339,3809,3888,2552
12841,77,36,41,4,6,25,42
12842,1166,590,576,192,163,412,399
12843,600,296,304,143,111,208,138
12844,199,101,98,27,28,77,67
12845,4842,2478,2364,959,943,1679,1261
12846,3298,1639,1659,746,741,1068,743
12847,605,318,287,85,95,222,203
12849,385,187,198,86,76,138,85
12850,2835,1480,1355,753,633,972,477
12851,366,192,174,71,74,103,118
12852,436,221,215,83,61,107,185
12853,1770,874,896,374,337,504,555
12855,259,126,133,50,42,95,72
12856,187,91,96,30,23,68,66
12857,498,250,248,107,82,158,151
12858,59,25,34,7,12,15,25
12859,2220,1116,1104,602,541,748,329
12860,748,370,378,171,159,222,196
12861,609,305,304,133,86,201,189
12862,17,10,7,3,2,10,2
12863,533,264,269,127,128,178,100
12864,36,18,18,5,5,14,12
12865,3663,1847,1816,873,728,1192,870
12866,36915,17960,18955,8233,9648,10661,8373
12870,1509,722,787,318,243,480,468
12871,4084,2050,2034,1121,1008,1220,735
12872,31,14,17,1,3,14,13
12873,736,369,367,128,125,261,222
12874,142,73,69,11,9,39,83
12878,719,364,355,130,132,239,218
12883,5025,2485,2540,1213,983,1469,1360
12884,486,241,245,135,115,144,92
12885,4602,2254,2348,1089,963,1397,1153
12886,269,134,135,51,51,84,83
12887,4972,2529,2443,1231,1170,1487,1084
12901,33439,16209,17230,7971,10759,8252,6457
12903,1217,535,682,225,282,314,396
12910,2148,1295,853,434,679,703,332
12911,36,21,15,8,5,17,6
12912,1998,995,1003,446,471,645,436
12913,1157,585,572,291,265,397,204
12914,1044,512,532,355,229,259,201
12916,2135,1061,1074,601,548,570,416
12917,1403,731,672,423,306,428,246
12918,2381,1171,1210,594,521,821,445
12919,3037,1500,1537,766,660,989,622
12920,2842,1516,1326,667,698,887,590
12921,2410,1208,1202,605,557,782,466
12922,65,33,32,13,9,24,19
12923,632,327,305,164,140,194,134
12924,158,77,81,38,29,52,39
12926,2208,1154,1054,571,517,686,434
12927,224,120,104,34,34,75,81
12928,2028,1034,994,473,461,606,488
12929,3938,3357,581,364,1869,1392,313
12930,634,322,312,168,107,206,153
12932,1236,593,643,213,198,383,442
12933,17,9,8,3,8,1,5
12934,1074,544,530,274,248,328,224
12935,1748,912,836,429,413,605,301
12936,599,306,293,110,117,193,179
12937,1572,787,785,416,334,467,355
12939,205,101,104,60,51,65,29
12941,1428,723,705,319,261,508,340
12942,646,306,340,127,118,215,186
12943,459,220,239,81,70,122,186
12944,4080,2048,2032,950,886,1322,922
12945,638,317,321,156,111,238,133
12946,5492,2724,2768,1306,1224,1645,1317
12950,929,500,429,222,232,287,188
12952,546,261,285,108,100,172,166
12953,15836,9932,5904,2935,5455,4711,2735
12955,381,195,186,87,67,130,97
12956,1259,671,588,276,388,348,247
12957,1726,851,875,474,399,522,331
12958,1929,980,949,491,475,614,349
12959,1369,684,685,366,293,468,242
12960,1148,608,540,289,220,383,256
12961,180,103,77,34,38,70,38
12962,5499,2686,2813,1328,1191,1858,1122
12964,161,77,84,38,27,50,46
12965,516,247,269,168,104,153,91
12966,2915,1494,1421,769,672,937,537
12967,1223,631,592,391,299,316,217
12969,423,230,193,90,64,156,113
12970,963,622,341,409,386,104,64
12972,6364,3193,3171,1728,1347,2080,1209
12973,187,86,101,43,33,71,40
12974,1599,787,812,377,366,471,385
12975,265,123,142,52,50,89,74
12976,260,130,130,44,64,92,60
12977,1753,1691,62,29,1232,453,39
12978,403,213,190,116,95,123,69
12979,2304,1109,1195,506,515,753,530
12980,1304,646,658,318,256,413,317
12981,2253,1133,1120,500,487,869,397
12983,7494,3735,3759,1604,1949,2270,1671
12985,1072,558,514,288,241,374,169
12986,6120,3227,2893,1331,1496,1953,1340
12987,201,98,103,36,32,73,60
12989,1010,514,496,212,175,367,256
12992,4778,2427,2351,1225,1091,1616,846
12993,1623,778,845,345,232,556,490
12996,2086,1029,1057,423,380,675,608
12997,1239,621,618,283,268,425,263
12998,526,252,274,148,123,148,107
13020,150,82,68,51,32,44,23
13021,39506,19104,20402,9693,9108,11460,9245
13024,1733,1730,3,11,990,684,48
13026,1914,882,1032,520,533,476,385
13027,31637,15296,16341,8139,6659,10298,6541
13028,1350,717,633,332,274,452,292
13029,7109,3546,3563,2017,1679,2271,1142
13030,3892,1974,1918,880,825,1326,861
13031,15551,7451,8100,3795,3085,4791,3880
13032,12790,6346,6444,3243,2836,4095,2616
13033,3556,1799,1757,965,722,1218,651
13034,1989,1001,988,478,432,628,451
13035,8617,4062,4555,2361,1735,2670,1851
13036,8680,4285,4395,2255,1911,2759,1755
13037,8897,4316,4581,2332,1870,2899,1796
13039,17537,8629,8908,5079,3875,5741,2842
13040,2758,1375,1383,762,555,884,557
13041,10705,5299,5406,3142,2673,3414,1476
13042,2356,1204,1152,610,458,804,484
13044,2512,1312,1200,604,522,895,491
13045,30112,14480,15632,8012,9560,7202,5338
13051,153,81,72,33,40,57,23
13052,1679,828,851,428,332,529,390
13053,5015,2510,2505,1507,1263,1359,886
13054,1582,815,767,435,358,497,292
13057,14992,7200,7792,3455,3134,4699,3704
13060,2806,1388,1418,691,600,887,628
13061,1040,560,480,226,210,408,196
13062,173,84,89,49,53,42,29
13063,1898,943,955,540,352,668,338
13064,64,33,31,10,3,26,25
13066,12390,5924,6466,3054,1956,4106,3274
13068,5368,2729,2639,1452,1322,1657,937
13069,24931,12322,12609,7059,6027,7343,4502
13071,1023,531,492,249,236,336,202
13072,1123,653,470,267,304,358,194
13073,6423,3160,3263,1686,1428,2070,1239
13074,4488,2273,2215,1329,1005,1411,743
13076,2393,1220,1173,693,480,855,365
13077,6735,3302,3433,1807,1423,2088,1417
13078,9866,4976,4890,2505,1811,3205,2345
13080,3631,1848,1783,921,743,1209,758
13081,1169,589,580,272,239,403,255
13082,4871,2358,2513,1119,915,1645,1192
13083,1809,940,869,524,409,584,292
13084,4409,2175,2234,1056,935,1519,899
13087,168,80,88,22,15,69,62
13088,22156,10396,11760,4389,5867,6050,5850
13090,30124,14643,15481,8088,7927,9148,4961
13092,2606,1332,1274,662,584,848,512
13101,2508,1248,1260,671,549,793,495
13102,85,46,39,20,13,35,17
13103,326,170,156,117,77,85,47
13104,15567,7591,7976,4548,2514,5374,3131
13108,6175,3037,3138,1629,1097,2085,1364
13110,2338,1208,1130,566,401,863,508
13111,1700,889,811,480,400,562,258
13112,1973,1016,957,505,364,708,396
13113,287,147,140,94,66,83,44
13114,6356,3159,3197,1760,1430,2015,1151
13115,224,117,107,58,57,66,43
13116,3457,1618,1839,851,795,1022,789
13117,188,97,91,48,43,60,37
13118,6382,3729,2653,1425,1837,1929,1191
13120,2328,1123,1205,571,516,774,467
13122,1174,566,608,374,233,376,191
13123,314,158,156,68,55,117,74
13124,124,72,52,25,29,50,20
13126,37205,18249,18956,9887,10875,9762,6681
13131,3895,1960,1935,1086,878,1219,712
13132,4244,2171,2073,1081,928,1481,754
13134,119,49,70,36,26,39,18
13135,6617,3266,3351,1867,1477,2142,1131
13136,534,277,257,151,108,162,113
13138,61,34,27,19,19,19,4
13140,4488,2233,2255,1170,985,1445,888
13141,596,320,276,138,130,205,123
13142,6451,3210,3241,1708,1428,1956,1359
13143,2873,1589,1284,747,753,878,495
13144,1531,821,710,413,341,515,262
13145,1926,973,953,490,416,580,440
13146,2443,1220,1223,721,547,677,498
13147,1281,680,601,301,328,413,239
13148,10750,5319,5431,2494,2648,3223,2385
13152,7941,3845,4096,1995,1077,2729,2140
13153,399,210,189,115,86,139,59
13155,663,348,315,205,139,204,115
13156,2000,1005,995,464,364,678,494
13157,695,351,344,108,91,252,244
13158,1855,946,909,539,389,584,343
13159,5184,2611,2573,1398,963,1819,1004
13160,2027,1014,1013,523,411,620,473
13162,385,191,194,57,65,130,133
13163,339,161,178,84,76,111,68
13164,2338,1201,1137,689,586,714,349
13165,10741,5186,5555,2662,2337,3135,2607
13166,5610,2749,2861,1455,1158,1878,1119
13167,3342,1718,1624,887,714,1124,617
13202,5438,3103,2335,1469,2196,1347,426
13203,16029,7786,8243,4191,4890,4037,2911
13204,19931,9701,10230,6422,6443,4640,2426
13205,19201,8676,10525,5826,4625,4628,4122
13206,16443,7887,8556,3633,5038,4741,3031
13207,13897,6361,7536,4306,3607,3943,2041
13208,22854,10998,11856,6911,6457,5888,3598
13209,13243,6316,6927,3003,3146,3894,3200
13210,27606,13083,14523,7914,14296,3343,2053
13211,6517,3126,3391,1698,1707,1894,1218
13212,20356,9714,10642,4631,4778,5968,4979
13214,8793,4006,4787,2407,2181,2154,2051
13215,15245,7349,7896,4349,2684,4908,3304
13219,15363,7074,8289,3409,3227,4590,4137
13224,8891,4207,4684,2354,2188,2431,1918
13290,0,0,0,0,0,0,0
13301,98,57,41,15,21,31,31
13302,1610,808,802,493,360,516,241
13303,1153,579,574,275,231,391,256
13304,1684,861,823,404,295,632,353
13305,293,146,147,99,66,81,47
13308,3625,1804,1821,959,796,1146,724
13309,5889,2897,2992,1438,1272,1832,1347
13310,624,288,336,173,150,181,120
13312,331,171,160,43,50,107,131
13313,526,259,267,140,140,150,96
13314,443,215,228,118,94,131,100
13315,1419,740,679,328,310,464,317
13316,6460,3236,3224,1742,1304,2076,1338
13317,3784,1843,1941,1000,839,1158,787
13318,1325,678,647,358,246,493,228
13319,1079,519,560,308,306,287,178
13320,2018,983,1035,449,395,678,496
13321,1049,495,554,239,239,315,256
13322,1076,555,521,258,249,383,186
13323,11323,5343,5980,2674,2828,3022,2799
13324,2149,1100,1049,543,415,748,443
13325,866,441,425,209,175,292,190
13326,5561,2635,2926,1124,1025,1680,1732
13327,2056,1040,1016,553,472,609,422
13328,1267,655,612,302,270,440,255
13329,3889,1928,1961,993,902,1118,876
13331,189,99,90,24,20,67,78
13332,2460,1244,1216,678,526,749,507
13333,62,32,30,10,15,12,25
13334,1374,699,675,386,323,398,267
13335,1590,794,796,414,335,513,328
13337,790,398,392,191,121,254,224
13338,1206,623,583,259,235,394,318
13339,6941,3500,3441,2107,1560,1907,1367
13340,8205,3980,4225,2061,1754,2573,1817
13341,102,46,56,25,21,29,27
13342,165,73,92,29,29,63,44
13343,1658,850,808,427,351,548,332
13345,177,86,91,51,41,64,21
13346,6735,3162,3573,1874,2474,1238,1149
13348,1469,737,732,379,297,461,332
13350,10093,4793,5300,2633,2367,2493,2600
13352,65,27,38,15,15,17,18
13353,86,50,36,15,13,25,33
13354,3342,1699,1643,858,689,1098,697
13355,905,468,437,283,196,260,166
13357,11096,5387,5709,2933,2683,3065,2415
13360,333,172,161,73,54,110,96
13361,824,448,376,255,169,207,193
13362,60,29,31,21,15,12,12
13363,2315,1150,1165,601,454,779,481
13364,243,111,132,75,45,74,49
13365,8906,4392,4514,2325,1925,2644,2012
13367,8830,4351,4479,2422,2016,2458,1934
13368,1118,571,547,301,243,328,246
13402,1534,769,765,409,337,491,297
13403,7372,5221,2151,1233,2475,2585,1079
13404,236,121,115,68,54,78,36
13406,725,354,371,178,150,212,185
13407,5453,2702,2751,1317,1196,1647,1293
13408,4280,2211,2069,1549,1347,816,568
13409,2374,1183,1191,654,554,727,439
13410,241,119,122,62,62,63,54
13411,3264,1585,1679,764,690,956,854
13413,16135,7484,8651,3468,2890,4640,5137
13415,77,40,37,19,15,27,16
13416,2271,1108,1163,612,498,705,456
13417,3305,1585,1720,632,920,864,889
13418,255,133,122,75,65,69,46
13420,1266,624,642,206,202,439,419
13421,14125,6884,7241,3658,3233,4349,2885
13424,2725,1491,1234,612,769,772,572
13425,1970,1000,970,482,462,603,423
13428,1635,810,825,375,320,469,471
13431,2069,1026,1043,556,374,693,446
13433,1820,892,928,538,421,505,356
13435,286,141,145,77,55,90,64
13436,108,61,47,4,22,48,34
13437,460,243,217,95,92,171,102
13438,3789,1925,1864,865,812,1267,845
13439,3950,1930,2020,928,726,1201,1095
13440,42986,21953,21033,10052,10608,12538,9788
13441,51,41,10,28,20,2,1
13450,104,55,49,27,20,42,15
13452,4629,2294,2335,1144,1031,1343,1111
13454,826,411,415,233,201,224,168
13456,4164,2020,2144,1023,836,1350,955
13459,2222,1130,1092,537,496,678,511
13460,4429,2161,2268,1166,922,1382,959
13461,3083,1489,1594,711,612,954,806
13464,1189,625,564,287,248,378,276
13468,451,218,233,111,72,147,121
13469,847,426,421,234,178,296,139
13470,725,365,360,171,128,258,168
13471,3540,1785,1755,1011,783,1144,602
13472,310,163,147,62,34,101,113
13473,766,406,360,201,181,244,140
13475,28,14,14,5,6,8,9
13476,3032,1505,1527,773,657,952,650
13477,1452,722,730,397,322,430,303
13478,3083,1531,1552,796,620,958,709
13480,3532,1758,1774,942,772,1018,800
13483,256,116,140,85,51,86,34
13484,176,89,87,62,32,45,37
13485,1132,570,562,286,219,373,254
13486,815,406,409,193,184,262,176
13488,98,55,43,24,16,32,26
13489,658,339,319,178,142,222,116
13490,1361,704,657,359,280,457,265
13491,3641,1805,1836,974,732,1108,827
13492,11596,5528,6068,2783,2445,3554,2814
13493,2070,1060,1010,627,483,650,310
13494,314,163,151,60,41,110,103
13495,2144,1031,1113,497,596,556,495
13501,38546,18360,20186,11709,10024,9129,7684
13502,33257,16306,16951,8573,8797,9010,6877
13601,38158,18821,19337,10107,11538,9818,6695
13602,3881,3294,587,700,3057,121,3
13603,9760,4739,5021,4367,4607,739,47
13605,4777,2352,2425,1422,1102,1370,883
13606,2716,1335,1381,725,630,896,465
13607,1822,915,907,386,400,566,470
13608,1719,856,863,503,431,501,284
13612,2852,1418,1434,774,718,857,503
13613,2726,1352,1374,731,622,794,579
13614,357,165,192,128,86,91,52
13615,1271,605,666,373,293,366,239
13616,1880,958,922,532,719,411,218
13617,11299,5565,5734,3295,3694,2495,1815
13618,1711,838,873,342,309,543,517
13619,10901,5349,5552,3161,2929,2903,1908
13620,2197,1111,1086,639,499,646,413
13621,650,327,323,167,149,206,128
13622,2432,1219,1213,650,474,776,532
13623,49,25,24,9,8,21,11
13624,5457,3036,2421,1162,1615,1577,1103
13625,1868,954,914,398,393,604,473
13626,2267,1181,1086,639,568,691,369
13628,220,98,122,60,58,48,54
13630,1525,756,769,485,323,407,310
13633,345,183,162,125,77,95,48
13634,3984,1955,2029,1067,854,1289,774
13635,1092,529,563,288,231,313,260
13636,282,146,136,79,60,88,55
13637,4491,2288,2203,1454,1841,822,374
13638,378,186,192,110,109,95,64
13639,243,124,119,69,55,76,43
13640,271,138,133,27,33,82,129
13641,91,46,45,13,11,29,38
13642,10088,5493,4595,2549,2843,2897,1799
13643,19,11,8,6,5,7,1
13646,2211,1117,1094,563,445,656,547
13647,69,33,36,12,26,14,17
13648,2424,1209,1215,614,535,706,569
13650,1391,713,678,336,263,449,343
13651,127,64,63,20,15,41,51
13652,1815,914,901,507,446,509,353
13654,2461,1221,1240,845,528,676,412
13655,3512,1724,1788,1224,884,900,504
13656,2861,1442,1419,905,676,821,459
13658,2357,1182,1175,657,511,710,479
13659,593,295,298,159,124,211,99
13660,1891,964,927,523,417,612,339
13661,1646,822,824,469,353,537,287
13662,16582,7937,8645,4100,3760,4908,3814
13664,399,184,215,98,77,114,110
13665,882,440,442,257,182,285,158
13666,266,134,132,77,50,80,59
13667,3181,1592,1589,787,777,962,655
13668,3329,1656,1673,859,738,1018,714
13669,16452,8681,7771,3793,4211,4983,3465
13670,430,219,211,85,78,144,123
13672,602,301,301,120,119,182,181
13673,2249,1073,1176,735,662,553,299
13674,126,59,67,33,26,39,28
13675,160,77,83,57,45,37,21
13676,16646,8675,7971,4919,6123,3296,2308
13677,93,41,52,33,26,21,13
13678,211,102,109,50,57,65,39
13679,1853,940,913,492,381,621,359
13680,1244,624,620,381,296,350,217
13681,897,465,432,273,229,243,152
13682,877,447,430,245,191,305,136
13684,1131,570,561,294,243,356,238
13685,2272,1127,1145,527,628,666,451
13687,479,249,230,86,75,160,158
13690,846,431,415,180,168,269,229
13691,3176,1616,1560,944,803,940,489
13692,27,14,13,0,0,2,25
13693,503,260,243,96,93,168,146
13694,1507,706,801,344,296,435,432
13695,134,86,48,33,41,34,26
13696,87,44,43,10,22,36,19
13697,2281,1164,1117,646,524,645,466
13730,2805,1390,1415,687,552,859,707
13731,1162,596,566,199,178,342,443
13732,8153,4074,4079,2145,1625,2650,1733
13733,5216,2625,2591,1236,1037,1666,1277
13734,2287,1144,1143,651,484,716,436
13736,2338,1177,1161,599,498,751,490
13739,953,485,468,215,189,287,262
13740,554,290,264,104,74,196,180
13743,3806,1858,1948,1018,786,1224,778
13744,1137,583,554,277,263,381,216
13746,2539,1300,1239,625,486,847,581
13748,3800,1854,1946,923,726,1254,897
13750,1092,546,546,271,241,308,272
13751,189,97,92,47,44,57,41
13752,782,407,375,140,114,255,273
13753,5848,3040,2808,1768,1573,1282,1225
13754,3310,1612,1698,865,650,973,822
13755,1228,612,616,305,212,392,319
13756,613,319,294,126,115,200,172
13757,1045,512,533,234,215,352,244
13760,44264,21432,22832,10198,10210,12984,10872
13774,201,111,90,43,38,63,57
13775,1631,820,811,357,325,517,432
13776,513,223,290,109,72,160,172
13777,727,354,373,187,171,225,144
13778,5948,2977,2971,1509,1141,1898,1400
13780,1045,528,517,260,207,346,232
13782,755,374,381,157,135,252,211
13783,2670,1380,1290,739,468,776,687
13784,172,81,91,48,44,62,18
13786,464,245,219,96,70,168,130
13787,3629,1849,1780,970,739,1183,737
13788,991,488,503,215,201,306,269
13790,19104,9103,10001,4323,5165,5187,4429
13794,105,56,49,26,24,33,22
13795,3800,1892,1908,1003,846,1125,826
13796,1236,596,640,313,236,403,284
13797,2250,1097,1153,581,564,660,445
13801,1398,737,661,347,265,464,322
13802,718,352,366,196,165,238,119
13803,3975,2014,1961,1091,882,1235,767
13804,391,198,193,107,83,120,81
13806,205,101,104,41,41,66,57
13807,1199,579,620,276,251,394,278
13808,1771,878,893,412,327,573,459
13809,1517,764,753,341,338,489,349
13810,1149,555,594,236,229,396,288
13811,4354,2173,2181,1180,888,1394,892
13812,2348,1178,1170,607,470,748,523
13813,977,501,476,263,203,292,219
13815,13999,6747,7252,3602,3252,3968,3177
13820,22455,10542,11913,5843,7620,4829,4163
13825,3442,1682,1760,822,702,1124,794
13826,58,29,29,13,5,25,15
13827,11759,5875,5884,2914,2543,3611,2691
13830,5042,2615,2427,1204,975,1475,1388
13832,709,363,346,196,147,232,134
13833,4255,2172,2083,1107,814,1442,892
13834,118,63,55,24,27,39,28
13835,1511,770,741,384,331,518,278
13838,4409,2107,2302,1109,997,1221,1082
13839,1405,714,691,322,243,473,367
13841,529,274,255,134,95,181,119
13842,695,423,272,177,177,206,135
13843,1888,954,934,453,345,632,458
13844,724,366,358,177,150,231,166
13845,83,41,42,26,19,15,23
13846,305,145,160,65,48,100,92
13847,67,31,36,17,14,19,17
13849,4551,2279,2272,1052,863,1443,1193
13850,22004,10609,11395,4782,4956,6470,5796
13856,6596,3282,3314,1563,1383,1981,1669
13859,182,93,89,39,40,58,45
13860,94,45,49,18,25,33,18
13861,432,216,216,101,84,143,104
13862,4189,2081,2108,1109,947,1295,838
13863,688,355,333,216,165,176,131
13864,1149,576,573,279,251,367,252
13865,6371,3230,3141,1702,1239,2092,1338
13901,19773,9684,10089,4803,4804,5771,4395
13902,6177,3223,2954,3355,2821,1,0
13903,18763,9198,9565,4591,4695,5541,3936
13904,9579,4620,4959,2252,2186,2859,2282
13905,28026,13980,14046,5769,9310,7012,5935
14001,9464,4688,4776,2255,1913,3001,2295
14004,12704,7173,5531,2639,3012,4299,2754
14005,1986,984,1002,610,381,643,352
14006,9858,4811,5047,2350,2038,3268,2202
14008,1467,741,726,409,278,516,264
14009,5672,2806,2866,1455,1283,1751,1183
14011,9822,6764,3058,1592,3492,3388,1350
14012,2362,1187,1175,675,450,734,503
14013,1751,874,877,464,384,536,367
14020,23306,11428,11878,5523,5812,6531,5440
14024,1688,854,834,492,365,516,315
14025,3039,1553,1486,822,585,1073,559
14026,674,342,332,174,127,228,145
14028,1595,816,779,409,304,525,357
14030,1807,934,873,434,393,577,403
14031,9392,4455,4937,2304,1390,3062,2636
14032,7989,3986,4003,2705,1323,2710,1251
14033,2219,1117,1102,551,407,823,438
14034,2742,1863,879,447,930,950,415
14035,125,62,63,37,27,39,22
14036,5201,2568,2633,1271,1042,1821,1067
14037,1166,598,568,256,225,419,266
14039,101,51,50,21,23,35,22
14040,2217,1152,1065,516,455,771,475
14041,237,110,127,67,45,82,43
14042,3969,1981,1988,1065,962,1187,755
14043,24742,11856,12886,5049,5983,7270,6440
14047,6440,3194,3246,1515,1366,2186,1373
14048,15072,7344,7728,3684,3655,4239,3494
14051,19533,9523,10010,5495,3365,6766,3907
14052,17329,8352,8977,4284,2962,5823,4260
14054,1344,683,661,351,319,431,243
14055,1405,703,702,300,233,532,340
14057,8116,4080,4036,2028,1508,2786,1794
14058,2285,1170,1115,615,506,744,420
14059,8933,4435,4498,2045,1435,3036,2417
14060,443,235,208,104,88,143,108
14061,349,174,175,100,102,88,59
14062,3329,1694,1635,763,620,1199,747
14063,14870,7100,7770,4063,4892,3337,2578
14065,1896,954,942,547,391,606,352
14066,1318,687,631,349,258,455,256
14067,5040,2504,2536,1321,1044,1664,1011
14068,7150,3216,3934,1743,1236,2141,2030
14069,844,434,410,186,174,307,177
14070,6732,4129,2603,1288,1985,2175,1284
14072,20374,10050,10324,5222,4122,6690,4340
14075,41937,19990,21947,10032,8649,13072,10184
14080,4330,2180,2150,1078,887,1560,805
14081,3095,1489,1606,819,607,956,713
14082,426,219,207,101,114,131,80
14085,7353,3711,3642,2148,1741,2352,1112
14086,31847,15465,16382,8478,6641,10707,6021
14091,1079,554,525,278,253,338,210
14092,11086,5128,5958,2220,1999,3265,3602
14094,50666,24836,25830,12671,12556,15354,10085
14098,2958,1504,1454,829,608,939,582
14101,1905,910,995,470,365,570,500
14102,1281,637,644,359,238,432,252
14103,11183,5452,5731,3066,2461,3231,2425
14105,4566,2237,2329,1193,974,1505,894
14108,5882,2838,3044,1488,1207,1831,1356
14109,1117,483,634,685,432,0,0
14111,3352,1662,1690,882,704,1092,674
14112,85,42,43,34,16,25,10
14113,703,367,336,186,155,240,122
14120,45100,21943,23157,10513,10402,14172,10013
14125,3782,1848,1934,1054,910,1122,696
14126,588,291,297,125,95,196,172
14127,29961,14377,15584,7599,5424,9559,7379
14129,1591,774,817,419,358,484,330
14130,265,135,130,87,52,81,45
14131,5283,2678,2605,1289,1051,1813,1130
14132,6218,3089,3129,1625,1316,1921,1356
14134,104,53,51,27,17,29,31
14135,119,60,59,20,22,51,26
14136,5033,2460,2573,1290,1078,1530,1135
14138,2018,1026,992,603,431,578,406
14139,2125,1061,1064,478,434,753,460
14141,7728,3809,3919,2010,1599,2339,1780
14143,1214,625,589,264,249,401,300
14145,1618,824,794,391,378,515,334
14150,41676,19982,21694,8755,10092,12129,10700
14167,1663,897,766,366,351,588,358
14168,36,19,17,8,7,12,9
14169,151,70,81,47,34,36,34
14170,2286,1156,1130,540,398,830,518
14171,2077,1074,1003,488,392,725,472
14172,3200,1592,1608,802,561,1107,730
14173,396,188,208,91,89,124,92
14174,5794,2885,2909,1381,1021,1902,1490
14201,11549,5663,5886,2956,3909,2834,1850
14202,3911,2403,1508,568,1587,1109,647
14203,1618,874,744,345,657,348,268
14204,8691,3867,4824,2385,2043,2614,1649
14206,20751,10046,10705,4903,5272,6210,4366
14207,23552,11446,12106,7444,6768,6058,3282
14208,11125,4962,6163,3227,2861,2553,2484
14209,7926,3730,4196,1553,2641,2030,1702
14210,14694,7222,7472,4070,4185,4162,2277
14211,22611,10275,12336,7315,5472,6223,3601
14212,10641,5230,5411,3008,2589,3141,1903
14213,24465,12112,12353,8027,8237,5547,2654
14214,19775,10025,9750,5004,7306,4657,2808
14215,39999,17815,22184,13268,10403,10374,5954
14216,22431,10727,11704,4563,7652,6264,3952
14217,23480,10823,12657,5025,6118,6744,5593
14218,19039,9118,9921,4627,4864,5200,4348
14219,11536,5514,6022,2720,2852,3359,2605
14220,24227,11646,12581,6115,6806,7011,4295
14221,53555,24916,28639,12033,10039,15189,16294
14222,14046,6943,7103,2297,6193,3201,2355
14223,22665,10697,11968,5150,5402,6738,5375
14224,39889,19094,20795,8712,8320,12059,10798
14225,33385,15703,17682,7148,8643,9531,8063
14226,29267,13762,15505,6972,8216,7752,6327
14227,23426,10925,12501,4266,5558,6432,7170
14228,20857,10221,10636,4703,7285,4999,3870
14261,5713,2914,2799,2548,3157,8,0
14301,12817,6046,6771,3211,3338,3667,2601
14302,107,27,80,0,0,9,98
14303,5981,2935,3046,1497,1531,1754,1199
14304,30389,14681,15708,6664,7115,9222,7388
14305,16898,7895,9003,4544,4395,4629,3330
14411,14491,7201,7290,3326,3970,4440,2755
14414,7142,3505,3637,1704,1617,2273,1548
14415,132,60,72,40,38,31,23
14416,3817,1899,1918,981,769,1276,791
14418,1325,661,664,281,231,460,353
14420,20467,9892,10575,5723,6455,5157,3132
14422,2468,1244,1224,631,523,857,457
14423,4799,2402,2397,1208,956,1646,989
14424,27007,13185,13822,6335,5678,8243,6751
14425,10717,5209,5508,3092,2865,3205,1555
14427,1964,989,975,487,463,609,405
14428,8096,4032,4064,2025,1648,2862,1561
14432,5726,2772,2954,1420,1199,1764,1343
14433,4629,2322,2307,1345,1045,1361,878
14435,2941,1492,1449,657,555,1092,637
14437,11415,6457,4958,2422,3006,3761,2226
14441,325,174,151,69,87,81,88
14445,8019,3920,4099,1939,2403,2224,1453
14450,41104,19737,21367,10543,7730,13395,9436
14454,11073,5071,6002,3247,4366,1849,1611
14456,20087,9579,10508,5149,5236,5342,4360
14462,655,334,321,176,123,234,122
14464,7524,3731,3793,2117,1744,2504,1159
14466,1719,881,838,426,358,630,305
14467,9105,4369,4736,2250,2116,2803,1936
14468,17813,8781,9032,4658,3690,5899,3566
14469,6220,3101,3119,1506,1214,2146,1354
14470,8016,3942,4074,2026,1750,2640,1600
14471,2672,1361,1311,522,466,932,752
14472,8598,4248,4350,2453,1269,3215,1661
14475,234,113,121,69,32,80,53
14476,2288,1169,1119,584,410,789,505
14477,1732,854,878,466,324,584,358
14478,1595,604,991,443,627,266,259
14479,275,136,139,75,60,80,60
14480,833,391,442,220,207,230,176
14481,1820,909,911,417,416,589,398
14482,8275,4073,4202,2110,1850,2551,1764
14485,4267,2103,2164,1095,927,1373,872
14486,308,151,157,76,79,101,52
14487,6025,2959,3066,1634,1190,2030,1171
14489,7192,3519,3673,1756,1541,2178,1717
14502,10691,5296,5395,3085,2275,3500,1831
14504,1701,812,889,387,402,500,412
14505,5393,2642,2751,1445,1137,1778,1033
14506,1325,650,675,388,191,479,267
14507,1351,671,680,334,246,451,320
14510,4895,2385,2510,1119,1123,1466,1187
14511,497,232,265,114,89,186,108
14512,4721,2330,2391,1194,822,1579,1126
14513,13976,6746,7230,3486,3141,4211,3138
14514,6389,3023,3366,1783,1634,1653,1319
14516,2365,1132,1233,555,465,737,608
14517,2883,1393,1490,732,637,895,619
14519,11581,5745,5836,3043,2384,3951,2203
14521,2761,1381,1380,779,559,809,614
14522,9565,4794,4771,2381,2103,3065,2016
14525,2865,1477,1388,748,656,928,533
14526,19804,9450,10354,5059,3557,6584,4604
14527,12820,6217,6603,3503,2530,3515,3272
14529,67,33,34,13,7,26,21
14530,5575,2721,2854,1407,1331,1606,1231
14532,4431,2180,2251,1158,906,1446,921
14533,2000,1062,938,521,422,639,418
14534,31426,15142,16284,8714,4115,10609,7988
14536,687,349,338,184,154,216,133
14537,207,101,106,53,49,62,43
14539,242,107,135,63,53,69,57
14541,4129,2778,1351,939,1457,1171,562
14542,97,50,47,20,19,31,27
14543,3152,1607,1545,756,499,1126,771
14544,2101,1036,1065,613,400,660,428
14545,173,89,84,36,46,58,33
14546,4695,2386,2309,1059,1125,1551,960
14548,4249,2140,2109,1058,868,1472,851
14549,91,38,53,20,25,29,17
14550,1537,748,789,359,340,488,350
14551,5651,2799,2852,1475,1189,1733,1254
14555,974,500,474,166,158,356,294
14559,18057,8835,9222,4741,3653,6033,3630
14560,2164,1127,1037,490,414,808,452
14561,3086,1578,1508,871,658,997,560
14564,14487,7086,7401,4164,2540,4667,3116
14568,6048,3012,3036,1752,1306,2098,892
14569,6211,3013,3198,1532,1391,1878,1410
14571,1176,598,578,249,208,423,296
14572,5081,2506,2575,1312,1102,1623,1044
14580,50587,24439,26148,13132,9813,16048,11594
14585,120,49,71,13,11,36,60
14586,10256,5236,5020,2760,3585,2736,1175
14588,749,667,82,43,531,157,18
14589,7854,3912,3942,1999,1564,2478,1813
14590,5446,2757,2689,1438,1120,1647,1241
14591,1748,901,847,439,380,552,377
14592,110,55,55,25,27,41,17
14604,1743,1019,724,105,737,581,320
14605,12610,5812,6798,4914,3652,2685,1359
14606,28255,13470,14785,7847,7183,7881,5344
14607,16223,8604,7619,1276,9707,3382,1858
14608,12268,5901,6367,4029,3797,2994,1448
14609,42571,19627,22944,12070,12445,11298,6758
14610,14233,6629,7604,2332,4177,3876,3848
14611,17396,8282,9114,5898,4654,4202,2642
14612,34515,16740,17775,7954,7965,11245,7351
14613,14730,7158,7572,5352,4258,3766,1354
14614,1224,1146,78,152,666,379,27
14615,16099,7664,8435,4481,4806,4218,2594
14616,28534,13283,15251,7217,7135,7947,6235
14617,22789,10788,12001,5580,4577,7045,5587
14618,22920,10297,12623,6329,5153,6077,5361
14619,14749,6754,7995,4566,4083,3928,2172
14620,25141,12407,12734,3746,11225,5741,4429
14621,33802,15630,18172,11282,8847,8149,5524
14622,12108,5722,6386,2380,2746,3896,3086
14623,27173,14975,12198,7444,11131,4802,3796
14624,36296,17410,18886,8763,8682,11113,7738
14625,10387,5073,5314,2264,1841,3406,2876
14626,30041,14120,15921,6919,6411,8893,7818
14627,2320,1229,1091,1409,911,0,0
14701,40730,19813,20917,10685,9678,11362,9005
14706,6356,3048,3308,1529,1364,1884,1579
14707,239,132,107,80,53,64,42
14708,183,95,88,52,41,59,31
14709,1535,811,724,403,311,446,375
14710,3540,1770,1770,835,653,1142,910
14711,1766,876,890,502,408,480,376
14712,3342,1657,1685,762,511,1088,981
14714,487,252,235,155,103,137,92
14715,2747,1340,1407,773,655,784,535
14716,3104,1843,1261,770,1099,753,482
14717,636,338,298,113,111,211,201
14718,2163,1089,1074,559,459,677,468
14719,3497,1763,1734,1021,682,1044,750
14720,675,338,337,168,171,187,149
14721,230,114,116,52,59,69,50
14722,153,69,84,5,4,29,115
14723,1295,651,644,380,267,397,251
14724,2540,1269,1271,826,505,696,513
14726,2156,1094,1062,1011,430,450,265
14727,5450,2654,2796,1269,1123,1648,1410
14728,1031,530,501,245,192,315,279
14729,948,504,444,263,195,330,160
14731,1576,805,771,306,253,532,485
14732,211,111,100,61,32,75,43
14733,3833,1942,1891,951,835,1112,935
14735,2751,1408,1343,854,608,716,573
14736,282,141,141,82,52,89,59
14737,4252,2148,2104,1108,887,1324,933
14738,3651,1808,1843,910,659,1181,901
14739,2903,1473,1430,808,664,786,645
14740,1431,677,754,337,259,367,468
14741,1873,935,938,477,348,595,453
14742,314,127,187,31,30,70,183
14743,1783,919,864,444,397,595,347
14744,2094,883,1211,707,786,279,322
14747,2289,1145,1144,587,453,763,486
14748,746,365,381,228,157,190,171
14750,4426,2156,2270,1005,762,1368,1291
14752,169,67,102,19,15,51,84
14753,1166,565,601,290,252,361,263
14754,667,337,330,161,137,208,161
14755,2916,1522,1394,689,687,923,617
14756,110,52,58,21,19,35,35
14757,3487,1835,1652,835,786,1007,859
14760,18775,9061,9714,4544,4608,5380,4243
14767,2088,1056,1032,703,449,546,390
14769,919,456,463,214,173,296,236
14770,2963,1442,1521,813,657,899,594
14772,4255,2162,2093,1352,892,1125,886
14774,151,73,78,56,45,32,18
14775,2537,1278,1259,664,539,783,551
14777,667,324,343,159,107,207,194
14778,1453,694,759,644,805,3,1
14779,6932,3350,3582,1847,1635,1951,1499
14781,2225,1119,1106,678,512,610,425
14782,2401,1197,1204,633,540,730,498
14783,320,170,150,87,72,91,70
14784,1033,519,514,288,217,331,197
14787,5121,2476,2645,1177,974,1564,1406
14788,163,90,73,37,31,61,34
14801,5475,2726,2749,1607,1331,1513,1024
14802,4135,2512,1623,1707,2104,173,151
14803,1174,615,559,277,267,370,260
14804,1479,739,740,382,293,478,326
14805,1100,550,550,278,221,362,239
14806,2269,1128,1141,650,479,643,497
14807,3076,1506,1570,786,582,963,745
14808,591,322,269,166,134,176,115
14809,2552,1302,1250,705,557,719,571
14810,12356,6285,6071,2845,2617,3811,3083
14812,3478,1834,1644,889,854,1051,684
14813,2520,1284,1236,624,562,745,589
14814,1931,971,960,484,401,554,492
14815,946,481,465,235,178,297,236
14816,520,263,257,123,106,180,111
14817,2380,1201,1179,567,654,718,441
14818,1745,879,866,393,328,599,425
14819,733,389,344,215,160,207,151
14820,784,392,392,233,180,232,139
14821,3314,1653,1661,909,645,1091,669
14822,1169,600,569,281,251,377,260
14823,3754,1838,1916,994,770,1096,894
14824,678,344,334,166,154,212,146
14825,919,476,443,241,198,299,181
14826,2216,1122,1094,551,450,732,483
14827,191,95,96,41,42,55,53
14830,19850,9735,10115,5013,4961,5906,3970
14836,1009,530,479,248,186,332,243
14837,5648,2802,2846,1754,1106,1566,1222
14838,1956,1010,946,475,407,665,409
14839,793,401,392,219,173,225,176
14840,3061,1515,1546,562,475,1050,974
14841,915,467,448,184,187,294,250
14842,938,471,467,323,188,220,207
14843,13043,6347,6696,3419,3025,3659,2940
14845,20453,9720,10733,4856,3947,6213,5437
14846,792,399,393,215,133,268,176
14847,2398,1205,1193,585,502,708,603
14850,63886,31290,32596,15194,26902,12608,9182
14853,2755,1473,1282,1494,1257,4,0
14854,37,12,25,4,6,8,19
14855,956,487,469,372,196,234,154
14856,215,116,99,60,55,65,35
14858,1598,804,794,450,386,444,318
14859,1029,507,522,252,194,375,208
14860,1039,538,501,254,207,337,241
14861,1404,704,700,338,269,449,348
14864,1307,649,658,315,292,404,296
14865,2607,1224,1383,550,465,801,791
14867,5569,2704,2865,1472,1275,1770,1052
14869,1378,687,691,345,317,410,306
14870,9821,4808,5013,2460,2071,2929,2361
14871,5456,3102,2354,1059,1417,1770,1210
14872,605,303,302,158,145,190,112
14873,2448,1215,1233,605,491,777,575
14874,250,121,129,48,45,68,89
14877,401,214,187,88,71,131,111
14878,781,392,389,216,134,251,180
14879,2398,1182,1216,676,525,724,473
14880,1668,847,821,407,356,525,380
14881,192,91,101,26,54,63,49
14882,3826,1915,1911,1046,707,1263,810
14883,4136,2070,2066,1083,876,1308,869
14884,273,142,131,53,47,97,76
14885,873,440,433,307,192,223,151
14886,6753,3289,3464,1601,1322,2258,1572
14889,1590,790,800,434,333,502,321
14891,4149,2004,2145,940,863,1358,988
14892,8189,3917,4272,2128,1862,2374,1825
14893,6,4,2,0,1,1,4
14894,1454,730,724,360,304,433,357
14895,9616,4625,4991,2317,2069,2716,2514
14897,980,498,482,291,226,254,209
14898,1734,876,858,648,384,416,286
14901,16736,8816,7920,4325,5162,4415,2834
14903,7567,3690,3877,1908,1713,2345,1601
14904,16269,7826,8443,4560,4119,4500,3090
14905,9070,4331,4739,2221,1979,2634,2236
27006,14150,6937,7213,3428,2347,4544,3831
27007,2162,1081,1081,597,496,651,418
27009,2647,1330,1317,672,619,883,473
27011,5497,2669,2828,1396,1207,1606,1288
27012,25461,12340,13121,6900,4857,8347,5357
27013,6057,2986,3071,1710,1476,1838,1033
27014,840,400,440,234,191,237,178
27016,1936,950,986,450,417,641,428
27017,9597,4891,4706,2770,2431,2610,1786
27018,7655,3752,3903,1971,1628,2489,1567
27019,4032,2008,2024,969,760,1394,909
27020,6421,3222,3199,1780,1502,1719,1420
27021,18106,8618,9488,4771,4008,5380,3947
27022,1560,774,786,338,324,534,364
27023,11873,5760,6113,3219,2083,4235,2336
27024,2733,1408,1325,714,618,822,579
27025,11138,5494,5644,2628,2429,3470,2611
27027,4385,2099,2286,1021,986,1273,1105
27028,25839,12587,13252,6936,5799,7632,5472
27030,38374,18426,19948,9795,8488,10982,9109
27040,10893,5310,5583,2770,1872,3737,2514
27041,7554,3706,3848,1882,1617,2324,1731
27042,834,424,410,198,192,245,199
27043,6615,3313,3302,1577,1378,2228,1432
27045,8536,4144,4392,2245,2008,2517,1766
27046,2024,1023,1001,461,493,645,425
27047,1191,595,596,318,270,331,272
27048,8609,4282,4327,2191,1868,2643,1907
27050,3893,1925,1968,903,798,1340,852
27051,7369,3592,3777,1948,1704,2250,1467
27052,10624,5188,5436,2502,2146,3433,2543
27053,3007,1515,1492,724,569,924,790
27054,2567,1260,1307,730,588,747,502
27055,14200,7007,7193,3592,3181,4142,3285
27101,18901,9372,9529,4391,5776,5399,3335
27103,33208,15355,17853,8180,10599,8192,6237
27104,28485,13136,15349,6650,6962,8071,6802
27105,39568,18525,21043,12199,10011,10369,6989
27106,45015,21075,23940,11505,12830,11816,8864
27107,46963,22761,24202,14729,12509,12516,7209
27109,2539,1236,1303,1548,991,0,0
27110,2127,731,1396,1109,1016,2,0
27127,34138,16045,18093,9431,10313,8988,5406
27201,63,31,32,11,18,18,16
27203,21108,10022,11086,6249,6072,4851,3936
27205,33216,16613,16603,8835,7546,9849,6986
27207,3795,1837,1958,878,817,1157,943
27208,1676,833,843,376,365,484,451
27209,3933,1926,2007,1266,1033,866,768
27212,2580,1799,781,339,988,816,437
27214,10294,5034,5260,3053,2688,2937,1616
27215,38807,18088,20719,9256,9436,10553,9562
27217,36954,17744,19210,10503,9074,10234,7143
27229,3929,1895,2034,1314,944,936,735
27231,2148,1062,1086,489,425,739,495
27233,3390,1705,1685,811,706,1127,746
27235,4136,1930,2206,1018,711,1221,1186
27239,9079,4427,4652,2228,1874,2837,2140
27242,2100,1037,1063,590,494,589,427
27243,4337,2151,2186,1121,943,1493,780
27244,14173,6561,7612,4141,4631,3043,2358
27248,4524,2255,2269,1223,998,1441,862
27249,12486,6045,6441,3192,2954,3838,2502
27252,2003,970,1033,427,398,651,527
27253,29827,14391,15436,7985,7361,8601,5880
27258,6006,2942,3064,1639,1421,1850,1096
27260,24023,11326,12697,7672,6423,5984,3944
27262,23934,11154,12780,6870,6149,6134,4781
27263,21414,10386,11028,5765,5281,6051,4317
27265,46690,22162,24528,12245,12453,13763,8229
27278,24286,11778,12508,6371,5287,8161,4467
27281,3100,1511,1589,901,694,814,691
27282,15906,7651,8255,4249,3676,4978,3003
27283,3141,1595,1546,705,633,1042,761
27284,51136,24641,26495,13407,12274,15761,9694
27288,24071,11244,12827,5859,5418,6949,5845
27291,1662,851,811,380,290,562,430
27292,39787,19624,20163,10271,9340,11783,8393
27295,37211,18311,18900,9515,8334,11472,7890
27298,10336,5202,5134,2674,2331,3100,2231
27299,5190,2616,2574,1532,1384,1459,815
27301,8750,4190,4560,2429,2115,2598,1608
27302,26412,12620,13792,7175,6513,7834,4890
27305,1685,798,887,433,323,575,354
27306,6176,3014,3162,1375,1163,1917,1721
27310,6710,3400,3310,2184,1029,2576,921
27311,3402,1628,1774,827,696,1072,807
27312,18306,8665,9641,3741,3434,5767,5364
27313,6962,3400,3562,1635,1374,2251,1702
27314,1051,538,513,235,227,347,242
27315,2243,1105,1138,515,489,660,579
27316,6650,3329,3321,1838,1520,1835,1457
27317,16959,8375,8584,4693,4251,4928,3087
27320,39351,19070,20281,9677,8830,12130,8714
27325,6704,3318,3386,1891,1602,1854,1357
27326,4008,1947,2061,1001,894,1288,825
27330,37947,18560,19387,10823,9907,10419,6798
27332,30236,14786,15450,9115,8124,7649,5348
27340,120,58,62,9,74,27,10
27341,5360,2684,2676,1356,1233,1672,1099
27343,1716,829,887,374,333,584,425
27344,18022,8839,9183,5260,4606,4689,3467
27349,5511,2738,2773,1426,1252,1816,1017
27350,6530,3241,3289,1677,1527,2033,1293
27355,2660,1314,1346,722,576,805,557
27356,3205,1606,1599,871,755,916,663
27357,7894,3931,3963,2146,1848,2450,1450
27358,14075,7019,7056,4235,2272,5236,2332
27360,46084,22401,23683,12669,11296,13091,9028
27370,15052,7452,7600,3887,3249,4798,3118
27371,8132,3803,4329,1900,2114,2372,1746
27376,9386,4547,4839,2158,1619,2606,3003
27377,7104,3366,3738,1680,2154,1977,1293
27379,4661,2159,2502,1097,908,1418,1238
27401,21932,10338,11594,6570,7990,4487,2885
27403,21958,10218,11740,5726,9141,4438,2653
27405,44567,21204,23363,13635,13207,10994,6731
27406,56458,26573,29885,15758,15148,15530,10022
27407,46242,22666,23576,12403,15559,11641,6639
27408,17296,8218,9078,3804,4152,4993,4347
27409,15621,7283,8338,3495,6277,3672,2177
27410,52388,24446,27942,11947,14174,14696,11571
27455,28706,13486,15220,7623,6892,8776,5415
27501,17571,8683,8888,5323,4823,4816,2609
27502,30831,15074,15757,10591,7739,9496,3005
27503,3471,1731,1740,813,624,1289,745
27504,14566,7066,7500,4071,3774,4133,2588
27505,5896,2905,2991,1809,1559,1512,1016
27507,1929,939,990,514,382,601,432
27508,2053,1221,832,400,664,642,347
27509,10167,7833,2334,1499,3670,3399,1599
27510,14644,7088,7556,2777,7489,3169,1209
27511,32029,15621,16408,8042,8552,8959,6476
27513,40755,19955,20800,11416,11290,13691,4358
27514,32110,14831,17279,9880,11885,6180,4165
27516,36139,17430,18709,9713,11298,10643,4485
27517,23346,10960,12386,4914,6357,6041,6034
27518,19630,9480,10150,5345,4254,6917,3114
27519,39178,19016,20162,13551,9967,11827,3833
27520,36357,17790,18567,11107,9865,10608,4777
27521,6035,3014,3021,1760,1690,1621,964
27522,12335,6067,6268,3504,3133,3739,1959
27523,9552,4714,4838,2854,2161,3273,1264
27524,12338,6084,6254,3558,3145,3378,2257
27525,13338,6513,6825,3715,3377,4026,2220
27526,38894,18950,19944,11957,9706,11177,6054
27527,18216,9018,9198,6362,4410,5412,2032
27529,42128,20346,21782,12032,11078,12505,6513
27530,40117,19548,20569,10808,9988,11518,7803
27531,594,503,91,109,485,0,0
27534,31364,15060,16304,8136,8715,8301,6212
27536,17289,7749,9540,4938,4153,4416,3782
27537,24319,11782,12537,6842,5734,7008,4735
27539,18692,9233,9459,5930,4517,6068,2177
27540,29363,14375,14988,10534,8147,7992,2690
27541,3770,1890,1880,916,755,1259,840
27542,9133,4494,4639,2526,2229,2613,1765
27544,4449,2150,2299,1271,1019,1319,840
27545,23006,11020,11986,7204,6958,6234,2610
27546,19471,9788,9683,5508,6188,4858,2917
27549,24112,11828,12284,6424,5530,6985,5173
27551,1962,999,963,355,307,638,662
27553,2937,1886,1051,477,948,973,539
27555,441,191,250,122,118,73,128
27556,346,164,182,96,78,108,64
27557,7509,3676,3833,2283,1819,2058,1349
27559,2288,1137,1151,596,481,791,420
27560,22623,11094,11529,5989,9767,5259,1608
27562,1938,981,957,464,345,655,474
27563,5008,2364,2644,1342,1129,1405,1132
27565,25255,12075,13180,6538,5435,7649,5633
27568,480,209,271,126,119,118,117
27569,8022,3922,4100,2375,2065,2184,1398
27571,3893,1956,1937,1353,1003,1081,456
27572,6546,3272,3274,1541,1305,2372,1328
27573,11414,5208,6206,3010,2610,3066,2728
27574,14373,7057,7316,3608,3183,4390,3192
27576,17091,8324,8767,5143,4478,4558,2912
27577,22911,11441,11470,6300,6118,5931,4562
27581,3049,1537,1512,811,710,972,556
27582,289,143,146,71,58,71,89
27583,6921,3489,3432,1870,1615,2207,1229
27587,53078,25949,27129,17303,12403,16492,6880
27589,8370,3979,4391,2137,1756,2354,2123
27591,19589,9594,9995,5930,5196,5577,2886
27592,15244,7648,7596,4806,4082,4589,1767
27596,15619,7797,7822,4543,3861,4929,2286
27597,22181,11032,11149,6357,5460,6679,3685
27601,9450,4858,4592,2747,3253,2291,1159
27603,47033,24260,22773,11716,17256,12357,5704
27604,42204,20235,21969,11578,14328,10931,5367
27605,4495,2256,2239,394,2202,1077,822
27606,43210,23338,19872,8748,21758,9023,3681
27607,25188,12612,12576,9106,8844,4454,2784
27608,10429,4983,5446,2292,3242,2976,1919
27609,32964,15699,17265,7608,10168,8532,6656
27610,65648,30476,35172,21703,20794,16061,7090
27612,35028,16525,18503,7004,12545,9132,6347
27613,42690,20738,21952,11202,12715,13649,5124
27614,31516,15034,16482,10207,6541,10499,4269
27615,42166,20112,22054,10269,10296,13238,8363
27616,42294,19935,22359,14145,14065,10772,3312
27617,15199,7123,8076,3545,6234,4083,1337
27701,21288,10840,10448,5295,8076,5490,2427
27703,41937,20148,21789,12609,13808,10825,4695
27704,34517,15927,18590,10376,10444,8537,5160
27705,46282,22697,23585,11201,17334,10209,7538
27707,45023,21161,23862,11743,16126,10687,6467
27709,1047,499,548,287,501,191,68
27712,20035,9596,10439,4926,3789,6641,4679
27713,46660,21657,25003,11259,18163,11725,5513
27801,21740,9843,11897,6140,5259,6092,4249
27803,21227,9902,11325,5812,4449,6434,4532
27804,29058,13712,15346,7557,7414,8130,5957
27805,3992,1876,2116,977,851,1251,913
27806,2331,1128,1203,520,427,709,675
27807,6629,3357,3272,1997,1769,1811,1052
27808,2225,1107,1118,435,347,721,722
27809,5091,2453,2638,1384,1078,1648,981
27810,4377,2119,2258,1017,815,1235,1310
27812,2593,1206,1387,631,498,813,651
27813,747,353,394,209,199,212,127
27814,1676,833,843,337,276,547,516
27816,2516,1240,1276,660,615,762,479
27817,7358,3625,3733,1745,1481,1998,2134
27818,1344,613,731,331,264,429,320
27819,330,164,166,94,71,81,84
27820,3088,1459,1629,808,620,941,719
27821,358,170,188,100,68,113,77
27822,8143,3924,4219,1968,1681,2585,1909
27823,8201,3845,4356,2205,1806,2411,1779
27824,1476,688,788,362,288,452,374
27825,103,48,55,19,16,28,40
27826,1379,1066,313,157,643,410,169
27827,33,14,19,5,7,13,8
27828,9071,4265,4806,2561,1973,2639,1898
27829,1930,954,976,469,345,589,527
27830,4755,2354,2401,1131,1036,1517,1071
27831,3908,1787,2121,987,800,1186,935
27832,2847,1364,1483,745,606,790,706
27834,52914,24585,28329,14765,18219,12774,7156
27837,5903,2935,2968,1745,1567,1713,878
27839,4001,2416,1585,649,1069,1426,857
27840,514,219,295,124,97,147,146
27841,84,38,46,16,14,31,23
27842,1493,734,759,177,142,449,725
27843,1157,574,583,253,213,376,315
27844,2950,1443,1507,838,684,839,589
27845,2394,1386,1008,369,635,715,675
27846,2988,1475,1513,768,601,921,698
27847,936,443,493,256,207,276,197
27849,1544,747,797,440,346,450,308
27850,7247,3520,3727,1321,1152,2207,2567
27851,5268,2632,2636,1394,1245,1557,1072
27852,2977,1456,1521,766,669,926,616
27853,673,335,338,178,129,220,146
27855,6456,3074,3382,1892,1543,1674,1347
27856,17141,8781,8360,4167,4102,5296,3576
27857,1298,638,660,269,217,401,411
27858,55781,26572,29209,15419,22353,10947,7062
27860,2246,1135,1111,587,446,628,585
27861,71,33,38,14,12,17,28
27862,877,416,461,190,160,272,255
27863,11735,5770,5965,3593,3159,3219,1764
27864,4779,2294,2485,1365,1074,1415,925
27865,1927,954,973,460,398,602,467
27866,855,419,436,199,181,253,222
27869,2258,1045,1213,509,393,666,690
27870,27236,12678,14558,7598,6213,7824,5601
27871,4619,2155,2464,1106,951,1390,1172
27872,375,183,192,61,66,136,112
27873,397,191,206,88,87,132,90
27874,4861,2260,2601,1145,961,1394,1361
27875,517,245,272,105,100,186,126
27876,1302,609,693,306,249,406,341
27878,1931,877,1054,552,502,556,321
27879,311,140,171,74,98,76,63
27880,3304,1701,1603,970,850,939,545
27881,61,29,32,13,5,29,14
27882,7413,3573,3840,1951,1640,2188,1634
27883,3565,1759,1806,910,781,1082,792
27884,1282,638,644,349,280,404,249
27885,984,475,509,183,189,322,290
27886,21591,10052,11539,5632,4965,6217,4777
27888,2560,1279,1281,781,660,729,390
27889,27468,13078,14390,7137,6465,7469,6397
27890,2521,1130,1391,718,552,659,592
27891,5227,2517,2710,1342,1125,1697,1063
27892,15182,7013,8169,3864,3148,4541,3629
27893,39723,18680,21043,11256,10156,10534,7777
27896,20130,9576,10554,5426,4716,5807,4181
27897,2265,1086,1179,611,509,590,555
27909,40699,19990,20709,10878,11154,10915,7752
27910,12007,5474,6533,3152,2656,3495,2704
27915,777,402,375,116,158,268,235
27916,747,356,391,187,142,264,154
27917,833,400,433,217,189,215,212
27919,1130,555,575,245,223,380,282
27920,1326,681,645,331,316,415,264
27921,4805,2422,2383,1367,1025,1540,873
27922,1030,454,576,252,213,299,266
27923,598,300,298,147,114,184,153
27924,3140,1489,1651,744,654,895,847
27925,4217,2342,1875,866,1160,1240,951
27926,1915,941,974,527,374,619,395
27927,542,276,266,28,129,166,219
27928,1986,1013,973,498,401,593,494
27929,1166,580,586,229,186,437,314
27932,12562,5918,6644,3062,2538,3508,3454
27935,1698,833,865,436,379,531,352
27936,1091,546,545,221,249,369,252
27937,4333,2125,2208,1226,934,1401,772
27938,1505,740,765,362,298,447,398
27939,2361,1198,1163,586,543,708,524
27941,536,277,259,100,104,194,138
27942,901,416,485,212,145,297,247
27943,504,257,247,84,133,177,110
27944,11909,5690,6219,2698,2321,3302,3588
27946,1207,569,638,274,250,384,299
27947,1230,606,624,281,283,418,248
27948,10862,5532,5330,2480,2985,3623,1774
27949,6947,3401,3546,1370,1110,2290,2177
27950,2006,999,1007,466,413,762,365
27953,1021,513,508,250,246,320,205
27954,6111,2995,3116,1466,1417,1849,1379
27956,340,182,158,94,89,96,61
27957,1356,655,701,265,270,422,399
27958,10144,5016,5128,3049,2296,3381,1418
27959,2789,1387,1402,501,639,947,702
27960,948,470,478,207,285,262,194
27962,7792,3555,4237,2116,1540,2217,1919
27964,545,254,291,112,120,158,155
27965,527,263,264,109,114,173,131
27966,1052,512,540,264,270,342,176
27967,366,162,204,82,67,126,91
27968,298,162,136,55,79,96,68
27970,3409,1636,1773,761,657,1045,946
27972,244,127,117,40,50,72,82
27973,1323,645,678,360,303,405,255
27974,1285,637,648,301,275,410,299
27976,3449,1731,1718,998,786,1091,574
27978,225,106,119,52,35,61,77
27979,1719,840,879,407,349,528,435
27980,2182,1090,1092,562,486,600,534
27981,1643,803,840,399,398,498,348
27982,82,44,38,16,21,29,16
27983,10416,5373,5043,2290,2693,3072,2361
27985,283,137,146,63,60,90,70
27986,2430,1803,627,270,903,909,348
28001,26760,12790,13970,6838,6284,7400,6238
28006,1130,542,588,261,254,344,271
28007,611,292,319,149,136,198,128
28009,1121,517,604,293,237,346,245
28012,20048,9864,10184,5186,5024,6120,3718
28016,13463,6611,6852,3739,3398,3861,2465
28017,695,257,438,365,330,0,0
28018,5562,2704,2858,1367,1160,1693,1342
28019,123,58,65,34,27,30,32
28020,2322,1175,1147,542,501,704,575
28021,13612,6673,6939,3385,3007,4128,3092
28023,14175,7069,7106,3633,3360,4295,2887
28025,49160,23814,25346,14227,12910,13551,8472
28027,55435,27064,28371,16841,15029,15384,8181
28031,24390,11923,12467,6017,7190,7288,3895
28032,3105,1398,1707,752,801,883,669
28033,2749,1358,1391,756,663,818,512
28034,16642,8235,8407,4430,4230,4862,3120
28036,14654,7088,7566,4433,3573,4135,2513
28037,18287,9100,9187,4690,3938,6055,3604
28039,116,55,61,36,26,31,23
28040,7969,3956,4013,2140,1882,2281,1666
28043,21055,9913,11142,5568,4738,5839,4910
28052,34932,16945,17987,9967,9224,9552,6189
28054,36270,16786,19484,9379,9584,9556,7751
28056,31418,15475,15943,8372,7258,10133,5655
28071,2802,1417,1385,728,587,926,561
28072,1357,651,706,376,367,388,226
28073,5621,2751,2870,1618,1405,1678,920
28075,16143,7913,8230,5211,3550,5191,2191
28076,722,359,363,209,185,174,154
28077,482,215,267,133,142,113,94
28078,52133,25626,26507,15946,14866,15514,5807
28079,31979,15568,16411,10564,8068,9079,4268
28080,7299,3662,3637,1942,1612,2456,1289
28081,25190,12246,12944,7226,6375,6812,4777
28083,23820,11419,12401,6589,6428,6121,4682
28086,25895,12517,13378,6720,5713,7825,5637
28088,2862,1397,1465,722,743,764,633
28089,248,128,120,84,111,29,24
28090,8342,4122,4220,2120,1831,2537,1854
28091,2158,1054,1104,552,446,641,519
28092,38570,19028,19542,9940,9406,11432,7792
28097,5369,2646,2723,1367,1252,1641,1109
28098,3579,1678,1901,931,1044,946,658
28101,698,339,359,164,177,217,140
28102,78,32,46,26,9,16,27
28103,10311,5037,5274,2876,2405,2965,2065
28104,28040,13737,14303,8918,5556,9333,4233
28105,39586,18888,20698,11069,9390,12231,6896
28107,6422,3252,3170,1632,1373,2076,1341
28108,54,29,25,10,17,17,10
28109,387,156,231,154,159,39,35
28110,50365,25132,25233,16173,13775,13393,7024
28112,26311,13045,13266,7617,6590,7153,4951
28114,7554,3706,3848,1977,1667,2253,1657
28115,34339,16823,17516,9954,8847,9754,5784
28117,35454,17759,17695,10706,7596,11709,5443
28119,2801,1341,1460,818,609,815,559
28120,19807,9610,10197,5177,5115,5906,3609
28124,6622,3417,3205,1707,1395,2196,1324
28125,2525,1287,1238,645,548,797,535
28127,7594,4208,3386,1615,1782,2394,1803
28128,7476,3732,3744,1879,1517,2244,1836
28129,5399,2725,2674,1330,1346,1506,1217
28133,2878,1450,1428,722,665,849,642
28134,9453,4399,5054,2419,2921,2499,1614
28135,6123,4051,2072,1049,2413,1822,839
28137,3120,1643,1477,823,794,892,611
28138,10495,5182,5313,2860,2502,3197,1936
28139,20111,9692,10419,4836,4029,6147,5099
28144,24734,12059,12675,6519,6506,6362,5347
28146,27614,13581,14033,6990,6358,8217,6049
28147,24697,12434,12263,6717,6679,6655,4646
28150,28098,13465,14633,7208,6102,8201,6587
28152,24735,11881,12854,6847,6113,6815,4960
28159,3108,1459,1649,889,725,868,626
28160,3929,1973,1956,949,1040,1071,869
28163,5233,2672,2561,1468,1227,1648,890
28164,14085,6925,7160,3620,3258,4453,2754
28166,8619,4314,4305,2252,2086,2648,1633
28167,2362,1207,1155,519,443,764,636
28168,10230,5094,5136,2657,2316,3205,2052
28169,173,89,84,40,44,56,33
28170,12355,5821,6534,3316,2793,3423,2823
28173,45097,22333,22764,16694,8315,14934,5154
28174,8608,4202,4406,3040,2390,2015,1163
28202,11195,6387,4808,1651,6896,1812,836
28203,11315,5463,5852,2186,4944,2921,1264
28204,4796,2266,2530,827,2291,1117,561
28205,43931,22131,21800,10996,16853,10993,5089
28206,11898,6081,5817,3368,3524,3575,1431
28207,9280,4288,4992,2558,2192,2613,1917
28208,34167,16286,17881,10824,9879,8980,4484
28209,20317,9801,10516,4053,8032,5109,3123
28210,42263,20240,22023,9537,13542,11055,8129
28211,28523,13656,14867,7400,7466,7941,5716
28212,38457,18553,19904,11735,13727,8851,4144
28213,37309,18394,18915,11191,14122,8545,3451
28214,34721,16830,17891,10657,10416,9404,4244
28215,53629,25458,28171,16937,15730,14349,6613
28216,47208,21890,25318,14518,14243,12180,6267
28217,24204,12092,12112,6865,9359,5375,2605
28226,37286,17699,19587,9223,9172,11178,7713
28227,49635,24108,25527,14430,12949,14308,7948
28244,0,0,0,0,0,0,0
28262,37547,18771,18776,10288,18165,6672,2422
28269,71048,34038,37010,21723,23802,18557,6966
28270,31525,14992,16533,9170,7656,9877,4822
28273,31478,15258,16220,8872,11770,8237,2599
28277,59664,28549,31115,17288,15866,18950,7560
28278,19283,9429,9854,5586,6228,5441,2028
28280,10,6,4,3,2,5,0
28282,0,0,0,0,0,0,0
28301,17165,7695,9470,4860,4640,4199,3466
28303,30909,14514,16395,8156,8971,7824,5958
28304,37147,17443,19704,10673,10763,9751,5960
28305,6073,2775,3298,1251,1502,1697,1623
28306,39683,18979,20704,12796,10945,10867,5075
28307,17631,9089,8542,7691,8937,953,50
28308,405,296,109,79,310,16,0
28310,3459,3179,280,541,2894,24,0
28311,34567,16608,17959,9966,10795,8937,4869
28312,18538,8901,9637,5071,4155,5718,3594
28314,54520,26144,28376,16315,20482,12212,5511
28315,11681,5568,6113,3154,3201,2992,2334
28318,4627,2304,2323,1186,1090,1383,968
28320,9229,4350,4879,2423,2082,2630,2094
28323,3182,1546,1636,965,860,889,468
28325,508,244,264,138,124,133,113
28326,17646,8619,9027,6664,5269,3861,1852
28327,15433,7518,7915,4110,3201,4374,3748
28328,27042,13047,13995,7433,6705,7303,5601
28330,346,175,171,97,89,90,70
28332,482,238,244,137,105,118,122
28333,11830,5780,6050,3595,3183,3100,1952
28334,24908,11952,12956,6798,5907,6844,5359
28337,10670,5144,5526,2707,2630,2964,2369
28338,4607,2309,2298,1287,1046,1289,985
28339,6751,3257,3494,1722,1602,1895,1532
28340,10765,5132,5633,2983,2381,3038,2363
28341,4257,2128,2129,1224,1037,1193,803
28342,298,140,158,134,57,62,45
28343,1685,808,877,513,361,508,303
28344,3415,1735,1680,1065,941,917,492
28345,12592,6013,6579,3574,3063,3265,2690
28347,1983,1349,634,461,908,436,178
28348,33307,15695,17612,11010,9302,9176,3819
28349,3724,1958,1766,878,872,1189,785
28350,305,154,151,96,69,79,61
28351,4759,2315,2444,1396,1133,1389,841
28352,25641,12389,13252,7131,6345,7031,5134
28356,5018,2486,2532,1391,1179,1639,809
28357,3125,1536,1589,884,852,908,481
28358,38738,18715,20023,11148,10258,10351,6981
28360,14263,7131,7132,4371,4020,3748,2124
28363,1202,577,625,325,270,354,253
28364,14809,7034,7775,4831,3866,3817,2295
28365,17144,8421,8723,4842,4575,4405,3322
28366,5061,2528,2533,1500,1326,1326,909
28367,87,40,47,23,15,26,23
28369,2652,1345,1307,759,638,716,539
28371,6519,3204,3315,2081,1851,1749,838
28372,14783,7110,7673,4885,4621,3143,2134
28373,2150,1049,1101,596,490,613,451
28374,15990,7465,8525,2681,2087,3514,7708
28375,102,47,55,19,16,32,35
28376,37991,18550,19441,12427,12684,8862,4018
28377,12666,6078,6588,4213,3363,3172,1918
28379,26388,12750,13638,7154,6225,7484,5525
28382,7056,3447,3609,1897,1608,2040,1511
28383,8080,3916,4164,2366,1913,2314,1487
28384,12097,6038,6059,3602,3269,3238,1988
28385,3029,1480,1549,836,692,846,655
28386,6319,3148,3171,2218,1896,1464,741
28387,13921,6334,7587,2927,2819,3444,4731
28390,19942,9921,10021,6064,7180,4504,2194
28391,5302,2623,2679,1421,1248,1634,999
28392,1579,763,816,390,346,454,389
28393,2005,1005,1000,575,476,572,382
28394,5164,2544,2620,1323,1212,1490,1139
28395,2375,1144,1231,625,525,693,532
28396,2732,1310,1422,743,565,771,653
28398,8112,3874,4238,2328,2007,2168,1609
28399,2140,1074,1066,616,528,583,413
28401,22094,10689,11405,4880,6912,6132,4170
28403,36063,17299,18764,8581,15152,6934,5396
28405,29152,14201,14951,6513,9072,7296,6271
28409,31296,15347,15949,7879,6588,9914,6915
28411,31962,15477,16485,8033,8717,8870,6342
28412,35573,16758,18815,8178,10483,9377,7535
28420,3886,1953,1933,1116,917,1079,774
28421,1521,724,797,371,281,497,372
28422,6641,3389,3252,1386,1409,1945,1901
28423,2290,1097,1193,637,481,675,497
28424,128,58,70,35,34,36,23
28425,10906,5604,5302,2779,2759,3112,2256
28428,6033,3062,2971,1092,1581,2039,1321
28429,8026,4155,3871,1944,2238,2496,1348
28430,1900,893,1007,501,455,537,407
28431,7102,3332,3770,1932,1598,1995,1577
28432,1968,939,1029,544,465,547,412
28433,5050,2395,2655,1347,1104,1535,1064
28434,1329,636,693,270,266,427,366
28435,2490,1246,1244,587,553,798,552
28436,2203,1064,1139,653,521,624,405
28438,1845,881,964,438,405,561,441
28439,1595,776,819,380,321,461,433
28441,3198,1577,1621,909,723,831,735
28442,1647,791,856,389,360,454,444
28443,17512,8640,8872,4385,3718,5139,4270
28444,2085,1018,1067,512,454,630,489
28445,5676,2905,2771,1149,1773,1524,1230
28447,1391,678,713,352,266,442,331
28448,1243,622,621,274,244,406,319
28449,1692,812,880,256,225,525,686
28450,2438,1172,1266,583,484,672,699
28451,27112,13305,13807,6970,7724,7195,5223
28452,694,327,367,198,161,217,118
28453,3829,1897,1932,1242,978,994,615
28454,2545,1272,1273,687,656,699,503
28455,2117,1037,1080,597,501,564,455
28456,3658,1737,1921,941,771,1096,850
28457,9905,4992,4913,2769,2634,2947,1555
28458,6444,3103,3341,1725,1501,1806,1412
28460,7652,3991,3661,1640,2416,1928,1668
28461,16126,7870,8256,2852,2734,4310,6230
28462,11680,5713,5967,2460,2237,3324,3659
28463,9799,5449,4350,2316,3131,2622,1730
28464,2457,1192,1265,744,653,643,417
28465,6531,3208,3323,955,1057,2092,2427
28466,10103,4844,5259,2530,2263,2711,2599
28467,8703,4175,4528,937,1020,2052,4694
28468,4375,2125,2250,433,448,1000,2494
28469,5839,2878,2961,963,892,1609,2375
28470,10644,5135,5509,2575,2399,2978,2692
28472,19658,9631,10027,5085,4703,5565,4305
28478,4588,2247,2341,1150,974,1386,1078
28479,4903,2427,2476,1140,1225,1366,1172
28480,2473,1312,1161,357,991,615,510
28501,20389,9354,11035,5642,4391,5695,4661
28504,21642,10498,11144,5375,4587,6387,5293
28508,2737,1401,1336,956,892,548,341
28510,1502,728,774,275,251,451,525
28511,694,359,335,124,119,234,217
28512,2896,1494,1402,325,507,840,1224
28513,10346,4836,5510,2808,2396,2837,2305
28515,2915,1716,1199,551,847,867,650
28516,11431,5583,5848,2259,2417,3590,3165
28518,7909,3846,4063,2187,2023,2101,1598
28519,404,186,218,85,90,132,97
28520,327,166,161,78,58,98,93
28521,2287,1133,1154,552,521,661,553
28523,2456,1216,1240,579,542,749,586
28524,426,197,229,82,90,121,133
28525,3132,1547,1585,855,790,881,606
28526,2489,1198,1291,566,529,784,610
28527,1140,585,555,268,264,376,232
28528,644,315,329,136,141,229,138
28529,2193,1095,1098,506,478,621,588
28530,7332,3528,3804,2073,1637,2130,1492
28531,1207,599,608,174,196,394,443
28532,23320,11381,11939,7605,8499,4757,2459
28533,2952,2732,220,442,2487,23,0
28537,137,67,70,30,26,23,58
28538,2175,1051,1124,583,546,646,400
28539,15469,7763,7706,4721,5648,3472,1628
28540,49252,24333,24919,14985,17516,10949,5802
28543,4699,2270,2429,2151,2437,102,9
28544,5368,2633,2735,1622,2471,883,392
28546,42696,20732,21964,12775,16695,8438,4788
28547,21884,18443,3441,6621,14753,488,22
28551,14093,6976,7117,3923,3469,4090,2611
28552,254,122,132,74,41,71,68
28553,454,241,213,66,91,146,151
28554,243,107,136,56,55,71,61
28555,5175,2558,2617,1345,1434,1498,898
28556,963,464,499,159,143,332,329
28557,14429,6839,7590,2889,3145,4207,4188
28560,28921,13901,15020,7215,6858,7762,7086
28562,36176,17145,19031,8681,8206,9412,9877
28570,21432,10769,10663,5286,5045,6767,4334
28571,2585,1275,1310,311,269,770,1235
28572,6531,3231,3300,1805,1613,1798,1315
28573,2176,1037,1139,501,417,640,618
28574,15102,7377,7725,4726,5097,3332,1947
28575,316,162,154,40,41,110,125
28577,522,262,260,57,68,115,282
28578,6363,3227,3136,2258,2026,1418,661
28579,622,296,326,122,97,236,167
28580,12657,7165,5492,2918,3778,3679,2282
28581,214,114,100,40,39,69,66
28582,1588,798,790,381,350,515,342
28583,281,137,144,76,56,73,76
28584,11396,5576,5820,2758,2572,3258,2808
28585,3942,1905,2037,950,801,1210,981
28586,8218,4371,3847,2173,2235,2369,1441
28587,369,167,202,96,78,97,98
28589,180,91,89,21,28,82,49
28590,23407,10966,12441,6956,7291,6277,2883
28594,3655,1859,1796,582,687,1058,1328
28601,50026,24124,25902,12977,12220,13928,10901
28602,28981,14356,14625,7770,7171,8557,5483
28604,6249,3158,3091,1299,1785,1708,1457
28605,3412,1686,1726,550,763,979,1120
28606,2158,1068,1090,549,479,597,533
28607,33059,16525,16534,8151,14515,5725,4668
28609,5864,2992,2872,1457,1215,1941,1251
28610,9913,4934,4979,2707,2394,3077,1735
28611,885,459,426,200,156,316,213
28612,12397,6194,6203,3251,2870,3772,2504
28613,22759,11067,11692,6221,5708,6318,4512
28615,1876,947,929,378,358,549,591
28616,493,240,253,137,118,126,112
28617,2261,1117,1144,523,534,642,562
28618,2352,1215,1137,560,572,749,471
28619,1520,705,815,335,355,402,428
28621,10472,5073,5399,2618,2330,2830,2694
28622,2527,1276,1251,547,607,700,673
28623,1653,840,813,398,376,478,401
28624,1639,795,844,343,294,534,468
28625,36189,17626,18563,9533,8522,10473,7661
28626,2714,1366,1348,607,701,821,585
28627,1152,594,558,285,227,309,331
28628,479,222,257,116,117,127,119
28629,75,35,40,18,13,23,21
28630,20041,9877,10164,5210,4858,6042,3931
28631,637,335,302,123,124,212,178
28634,5225,2645,2580,1439,1212,1526,1048
28635,3901,1951,1950,1054,896,1143,808
28636,5522,2745,2777,1523,1279,1654,1066
28637,1746,843,903,412,404,490,440
28638,12302,6053,6249,3113,2876,3685,2628
28640,4719,2279,2440,961,1041,1264,1453
28642,5745,2788,2957,1426,1254,1679,1386
28643,3521,1727,1794,757,714,1107,943
28644,1494,750,744,269,293,450,482
28645,47703,23426,24277,11847,10581,14173,11102
28646,342,167,175,83,61,98,100
28647,89,41,48,18,14,38,19
28649,993,487,506,221,205,341,226
28650,11883,5849,6034,3132,2914,3466,2371
28651,7132,3525,3607,1754,1620,2200,1558
28652,46,23,23,6,8,19,13
28654,3495,1725,1770,860,723,1057,855
28655,54996,27862,27134,14319,12674,15737,12266
28657,9488,4664,4824,2062,2005,2762,2659
28658,27022,13360,13662,7190,6680,7625,5527
28659,21134,10457,10677,5255,4936,6042,4901
28660,2249,1118,1131,621,559,631,438
28662,140,74,66,29,48,30,33
28663,614,302,312,122,113,196,183
28665,2571,1252,1319,626,559,773,613
28666,368,180,188,101,95,99,73
28667,559,277,282,145,144,162,108
28668,300,146,154,50,47,75,128
28669,3146,1590,1556,818,679,985,664
28670,2719,1355,1364,629,611,779,700
28671,597,254,343,104,118,156,219
28672,35,19,16,5,10,11,9
28673,5919,2946,2973,1362,1120,2077,1360
28675,6621,3245,3376,1491,1325,1913,1892
28676,3483,1693,1790,818,694,1023,948
28677,32940,15985,16955,8940,8142,9179,6679
28678,5226,2597,2629,1413,1278,1529,1006
28679,2064,1009,1055,448,505,608,503
28681,25910,13242,12668,6294,6228,7671,5717
28682,1129,554,575,206,196,395,332
28683,1697,819,878,393,335,538,431
28684,2141,1048,1093,492,424,670,555
28685,2076,1045,1031,513,436,613,514
28689,1712,893,819,410,338,588,376
28690,9295,4421,4874,2192,1894,2771,2438
28692,4067,2080,1987,863,1073,1171,960
28693,1700,872,828,392,343,482,483
28694,7744,3809,3935,1697,1632,2257,2158
28697,12930,6330,6600,3093,2750,3806,3281
28698,2256,1138,1118,488,562,656,550
28701,3635,1753,1882,883,844,1134,774
28702,366,175,191,63,57,120,126
28704,18821,9069,9752,4991,4628,5528,3674
28705,6715,3294,3421,1355,1379,2033,1948
28707,94,46,48,9,15,24,46
28708,754,385,369,187,165,235,167
28709,2225,1092,1133,496,434,752,543
28711,13209,6179,7030,2799,2895,3817,3698
28712,19347,9135,10212,3921,3776,4612,7038
28713,8686,4243,4443,1967,1795,2542,2382
28714,16753,8229,8524,3697,3463,4816,4777
28715,24582,12059,12523,6191,6024,7136,5231
28716,17477,8494,8983,4178,3866,4889,4544
28717,1729,881,848,299,342,472,616
28718,553,269,284,110,88,190,165
28719,8048,3921,4127,2696,2204,1969,1179
28720,114,58,56,20,18,30,46
28721,10063,4874,5189,2435,2207,2948,2473
28722,6371,2969,3402,1394,958,1742,2277
28723,11329,5793,5536,3199,5000,1666,1464
28725,43,20,23,9,11,16,7
28726,3203,1597,1606,944,872,776,611
28729,2894,1426,1468,571,469,742,1112
28730,9133,4424,4709,2190,1768,3093,2082
28731,7778,3824,3954,1653,1464,2014,2647
28732,16491,7973,8518,4152,3951,5019,3369
28733,21,11,10,0,5,6,10
28734,27040,13138,13902,5964,5502,7210,8364
28735,256,126,130,48,43,88,77
28736,787,416,371,148,156,213,270
28739,19786,9479,10307,3675,3500,5458,7153
28740,1364,691,673,288,243,449,384
28741,3197,1525,1672,501,442,903,1351
28742,2710,1339,1371,651,515,859,685
28743,2125,1042,1083,468,392,655,610
28745,551,241,310,70,57,117,307
28746,2388,1177,1211,353,329,673,1033
28747,2198,1132,1066,454,467,618,659
28748,11334,5614,5720,2828,2682,3442,2382
28749,50,24,26,1,3,9,37
28751,2916,1414,1502,458,430,882,1146
28752,30600,15310,15290,7444,7484,8745,6927
28753,11670,5791,5879,2693,2630,3574,2773
28754,7679,3771,3908,1890,1851,2028,1910
28756,4504,2239,2265,1113,1015,1364,1012
28757,280,139,141,28,32,53,167
28759,6922,3377,3545,1581,1296,2286,1759
28761,7816,3923,3893,1876,1708,2440,1792
28762,6857,3426,3431,1581,1474,2058,1744
28763,2725,1347,1378,636,488,800,801
28766,1262,623,639,307,295,376,284
28768,6813,3340,3473,1341,1143,2079,2250
28771,8558,4225,4333,2068,1799,2359,2332
28772,1239,606,633,298,218,357,366
28773,3378,1634,1744,677,588,963,1150
28774,1013,507,506,147,192,236,438
28775,296,147,149,51,51,93,101
28777,10638,6049,4589,2002,2844,3354,2438
28778,10381,4936,5445,2546,2912,2841,2082
28779,16111,7839,8272,3499,4106,4463,4043
28781,939,477,462,183,152,239,365
28782,6584,3140,3444,1208,965,1966,2445
28783,1593,860,733,390,343,477,383
28785,7338,3617,3721,1449,1398,2267,2224
28786,20714,9871,10843,4217,4290,5923,6284
28787,19718,9590,10128,4653,4171,6050,4844
28789,5097,2477,2620,1146,1127,1517,1307
28790,3205,1622,1583,785,739,939,742
28791,14171,6631,7540,2693,2399,3690,5389
28792,32689,15840,16849,8107,7712,8223,8647
28801,15019,7265,7754,2757,5631,3910,2721
28803,28693,13513,15180,6183,7290,7881,7339
28804,20507,10103,10404,4313,5471,5608,5115
28805,17620,8338,9282,3383,4095,5180,4962
28806,38550,18434,20116,9100,12647,9614,7189
28901,5354,2583,2771,1243,1010,1432,1669
28902,1373,679,694,289,264,424,396
28904,8533,4220,4313,1739,1554,2333,2907
28905,3129,1535,1594,759,637,862,871
28906,18475,8977,9498,3734,3376,5267,6098
28909,1030,500,530,230,196,302,302
56744,78,43,35,13,13,26,26
57638,246,134,112,53,29,89,75
57641,23,12,11,3,5,6,9
57642,36,20,16,15,5,13,3
57645,90,49,41,18,19,23,30
57648,15,8,7,3,3,3,6
57660,23,13,10,9,1,7,6
58001,55,24,31,21,10,16,8
58002,23,13,10,4,2,7,10
58004,266,140,126,70,46,85,65
58005,854,442,412,308,208,214,124
58006,427,206,221,125,62,134,106
58007,119,62,57,27,15,41,36
58008,229,116,113,50,41,85,53
58009,102,51,51,32,21,28,21
58011,391,198,193,95,64,130,102
58012,2474,1276,1198,828,569,711,366
58013,101,56,45,11,11,44,35
58015,291,155,136,80,55,113,43
58016,192,99,93,56,31,61,44
58017,313,173,140,59,40,130,84
58018,324,180,144,77,72,115,60
58021,447,226,221,142,117,126,62
58027,1391,700,691,328,247,412,404
58029,129,74,55,36,23,35,35
58030,649,327,322,174,120,208,147
58031,414,207,207,112,77,145,80
58032,722,380,342,173,130,202,217
58033,374,198,176,95,63,123,93
58035,262,142,120,50,43,102,67
58036,274,140,134,56,71,97,50
58038,332,178,154,85,61,119,67
58040,920,497,423,263,204,278,175
58041,1545,783,762,359,255,481,450
58042,1386,712,674,417,315,479,175
58043,167,93,74,36,29,45,57
58045,2230,1127,1103,609,476,641,504
58046,583,289,294,131,101,176,175
58047,3560,1815,1745,1201,748,1212,399
58048,418,218,200,105,81,142,90
58049,289,147,142,65,41,102,81
58051,1458,747,711,439,320,492,207
58052,581,303,278,136,110,173,162
58053,1171,591,580,281,177,350,363
58054,3128,1583,1545,766,571,953,838
58056,191,102,89,41,33,70,47
58057,147,85,62,27,28,53,39
58058,123,62,61,32,12,55,24
58059,1168,607,561,365,300,374,129
58060,1329,687,642,371,266,389,303
58061,413,217,196,115,84,148,66
58062,174,92,82,41,34,47,52
58063,340,185,155,98,61,111,70
58064,450,227,223,123,89,116,122
58065,22,12,10,0,0,8,14
58067,243,135,108,45,38,82,78
58068,321,170,151,83,57,99,82
58069,176,87,89,62,29,42,43
58071,409,221,188,105,87,133,84
58072,7997,3891,4106,1862,1864,2122,2149
58075,9276,4794,4482,2534,2524,2583,1635
58076,236,116,120,139,95,2,0
58077,787,416,371,242,160,259,126
58078,26321,13075,13246,7619,8677,6822,3203
58079,530,283,247,151,104,164,111
58081,845,455,390,238,139,273,195
58102,29850,15961,13889,6310,11732,7198,4610
58103,47302,23499,23803,10112,18783,11130,7277
58104,28322,13687,14635,7839,10271,6627,3585
58105,2483,1349,1134,1835,648,0,0
58201,34880,17239,17641,8248,11336,9060,6236
58202,1839,978,861,1261,578,0,0
58203,18229,9946,8283,4196,8851,3472,1710
58204,2107,1091,1016,930,993,179,5
58205,260,186,74,49,211,0,0
58210,322,149,173,58,50,120,94
58212,474,250,224,82,54,141,197
58214,367,191,176,74,68,158,67
58216,153,80,73,33,20,73,27
58218,700,361,339,197,146,227,130
58219,47,25,22,10,5,22,10
58220,2360,1164,1196,537,463,691,669
58222,295,150,145,76,56,82,81
58223,212,112,100,39,33,75,65
58224,41,19,22,11,8,14,8
58225,1054,573,481,216,215,345,278
58227,504,259,245,103,78,167,156
58228,880,464,416,199,211,317,153
58229,114,61,53,13,11,35,55
58230,663,333,330,162,112,196,193
58231,490,244,246,118,104,136,132
58233,283,150,133,66,54,96,67
58235,418,208,210,100,78,163,77
58237,5499,2714,2785,1415,1159,1592,1333
58238,167,80,87,24,31,54,58
58239,71,41,30,13,11,29,18
58240,1276,637,639,317,228,384,347
58241,126,71,55,23,26,41,36
58243,539,282,257,137,102,163,137
58244,194,109,85,43,25,84,42
58249,2574,1278,1296,570,440,755,809
58250,241,128,113,40,38,73,90
58251,2049,1026,1023,549,414,607,479
58254,513,255,258,100,73,159,181
58256,872,455,417,248,210,283,131
58257,2239,1099,1140,549,587,519,584
58258,290,150,140,63,71,113,43
58259,454,239,215,88,77,144,145
58260,173,92,81,25,21,60,67
58261,1112,581,531,304,192,371,245
58262,134,64,70,19,23,32,60
58265,519,267,252,152,107,147,113
58266,203,106,97,36,33,62,72
58267,1520,770,750,380,285,407,448
58269,207,104,103,33,23,60,91
58270,1950,991,959,450,327,563,610
58271,708,352,356,183,151,220,154
58272,312,160,152,73,60,94,85
58273,264,142,122,76,43,83,62
58274,953,476,477,226,173,296,258
58275,733,379,354,203,147,259,124
58276,503,264,239,115,85,175,128
58277,225,117,108,52,32,61,80
58278,1988,1036,952,590,445,670,283
58281,124,68,56,29,15,41,39
58282,1441,743,698,353,247,417,424
58301,9864,4859,5005,2519,2256,2776,2313
58311,60,34,26,14,6,21,19
58316,6486,3227,3259,2631,1640,1507,708
58317,226,121,105,37,32,76,81
58318,3684,1862,1822,826,666,1042,1150
58321,161,84,77,40,19,51,51
58323,47,27,20,12,2,17,16
58324,1345,651,694,301,176,426,442
58325,92,45,47,16,11,30,35
58327,390,222,168,118,77,132,63
58329,3313,1630,1683,1248,779,858,428
58330,341,175,166,49,50,99,143
58331,122,67,55,25,14,47,36
58332,320,173,147,57,30,100,133
58335,1694,851,843,831,488,276,99
58338,105,48,57,30,12,27,36
58339,47,22,25,7,5,17,18
58341,2597,1253,1344,543,385,734,935
58343,81,46,35,12,11,30,28
58344,958,482,476,190,145,278,345
58345,158,80,78,33,16,48,61
58346,650,333,317,140,100,201,209
58348,727,372,355,166,113,227,221
58351,478,247,231,97,83,168,130
58352,435,239,196,104,65,140,126
58353,140,73,67,34,24,54,28
58355,84,47,37,14,11,31,28
58356,1751,834,917,392,266,527,566
58357,364,185,179,142,66,91,65
58361,190,103,87,26,26,55,83
58362,82,44,38,14,11,41,16
58363,83,48,35,12,6,28,37
58365,304,162,142,59,53,109,83
58366,1080,540,540,278,182,323,297
58367,1707,810,897,504,383,453,367
58368,3801,1881,1920,879,689,1089,1144
58369,1231,626,605,412,285,350,184
58370,1280,629,651,566,306,277,131
58372,106,59,47,21,15,33,37
58374,640,311,329,174,116,197,153
58377,334,179,155,86,51,114,83
58379,360,180,180,156,96,76,32
58380,442,236,206,100,72,122,148
58381,317,174,143,106,71,72,68
58382,163,83,80,34,25,58,46
58384,549,303,246,112,75,211,151
58385,225,121,104,77,31,61,56
58386,134,75,59,26,17,50,41
58401,17142,8633,8509,4015,4088,4999,4040
58402,260,184,76,16,132,82,30
58405,427,200,227,89,336,1,1
58413,1150,563,587,193,149,291,517
58415,145,75,70,45,19,44,37
58416,440,232,208,73,53,136,178
58418,353,169,184,53,33,125,142
58420,314,168,146,88,67,124,35
58421,2850,1417,1433,712,512,844,782
58422,195,104,91,45,31,73,46
58423,78,48,30,10,10,23,35
58424,301,162,139,70,36,113,82
58425,1379,666,713,304,203,381,491
58426,200,107,93,51,33,68,48
58428,271,140,131,68,49,91,63
58429,357,192,165,90,69,109,89
58430,112,61,51,26,15,34,37
58431,132,73,59,22,23,39,48
58433,1092,556,536,262,150,350,330
58436,1965,968,997,500,470,452,543
58438,625,317,308,107,82,212,224
58439,148,76,72,35,19,41,53
58440,181,97,84,41,25,72,43
58441,389,202,187,107,74,109,99
58442,478,239,239,71,75,120,212
58443,200,104,96,34,40,59,67
58444,192,90,102,30,20,65,77
58445,160,87,73,50,35,44,31
58448,347,183,164,69,60,106,112
58451,185,86,99,38,30,61,56
58452,27,17,10,7,6,7,7
58454,360,191,169,77,50,118,115
58455,303,151,152,58,64,99,82
58456,523,247,276,112,73,145,193
58458,1397,703,694,362,269,379,387
58460,230,122,108,41,25,76,88
58461,413,222,191,77,59,146,131
58463,651,316,335,113,94,172,272
58464,242,118,124,50,33,58,101
58466,355,181,174,75,56,107,117
58467,606,297,309,159,89,189,169
58472,419,219,200,110,82,125,102
58474,2681,1335,1346,690,518,730,743
58475,150,76,74,18,27,46,59
58476,271,151,120,57,46,89,79
58477,148,77,71,27,25,43,53
58478,135,74,61,26,15,54,40
58479,192,102,90,39,30,80,43
58480,340,175,165,95,50,126,69
58481,272,143,129,60,49,92,71
58482,1003,480,523,276,194,289,244
58483,340,177,163,73,50,115,102
58484,65,38,27,7,6,23,29
58486,262,140,122,52,29,97,84
58487,444,238,206,110,88,138,108
58488,258,141,117,36,38,93,91
58490,240,130,110,44,39,84,73
58492,481,234,247,146,76,162,97
58494,350,187,163,90,55,97,108
58495,1332,644,688,292,216,348,476
58496,182,107,75,34,30,66,52
58497,326,177,149,99,61,99,67
58501,28055,13785,14270,6165,8381,7377,6132
58503,25734,12433,13301,7282,6439,7315,4698
58504,24342,12093,12249,6610,7090,6994,3648
58505,2,1,1,0,0,2,0
58520,264,138,126,59,41,103,61
58521,658,342,316,154,131,216,157
58523,3619,1869,1750,840,745,1273,761
58524,100,56,44,14,17,26,43
58528,798,385,413,367,220,156,55
58529,660,329,331,177,117,185,181
58530,1193,615,578,274,197,397,325
58531,307,168,139,41,30,127,109
58532,297,163,134,70,67,81,79
58533,945,447,498,171,121,255,398
58535,571,296,275,149,98,176,148
58538,2489,1279,1210,1023,696,561,209
58540,2449,1207,1242,520,398,693,838
58541,364,190,174,68,54,136,106
58542,324,173,151,92,55,76,101
58544,551,299,252,131,70,175,175
58545,3461,1773,1688,817,612,1236,796
58549,214,116,98,69,29,61,55
58552,1797,900,897,409,228,528,632
58554,22884,11379,11505,6085,6017,6551,4231
58558,812,429,383,212,174,275,151
58559,218,117,101,42,22,72,82
58560,161,88,73,33,26,69,33
58561,1085,546,539,266,171,277,371
58562,415,213,202,61,53,133,168
58563,1977,998,979,474,342,597,564
58564,92,52,40,15,8,35,34
58565,209,106,103,28,17,94,70
58566,180,94,86,50,41,56,33
58568,535,280,255,200,126,122,87
58569,77,41,36,10,19,28,20
58570,397,210,187,102,90,128,77
58571,603,314,289,120,92,218,173
58572,319,171,148,68,58,117,76
58573,674,330,344,143,73,194,264
58575,920,467,453,181,152,255,332
58576,953,471,482,192,176,287,298
58577,1671,855,816,370,319,588,394
58579,1190,625,565,261,222,387,320
58580,455,246,209,109,85,175,86
58581,258,130,128,66,31,90,71
58601,21078,10489,10589,5222,5951,5549,4356
58620,132,76,56,25,17,45,45
58621,1231,597,634,297,224,351,359
58622,1489,772,717,359,285,464,381
58623,2363,1171,1192,561,459,680,663
58625,185,94,91,39,21,64,61
58626,262,137,125,55,65,91,51
58627,154,90,64,30,26,58,40
58630,502,261,241,108,74,203,117
58631,1150,558,592,249,157,339,405
58632,149,71,78,35,20,55,39
58634,251,139,112,62,53,81,55
58636,706,379,327,191,152,177,186
58638,992,520,472,242,185,283,282
58639,1816,854,962,379,322,530,585
58640,1344,714,630,306,304,401,333
58641,79,43,36,12,7,37,23
58642,334,166,168,83,53,118,80
58643,191,100,91,49,42,54,46
58645,238,119,119,45,54,83,56
58646,1138,569,569,252,150,324,412
58647,1142,512,630,218,260,337,327
58649,307,156,151,59,50,91,107
58650,393,209,184,94,53,131,115
58651,475,244,231,102,100,155,118
58652,987,511,476,225,198,300,264
58653,556,294,262,119,94,169,174
58654,289,158,131,99,52,63,75
58655,484,259,225,131,107,152,94
58656,366,185,181,86,63,113,104
58701,28368,13995,14373,6791,8138,7397,6042
58702,0,0,0,0,0,0,0
58703,19396,9836,9560,5009,6450,4763,3174
58704,4770,2498,2272,2067,2396,303,4
58705,751,636,115,189,562,0,0
58707,509,221,288,242,250,17,0
58710,469,241,228,96,78,146,149
58711,211,110,101,61,31,66,53
58712,155,87,68,39,30,46,40
58713,35,17,18,7,6,12,10
58716,147,72,75,31,20,49,47
58718,1040,545,495,329,196,306,209
58721,529,290,239,126,93,165,145
58722,1516,766,750,473,357,483,203
58723,236,136,100,37,37,75,87
58725,341,179,162,96,67,97,81
58727,279,142,137,51,39,94,95
58730,1295,647,648,260,226,354,455
58731,300,151,149,78,69,85,68
58733,402,205,197,106,81,124,91
58734,241,131,110,44,36,83,78
58735,314,161,153,71,66,86,91
58736,452,242,210,96,74,132,150
58737,140,78,62,28,17,34,61
58740,755,389,366,199,204,218,134
58741,554,297,257,142,102,169,141
58744,143,85,58,23,15,61,44
58746,1620,833,787,392,296,482,450
58748,148,76,72,26,24,47,51
58750,528,282,246,145,120,162,101
58752,223,120,103,55,38,69,61
58755,129,65,64,24,25,39,41
58756,250,131,119,64,36,71,79
58757,909,443,466,380,250,214,65
58758,222,107,115,37,34,75,76
58759,821,427,394,242,192,235,152
58760,254,134,120,49,49,80,76
58761,1104,561,543,258,206,321,319
58762,246,132,114,53,65,61,67
58763,3502,1723,1779,1160,916,929,497
58765,248,135,113,35,49,82,82
58768,282,151,131,67,39,113,63
58769,229,132,97,39,54,77,59
58770,1240,649,591,369,301,362,208
58771,453,247,206,94,88,151,120
58772,137,76,61,28,29,47,33
58773,687,351,336,164,138,196,189
58775,290,148,142,107,61,73,49
58776,298,184,114,53,104,76,65
58778,133,71,62,25,16,41,51
58779,367,201,166,84,69,105,109
58781,695,364,331,211,144,215,125
58782,436,216,220,120,76,127,113
58783,346,196,150,74,55,122,95
58784,2330,1356,974,493,745,561,531
58785,1091,561,530,349,290,310,142
58787,136,83,53,19,22,40,55
58788,1124,575,549,248,205,331,340
58789,321,171,150,81,73,97,70
58790,1585,774,811,424,328,446,387
58792,227,126,101,39,29,90,69
58793,609,313,296,127,96,204,182
58794,159,90,69,50,28,38,43
58795,198,101,97,34,20,73,71
58801,18371,9435,8936,4829,4934,5159,3449
58830,213,114,99,38,25,83,67
58831,472,265,207,91,130,148,103
58833,80,43,37,6,9,31,34
58835,313,172,141,72,60,102,79
58838,199,119,80,41,50,60,48
58843,466,259,207,112,116,139,99
58844,142,77,65,29,23,44,46
58845,371,189,182,99,73,109,90
58847,283,157,126,75,68,79,61
58849,883,478,405,199,173,295,216
58852,1750,910,840,347,353,524,526
58853,292,148,144,97,69,67,59
58854,2804,1448,1356,735,607,824,638
58856,131,70,61,28,25,36,42
59221,417,218,199,101,71,139,106
59270,127,73,54,37,27,39,24
59275,54,28,26,8,4,22,20
43001,2400,1204,1196,665,417,829,489
43002,2262,1081,1181,299,1336,406,221
43003,2917,1455,1462,830,709,896,482
43004,22727,10880,11847,6845,7882,5847,2153
43005,174,81,93,65,44,42,23
43006,822,416,406,311,184,191,136
43008,2479,1214,1265,658,580,801,440
43009,2135,1079,1056,632,468,674,361
43010,272,141,131,91,65,68,48
43011,7491,3726,3765,2238,1597,2368,1288
43013,1201,602,599,334,261,384,222
43014,3632,1829,1803,1241,844,918,629
43015,48107,23467,24640,13786,13429,12993,7899
43016,31306,15575,15731,8831,9995,9115,3365
43017,37626,18702,18924,11678,8848,12248,4852
43019,8700,4322,4378,2590,1895,2528,1687
43021,10301,5155,5146,3303,1946,3522,1530
43022,4161,2025,2136,1259,1710,682,510
43023,13231,6458,6773,4140,2908,3853,2330
43025,5306,2591,2715,1270,1057,1741,1238
43026,54017,26542,27475,17240,15540,15573,5664
43028,7537,3788,3749,2059,1624,2136,1718
43029,664,316,348,253,136,175,100
43030,114,55,59,28,28,32,26
43031,12318,6076,6242,3386,2741,3818,2373
43032,77,43,34,14,16,32,15
43033,380,201,179,103,94,122,61
43035,24721,12323,12398,8939,7238,6733,1811
43036,258,133,125,69,63,93,33
43037,535,274,261,168,116,150,101
43040,31790,14399,17391,9089,9455,9050,4196
43044,5528,2851,2677,1564,1311,1659,994
43045,1953,969,984,582,451,601,319
43046,3396,1674,1722,756,668,1104,868
43050,29050,13872,15178,7469,6864,8096,6621
43054,20566,10003,10563,6477,5852,5995,2242
43055,59605,28756,30849,16010,14987,16386,12222
43056,17439,8560,8879,4635,3781,5250,3773
43060,2480,1256,1224,718,649,721,392
43061,3967,2066,1901,1021,807,1497,642
43062,27644,13676,13968,7985,6933,8187,4539
43064,12580,6178,6402,3812,2705,3821,2242
43065,38821,19171,19650,12753,8280,12737,5051
43066,1328,690,638,363,256,474,235
43067,1591,804,787,441,352,549,249
43068,51836,24638,27198,15242,14295,14366,7933
43070,133,74,59,41,32,30,30
43071,2351,1195,1156,660,473,745,473
43072,5948,2960,2988,1765,1334,1722,1127
43074,11655,5793,5862,3355,2493,3776,2031
43076,9051,4556,4495,2243,1840,2933,2035
43077,258,131,127,87,47,86,38
43078,20885,10105,10780,5558,4664,5969,4694
43080,5498,2730,2768,1634,1197,1619,1048
43081,55991,26675,29316,14482,16767,15271,9471
43082,29946,14675,15271,9266,5692,10104,4884
43084,841,434,407,257,181,246,157
43085,23258,11025,12233,5928,5960,6644,4726
43101,380,194,186,111,90,99,80
43102,4512,2324,2188,1335,990,1407,780
43103,10697,5287,5410,3181,2583,3173,1760
43105,8147,4018,4129,2175,1697,2630,1645
43106,1685,870,815,546,437,446,256
43107,3153,1587,1566,961,697,881,614
43109,118,56,62,34,26,37,21
43110,33847,15997,17850,10524,10234,8816,4273
43111,225,114,111,58,47,84,36
43112,4617,2273,2344,1202,867,1529,1019
43113,23717,11521,12196,6163,5355,6654,5545
43115,1321,656,665,366,316,411,228
43116,1448,697,751,544,411,355,138
43117,73,40,33,24,15,18,16
43119,27698,13511,14187,8692,8831,7407,2768
43123,58424,28401,30023,16392,15282,16852,9898
43125,12161,5837,6324,2967,3085,3660,2449
43126,326,167,159,70,77,114,65
43127,283,136,147,95,73,71,44
43128,2309,1171,1138,682,534,653,440
43130,59570,29810,29760,15215,15336,16279,12740
43135,4445,2174,2271,1255,967,1339,884
43136,460,209,251,119,107,136,98
43137,2388,1237,1151,640,529,773,446
43138,18437,8960,9477,5086,4360,5163,3828
43140,24066,14256,9810,5422,7074,7695,3875
43142,111,64,47,26,23,28,34
43143,5694,2828,2866,1448,1363,1780,1103
43144,477,238,239,127,122,134,94
43145,1918,961,957,488,376,649,405
43146,12369,7974,4395,2450,4343,3764,1812
43147,38440,18883,19557,12799,8566,11977,5098
43148,2220,1105,1115,655,527,667,371
43149,2552,1289,1263,607,464,869,612
43150,2482,1206,1276,780,569,767,366
43151,322,157,165,108,74,82,58
43152,921,464,457,240,191,281,209
43153,971,491,480,283,213,307,168
43154,3150,1595,1555,965,745,941,499
43155,2543,1297,1246,652,483,832,576
43156,242,114,128,72,50,81,39
43157,610,293,317,195,151,169,95
43158,268,136,132,65,61,97,45
43160,22305,10840,11465,5936,5339,6180,4850
43162,6926,3414,3512,1877,1495,2068,1486
43164,2203,1105,1098,685,518,684,316
43201,35495,20162,15333,4805,26350,3146,1194
43202,20251,10854,9397,2748,12579,3524,1400
43203,8108,3894,4214,2715,2076,2101,1216
43204,42104,20654,21450,11704,13279,11216,5905
43205,12272,6316,5956,3348,3578,3615,1731
43206,21864,10840,11024,5081,7900,5627,3256
43207,45144,21912,23232,12561,11753,12573,8257
43209,27228,12669,14559,7081,7209,7338,5600
43210,9432,4827,4605,6854,2524,41,13
43211,21600,10153,11447,7263,5523,5710,3104
43212,18551,9158,9393,2841,9235,4078,2397
43213,30444,14383,16061,7852,8600,8070,5922
43214,24650,11742,12908,4060,7572,7179,5839
43215,12790,7158,5632,1142,7102,2915,1631
43217,2602,1221,1381,1174,852,475,101
43219,27123,12425,14698,8308,8365,5989,4461
43220,24989,12209,12780,5054,8088,6429,5418
43221,31265,15071,16194,8002,8314,9486,5463
43222,4617,2335,2282,1475,1278,1216,648
43223,27366,13737,13629,7906,8078,7557,3825
43224,38699,18920,19779,10976,11284,10907,5532
43227,21340,9843,11497,6252,5164,6086,3838
43228,50737,24817,25920,14962,17451,11726,6598
43229,46347,22358,23989,12686,15222,11630,6809
43230,51161,24452,26709,13287,14992,14811,8071
43231,19685,9334,10351,5713,6240,5010,2722
43232,42201,19712,22489,13184,12463,10985,5569
43235,38493,18618,19875,8530,12649,10114,7200
43240,3469,1657,1812,875,1511,738,345
43302,54790,28984,25806,13371,14398,15894,11127
43310,3104,1547,1557,813,695,915,681
43311,19240,9410,9830,5460,4696,5437,3647
43314,3173,1579,1594,823,683,977,690
43315,7046,3509,3537,2033,1628,2146,1239
43316,6041,3028,3013,1705,1434,1727,1175
43317,168,74,94,41,39,43,45
43318,3864,1919,1945,1285,863,1041,675
43319,1040,526,514,270,207,350,213
43320,1588,786,802,421,363,478,326
43321,267,127,140,75,75,69,48
43322,374,203,171,105,82,113,74
43323,680,355,325,174,131,209,166
43324,2817,1394,1423,692,535,859,731
43326,13611,6610,7001,3781,3170,3680,2980
43330,118,71,47,31,40,31,16
43331,4485,2249,2236,923,834,1458,1270
43332,2323,1173,1150,684,525,688,426
43333,894,443,451,287,191,263,153
43334,6651,3342,3309,1840,1543,2100,1168
43336,39,19,20,8,13,13,5
43337,1108,556,552,307,228,360,213
43338,10489,5198,5291,2944,2343,2975,2227
43340,1721,874,847,580,381,434,326
43341,907,468,439,228,179,334,166
43342,3228,1629,1599,819,696,1030,683
43343,1505,775,730,468,343,456,238
43344,5677,2837,2840,1653,1300,1695,1029
43345,920,454,466,271,227,271,151
43347,1530,750,780,484,330,459,257
43348,1984,983,1001,514,446,526,498
43351,10436,5036,5400,2668,2313,2919,2536
43356,1103,554,549,256,239,363,245
43357,4763,2286,2477,1389,938,1318,1118
43358,2521,1258,1263,700,591,798,432
43359,819,425,394,227,202,238,152
43360,1593,812,781,431,345,560,257
43402,31327,15448,15879,6230,13343,6838,4916
43403,5004,2164,2840,3147,1855,2,0
43406,1777,883,894,502,432,542,301
43407,639,322,317,166,116,211,146
43408,269,123,146,81,73,64,51
43410,10403,5166,5237,2886,2419,3058,2040
43412,4362,2227,2135,1101,862,1496,903
43413,1407,690,717,420,326,430,231
43416,2891,1427,1464,744,560,849,738
43420,30579,14980,15599,8130,6979,8807,6663
43430,4783,2372,2411,1226,1039,1375,1143
43431,4752,2381,2371,1296,1120,1406,930
43432,1366,686,680,354,292,477,243
43433,95,46,49,26,23,27,19
43434,101,51,50,28,22,33,18
43435,1532,795,737,384,306,521,321
43437,427,214,213,131,97,129,70
43438,312,164,148,30,25,111,146
43439,113,50,63,27,29,39,18
43440,4875,2385,2490,775,670,1524,1906
43442,999,504,495,269,214,315,201
43443,1834,901,933,522,415,571,326
43445,1161,610,551,310,224,409,218
43446,25,10,15,4,0,8,13
43447,3450,1681,1769,868,722,1148,712
43449,8278,4081,4197,2147,1668,2658,1805
43450,3619,1776,1843,947,706,1128,838
43451,1119,580,539,285,261,354,219
43452,13811,6767,7044,2909,2611,4255,4036
43456,608,306,302,104,74,237,193
43457,1456,763,693,391,318,459,288
43458,414,213,201,124,89,133,68
43460,6289,3096,3193,1687,1531,1871,1200
43462,1163,609,554,332,275,354,202
43463,18,10,8,5,2,5,6
43464,1460,748,712,362,319,505,274
43465,5059,2402,2657,1162,1211,1400,1286
43466,2192,1092,1100,623,563,635,371
43467,106,47,59,36,27,28,15
43468,451,220,231,91,76,152,132
43469,3149,1555,1594,880,698,919,652
43501,788,412,376,197,161,272,158
43502,6933,3355,3578,1959,1477,1981,1516
43504,1094,550,544,269,206,388,231
43505,96,47,49,24,27,18,27
43506,14830,7153,7677,3740,3248,4354,3488
43511,940,479,461,258,208,286,188
43512,28674,14102,14572,7635,6802,8174,6063
43515,7979,3967,4012,2274,1816,2463,1426
43516,2951,1468,1483,873,680,803,595
43517,3744,1837,1907,1041,736,1141,826
43518,2726,1382,1344,753,616,805,552
43519,184,92,92,52,50,49,33
43521,2811,1390,1421,797,656,787,571
43522,3344,1680,1664,853,677,1155,659
43523,62,34,28,21,17,20,4
43524,1236,618,618,336,254,354,292
43525,1152,576,576,414,331,299,108
43526,6072,2987,3085,1777,1429,1643,1223
43527,2287,1126,1161,615,486,675,511
43528,16430,7952,8478,4256,3673,5058,3443
43529,256,130,126,87,63,74,32
43531,216,114,102,69,68,48,31
43532,4015,2047,1968,1223,871,1174,747
43533,1553,774,779,438,327,497,291
43534,1784,904,880,502,424,556,302
43535,757,384,373,203,179,198,177
43536,394,207,187,110,96,130,58
43537,27276,13269,14007,6800,6455,8114,5907
43540,1501,726,775,444,339,456,262
43541,144,67,77,47,27,42,28
43542,3591,1857,1734,1118,696,1212,565
43543,7771,3839,3932,2119,1794,2186,1672
43545,14034,6809,7225,3723,3217,4008,3086
43547,284,148,136,71,65,92,56
43548,700,359,341,202,143,223,132
43549,1460,743,717,437,331,406,286
43551,37002,18023,18979,9905,8989,11015,7093
43553,252,120,132,84,55,78,35
43554,2408,1207,1201,654,579,710,465
43555,200,109,91,45,54,59,42
43556,1860,917,943,542,430,512,376
43557,3393,1870,1523,835,946,968,644
43558,13579,6767,6812,3518,2760,4503,2798
43560,32226,15486,16740,9120,6460,9947,6699
43565,348,179,169,106,83,91,68
43566,7613,3691,3922,2036,1464,2426,1687
43567,13283,6509,6774,3858,2986,3902,2537
43569,2818,1437,1381,806,640,875,497
43570,3106,1536,1570,859,718,912,617
43571,6783,3331,3452,1921,1333,2274,1255
43604,10154,5211,4943,3031,3327,2648,1148
43605,28346,13804,14542,9454,8216,6936,3740
43606,26429,12626,13803,7966,7730,6041,4692
43607,23958,11574,12384,6372,7800,5598,4188
43608,16515,8447,8068,5283,4763,4408,2061
43609,23687,11692,11995,7723,6982,6209,2773
43610,5105,2460,2645,1591,1279,1426,809
43611,19207,9388,9819,5074,4895,5280,3958
43612,29674,14504,15170,8707,9044,7729,4194
43613,31635,15353,16282,8545,9120,8596,5374
43614,29290,13740,15550,6510,8136,7797,6847
43615,39441,18375,21066,9497,11757,10125,8062
43616,20873,10062,10811,5228,4555,6108,4982
43617,7500,3661,3839,1932,1376,2484,1708
43619,7499,3670,3829,2078,1787,2301,1333
43620,5858,2804,3054,1505,1509,1634,1210
43623,20149,9564,10585,4533,4814,5658,5144
43701,55643,26544,29099,14543,13051,15493,12556
43711,91,48,43,38,24,16,13
43713,7487,3613,3874,1886,1745,2068,1788
43716,1973,1025,948,436,421,605,511
43717,164,83,81,46,47,44,27
43718,3209,1576,1633,745,685,1044,735
43719,2601,1276,1325,666,568,833,534
43720,1300,647,653,328,253,477,242
43721,149,72,77,32,29,44,44
43722,420,208,212,95,87,135,103
43723,4984,2383,2601,1414,1170,1368,1032
43724,9201,5707,3494,1604,1572,2493,3532
43725,20357,9773,10584,5147,4633,5833,4744
43727,1473,762,711,397,325,473,278
43728,1250,607,643,368,263,357,262
43730,2503,1224,1279,720,593,702,488
43731,5461,2693,2768,1599,1283,1527,1052
43732,1703,868,835,411,371,539,382
43733,95,48,47,22,26,27,20
43734,1171,568,603,334,255,317,265
43735,499,245,254,178,107,129,85
43736,55,32,23,14,10,16,15
43738,164,80,84,54,44,43,23
43739,2025,1046,979,593,451,647,334
43740,256,122,134,60,45,91,60
43746,1425,723,702,391,338,426,270
43747,1083,535,548,311,253,285,234
43748,2755,1419,1336,835,672,791,457
43749,2339,1240,1099,537,499,736,567
43750,164,78,86,41,43,52,28
43754,1542,781,761,368,344,463,367
43755,1620,783,837,422,343,449,406
43756,5320,2533,2787,1233,1089,1521,1477
43758,3315,1699,1616,901,736,949,729
43759,66,30,36,11,20,16,19
43760,1831,948,883,565,395,554,317
43761,111,56,55,26,31,32,22
43762,5413,2590,2823,1370,1836,1206,1001
43764,8566,4214,4352,2446,2102,2459,1559
43766,1648,815,833,455,400,510,283
43767,1443,717,726,345,310,472,316
43768,275,144,131,66,71,64,74
43771,2007,1003,1004,570,471,576,390
43772,1879,953,926,532,412,562,373
43773,3248,1624,1624,1079,690,834,645
43777,4714,2355,2359,1377,1113,1344,880
43778,1526,761,765,499,347,427,253
43779,971,501,470,256,231,312,172
43780,2106,1078,1028,479,389,657,581
43782,849,443,406,254,211,259,125
43783,4704,2371,2333,1339,976,1419,970
43786,32,16,16,3,3,11,15
43787,2997,1538,1459,826,632,857,682
43788,865,435,430,268,183,257,157
43793,5110,2480,2630,1205,986,1390,1529
43802,1075,563,512,330,280,275,190
43804,3851,1900,1951,1604,979,750,518
43805,71,40,31,11,12,23,25
43811,829,412,417,204,179,254,192
43812,19061,9165,9896,4728,4245,5361,4727
43821,4327,2145,2182,1255,1000,1261,811
43822,4626,2284,2342,1298,1074,1421,833
43824,3787,1919,1868,1320,886,1000,581
43830,6158,3093,3065,1843,1428,1845,1042
43832,7479,3678,3801,1974,1614,2126,1765
43836,128,61,67,23,21,54,30
43837,1973,999,974,571,422,597,383
43840,1248,650,598,327,273,387,261
43842,355,189,166,118,88,80,69
43843,1123,580,543,357,270,327,169
43844,3869,2012,1857,974,819,1249,827
43845,4711,2289,2422,1152,1058,1362,1139
43901,2219,1067,1152,505,413,692,609
43902,202,110,92,41,47,62,52
43903,2208,1082,1126,532,465,682,529
43905,237,115,122,55,57,55,70
43906,8678,4232,4446,2070,1960,2653,1995
43907,6008,2928,3080,1375,1261,1854,1518
43908,1574,782,792,447,356,467,304
43910,3631,1824,1807,789,674,1210,958
43912,6801,3265,3536,1417,1453,2067,1864
43913,1490,708,782,344,313,452,381
43914,94,48,46,21,27,30,16
43915,1495,725,770,343,302,491,359
43917,3136,1540,1596,660,605,1039,832
43920,23438,11306,12132,5934,5219,6819,5466
43925,82,41,41,22,20,27,13
43926,285,131,154,87,86,68,44
43927,74,36,38,19,20,16,19
43928,116,61,55,33,20,42,21
43930,882,444,438,196,198,281,207
43931,272,133,139,52,40,91,89
43932,931,490,441,243,207,301,180
43933,2070,1052,1018,448,461,680,481
43934,295,148,147,73,67,84,71
43935,8943,4264,4679,2114,2045,2673,2111
43938,5794,2802,2992,1371,1233,1756,1434
43939,513,248,265,111,115,161,126
43940,377,183,194,93,99,100,85
43942,2500,1230,1270,562,575,736,627
43943,3472,1732,1740,757,737,1133,845
43944,2529,1267,1262,559,565,812,593
43945,3191,1605,1586,867,689,919,716
43946,2114,1044,1070,463,453,628,570
43947,5322,2493,2829,1095,1079,1628,1520
43948,670,325,345,170,137,169,194
43950,16762,9464,7298,3143,4773,4821,4025
43951,84,39,45,18,20,30,16
43952,19050,8894,10156,4827,5039,4919,4265
43953,11553,5418,6135,2417,2205,3372,3559
43961,294,138,156,64,48,91,91
43962,112,59,53,32,30,24,26
43963,1362,630,732,293,305,406,358
43964,9575,4661,4914,2155,2044,2964,2412
43967,21,13,8,7,4,9,1
43968,7182,3487,3695,1793,1582,2109,1698
43970,31,16,15,6,4,11,10
43971,1150,552,598,227,281,333,309
43972,144,77,67,23,29,62,30
43973,1996,1031,965,491,407,623,475
43974,107,57,50,31,27,30,19
43976,1632,817,815,407,308,446,471
43977,2407,1199,1208,579,547,720,561
43983,440,237,203,89,80,124,147
43985,128,61,67,44,32,26,26
43986,1975,1001,974,559,410,581,425
43988,2476,1240,1236,627,494,769,586
44001,20769,10152,10617,5188,3815,6852,4914
44003,4676,2283,2393,1158,904,1391,1223
44004,33421,16081,17340,8789,7454,9521,7657
44010,1667,809,858,350,301,548,468
44011,21193,10258,10935,6793,4451,6171,3778
44012,22581,10901,11680,6352,4238,7313,4678
44017,19161,9144,10017,4651,5501,5225,3784
44021,6444,3216,3228,1944,1372,1842,1286
44022,16516,7989,8527,4421,1966,5718,4411
44023,17351,8543,8808,4991,2420,6283,3657
44024,23557,11418,12139,6142,4212,7881,5322
44026,11116,5506,5610,2669,1657,3850,2940
44028,8467,4339,4128,2012,1515,3124,1816
44030,16652,8922,7730,3920,4294,4868,3570
44032,1557,799,758,407,324,542,284
44035,64263,30883,33380,16669,15991,18117,13486
44039,29563,14506,15057,7390,7061,8611,6501
44040,3020,1528,1492,620,393,992,1015
44041,14979,7448,7531,3717,3366,4614,3282
44044,15951,9985,5966,3080,4669,5505,2697
44045,422,220,202,101,99,134,88
44046,2222,1055,1167,685,435,617,485
44047,9213,4517,4696,2402,1891,2848,2072
44048,2565,1286,1279,661,443,800,661
44049,238,130,108,49,65,76,48
44050,6118,3022,3096,1610,1213,2139,1156
44052,29850,14188,15662,9007,7472,7896,5475
44053,18256,8567,9689,4453,4248,5080,4475
44054,12591,6242,6349,3091,3086,4043,2371
44055,19846,9524,10322,6526,4874,5182,3264
44056,11157,5409,5748,2720,2256,3745,2436
44057,19961,9841,10120,5225,4260,6297,4179
44060,60211,29097,31114,14127,12275,19769,14040
44062,14972,7368,7604,6329,3452,3047,2144
44064,1657,869,788,414,306,595,342
44065,4433,2163,2270,1049,775,1513,1096
44067,20441,9865,10576,4650,4234,6646,4911
44070,32902,15892,17010,7584,7482,9870,7966
44072,4383,2178,2205,956,612,1530,1285
44074,11679,5532,6147,3204,3464,2590,2421
44076,5141,2566,2575,1677,1265,1377,822
44077,56491,27973,28518,15653,13849,16337,10652
44080,226,123,103,53,50,80,43
44081,7088,3595,3493,2057,1324,2433,1274
44082,1619,830,789,495,351,444,329
44084,3611,1855,1756,903,820,1181,707
44085,3277,1715,1562,897,725,1068,587
44086,2391,1208,1183,595,482,840,474
44087,20221,9437,10784,5676,4151,6450,3944
44089,15899,7741,8158,3796,3040,5001,4062
44090,11504,5709,5795,2940,2380,3742,2442
44092,16835,8096,8739,3668,4028,4787,4352
44093,1467,750,717,431,299,431,306
44094,35234,16793,18441,7626,7745,10734,9129
44095,33579,16423,17156,7758,7969,10103,7749
44099,2314,1147,1167,923,547,589,255
44101,565,2,563,126,325,105,9
44102,45014,22354,22660,13747,13514,12060,5693
44103,18123,8984,9139,4912,4165,5425,3621
44104,22640,10090,12550,8337,5583,5326,3394
44105,40089,18792,21297,12141,9716,11159,7073
44106,26896,13068,13828,6131,10608,5310,4847
44107,52244,25672,26572,11291,18242,14344,8367
44108,25679,11534,14145,7625,5635,7126,5293
44109,40646,20007,20639,11612,11067,11841,6126
44110,20136,9165,10971,5767,4791,5896,3682
44111,39778,19482,20296,10479,11225,11919,6155
44112,23073,10393,12680,5928,5020,6470,5655
44113,19213,10977,8236,3606,8316,5194,2097
44114,5225,3048,2177,517,2086,1660,962
44115,8307,3833,4474,3330,3080,1370,527
44116,20268,9353,10915,4725,3787,5972,5784
44117,10224,4549,5675,2151,1932,3293,2848
44118,40438,18747,21691,11364,11609,9758,7707
44119,12482,5765,6717,3087,2774,4194,2427
44120,38196,17389,20807,10444,9114,11006,7632
44121,33220,15181,18039,9074,8515,9381,6250
44122,34057,15318,18739,8144,5869,9612,10432
44123,17637,8099,9538,4779,4392,5334,3132
44124,38282,17500,20782,7725,9061,10031,11465
44125,28730,13348,15382,7901,6871,8067,5891
44126,16771,8029,8742,3903,3994,5010,3864
44127,5586,2651,2935,1848,1517,1478,743
44128,29274,12934,16340,7829,6274,7734,7437
44129,29090,14102,14988,7005,7805,8160,6120
44130,50639,23927,26712,10366,11988,14396,13889
44131,20469,9933,10536,4350,3385,6569,6165
44132,14071,6273,7798,3917,3635,3893,2626
44133,30394,14833,15561,6748,7104,9990,6552
44134,38800,18554,20246,8826,9442,11250,9282
44135,26861,12832,14029,7079,6850,8001,4931
44136,25608,12520,13088,6328,5272,8255,5753
44137,23240,10751,12489,6523,5407,6994,4316
44138,22332,10622,11710,5889,4825,6725,4893
44139,24356,11866,12490,7302,3700,8661,4693
44140,15651,7433,8218,4244,2763,5051,3593
44141,13945,6954,6991,3435,2020,4960,3530
44142,19201,9217,9984,4525,4078,5739,4859
44143,24499,11360,13139,5172,4570,7478,7279
44144,21089,10248,10841,4723,5392,6408,4566
44145,32729,15519,17210,7631,6468,10167,8463
44146,29761,13755,16006,6608,6564,9064,7525
44147,19480,9373,10107,5183,4159,6220,3918
44149,19177,9263,9914,5023,3159,6391,4604
44201,6917,3475,3442,1771,1358,2338,1450
44202,19561,9436,10125,5192,3297,6332,4740
44203,41248,20017,21231,10388,9490,12040,9330
44212,43548,21409,22139,12126,10615,13152,7655
44214,2076,1065,1011,585,464,647,380
44215,2162,1121,1041,549,566,688,359
44216,9418,4716,4702,2453,1810,3108,2047
44217,4142,2054,2088,1128,924,1227,863
44221,29587,14087,15500,6540,9065,8094,5888
44223,18185,8489,9696,4436,3918,5485,4346
44224,38742,18652,20090,9595,9833,11561,7753
44230,8252,4071,4181,2152,1673,2559,1868
44231,8308,4116,4192,2310,1732,2669,1597
44233,7646,3851,3795,2001,1196,2770,1679
44234,4192,2105,2087,1046,1224,1174,748
44235,1825,925,900,652,370,513,290
44236,25296,12425,12871,8168,3697,8978,4453
44240,37927,18568,19359,8241,15185,8734,5767
44241,16428,7966,8462,4069,4726,4809,2824
44243,5658,2196,3462,3551,2103,4,0
44250,1253,609,644,313,339,375,226
44251,850,434,416,196,115,272,267
44253,3218,1658,1560,802,605,1207,604
44254,4833,2407,2426,1165,1005,1565,1098
44255,7987,3995,3992,1936,1798,2778,1475
44256,62039,30347,31692,17719,13299,19442,11579
44260,13450,6678,6772,3360,2736,4230,3124
44262,5016,2445,2571,1132,1078,1602,1204
44264,2315,1171,1144,456,411,894,554
44265,51,25,26,14,13,12,12
44266,33581,16568,17013,8244,8209,10331,6797
44270,8890,4389,4501,2300,2116,2506,1968
44272,5208,2563,2645,1389,1227,1593,999
44273,6718,3355,3363,1663,1363,2266,1426
44274,225,116,109,63,57,59,46
44275,3521,1785,1736,987,750,1147,637
44276,1906,978,928,552,450,537,367
44278,17868,8519,9349,4308,3423,5463,4674
44280,4557,2292,2265,1066,749,1702,1040
44281,29954,14582,15372,8384,6515,8860,6195
44285,85,47,38,24,18,31,12
44286,6109,3001,3108,1488,867,2224,1530
44287,7559,3834,3725,2286,1693,2267,1313
44288,4118,2000,2118,1202,993,1188,735
44301,15340,7403,7937,4342,4391,4014,2593
44302,5524,2799,2725,1313,1789,1668,754
44303,7700,3730,3970,1386,2165,2217,1932
44304,5916,3212,2704,2240,2967,468,241
44305,22294,10869,11425,6045,6204,6336,3709
44306,22492,10481,12011,7282,6125,5722,3363
44307,7643,3365,4278,2331,1862,1953,1497
44308,1392,957,435,253,415,553,171
44310,22786,11189,11597,5967,6731,6243,3845
44311,8782,4806,3976,2557,3766,1755,704
44312,31919,15513,16406,7389,7605,9688,7237
44313,24935,11721,13214,5325,7225,6461,5924
44314,18825,9206,9619,4979,5244,5341,3261
44319,22686,11191,11495,4925,4946,7006,5809
44320,19937,9159,10778,5389,4321,5740,4487
44321,15200,7418,7782,4272,3451,4636,2841
44333,18763,9066,9697,4345,3003,5990,5425
44401,2892,1493,1399,653,473,1005,761
44402,3352,1699,1653,876,634,1104,738
44403,3820,1881,1939,723,689,1219,1189
44404,1624,812,812,362,309,545,408
44405,8229,3900,4329,2160,1832,2113,2124
44406,22054,10788,11266,5493,3938,7297,5326
44408,10331,4949,5382,2347,2035,2925,3024
44410,17409,8413,8996,3990,3412,5486,4521
44411,2181,1098,1083,589,471,701,420
44412,2644,1345,1299,729,499,872,544
44413,7261,3606,3655,1764,1618,2203,1676
44417,1659,821,838,385,322,547,405
44418,1357,673,684,309,246,461,341
44420,15429,7388,8041,3735,3425,4631,3638
44423,2425,1218,1207,631,543,738,513
44425,14898,7260,7638,3307,3049,4651,3891
44427,1612,804,808,480,344,473,315
44428,3290,1628,1662,824,639,1034,793
44429,2576,1287,1289,551,556,832,637
44430,5270,3022,2248,1036,1819,1548,867
44431,4727,2384,2343,1247,1019,1531,930
44432,13693,8080,5613,2800,3840,4430,2623
44436,3836,1917,1919,890,705,1268,973
44437,4252,2099,2153,1097,897,1302,956
44438,4751,2346,2405,1142,1021,1401,1187
44439,115,58,57,39,40,22,14
44440,4967,2433,2534,1162,1068,1546,1191
44441,1600,823,777,357,366,535,342
44442,4006,1866,2140,962,804,1165,1075
44443,1704,837,867,384,363,549,408
44444,10454,5160,5294,2582,2240,3067,2565
44445,3449,1713,1736,941,774,1051,683
44446,20955,10014,10941,4833,4995,5994,5133
44449,1323,678,645,293,265,461,304
44450,2042,1045,997,610,465,594,373
44451,3032,1567,1465,647,607,1056,722
44452,3167,1489,1678,737,472,981,977
44454,1153,577,576,290,224,390,249
44455,1890,980,910,496,449,616,329
44460,26732,12964,13768,6410,5688,7859,6775
44470,3790,1910,1880,956,755,1212,867
44471,11097,5272,5825,2757,2502,3211,2627
44473,3823,1898,1925,756,727,1228,1112
44481,10408,5313,5095,2377,2179,3293,2559
44483,26006,12235,13771,6484,5841,7135,6546
44484,22991,10917,12074,5579,4753,6723,5936
44485,16498,7744,8754,4739,3971,4403,3385
44490,798,389,409,227,196,220,155
44491,3515,1798,1717,1241,865,866,543
44493,25,12,13,6,8,8,3
44502,10204,4819,5385,2983,2844,2469,1908
44503,1021,707,314,44,395,382,200
44504,5262,2423,2839,1345,1428,1130,1359
44505,19357,10346,9011,4298,5423,5350,4286
44506,2707,1315,1392,833,606,719,549
44507,5863,2805,3058,2014,1458,1472,919
44509,11975,5589,6386,3234,2951,3154,2636
44510,2499,1128,1371,802,610,589,498
44511,19672,9333,10339,4583,4129,5804,5156
44512,34424,16326,18098,7736,8031,10199,8458
44514,22472,10723,11749,4914,4077,7022,6459
44515,27766,13121,14645,6311,6728,7801,6926
44601,35294,17081,18213,9337,8650,9513,7794
44606,7819,3940,3879,3267,1911,1586,1055
44607,234,120,114,84,52,61,37
44608,2666,1335,1331,740,599,774,553
44609,3987,1958,2029,1024,783,1234,946
44610,263,129,134,54,73,75,61
44611,2025,1014,1011,613,433,562,417
44612,5293,2566,2727,1319,1126,1687,1161
44613,2011,986,1025,474,467,563,507
44614,12595,6142,6453,3353,2754,3778,2710
44615,11125,5507,5618,2840,2374,3277,2634
44618,6858,3432,3426,2098,1484,1862,1414
44620,1567,820,747,395,315,493,364
44621,4624,2298,2326,1256,1118,1367,883
44622,18588,8933,9655,4473,4015,5138,4962
44624,5397,2746,2651,2244,1401,1136,616
44625,1418,729,689,413,347,413,245
44626,2977,1496,1481,720,568,990,699
44627,6845,3462,3383,3235,1757,1165,688
44628,1067,550,517,303,237,316,211
44629,2403,1201,1202,692,522,665,524
44632,9765,4807,4958,2747,2010,2999,2009
44633,2615,1322,1293,932,672,562,449
44634,2164,1109,1055,543,436,741,444
44637,2694,1326,1368,786,608,783,517
44638,1497,756,741,444,347,440,266
44640,151,79,72,43,26,46,36
44641,20349,9789,10560,5246,4166,5951,4986
44643,3239,1631,1608,854,626,1011,748
44644,4791,2388,2403,1113,996,1526,1156
44645,2465,1273,1192,682,520,784,479
44646,47525,23104,24421,12473,10839,13726,10487
44647,18015,8914,9101,4212,4029,5390,4384
44651,861,447,414,279,193,259,130
44652,80,40,40,16,24,25,15
44653,599,295,304,195,171,150,83
44654,19679,9856,9823,7255,4851,4461,3112
44656,2968,1507,1461,770,630,927,641
44657,10334,5063,5271,2619,2172,3095,2448
44659,163,76,87,54,34,48,27
44661,171,86,85,59,56,30,26
44662,9656,4783,4873,2380,1878,2902,2496
44663,25362,12476,12886,6106,5975,7344,5937
44666,2928,1493,1435,822,509,1042,555
44667,13481,6688,6793,3780,3159,3819,2723
44669,1382,703,679,348,264,477,293
44670,235,113,122,70,44,59,62
44671,380,187,193,87,83,124,86
44672,4874,2241,2633,1136,992,1246,1500
44675,2082,1071,1011,501,399,661,521
44676,4877,2445,2432,1496,1074,1417,890
44677,2543,1246,1297,701,555,747,540
44678,152,74,78,29,21,67,35
44680,4138,2053,2085,1000,904,1235,999
44681,7799,3882,3917,2778,1975,1804,1242
44682,803,397,406,208,199,224,172
44683,8550,4154,4396,2393,2086,2346,1725
44685,27556,13537,14019,7859,5515,8591,5591
44687,249,69,180,2,7,7,233
44688,3053,1538,1515,812,650,948,643
44689,638,327,311,217,165,152,104
44690,166,72,94,37,46,44,39
44691,43753,21252,22501,11096,10705,12014,9938
44693,86,43,43,17,20,28,21
44695,1608,780,828,374,320,468,446
44697,187,96,91,24,32,67,64
44699,937,484,453,203,184,294,256
44702,1053,519,534,97,195,391,370
44703,8895,4385,4510,2646,2654,2468,1127
44704,3811,1784,2027,1155,854,1043,759
44705,18772,9169,9603,5430,4753,5244,3345
44706,18246,8943,9303,4941,4210,5328,3767
44707,9208,4400,4808,2780,2241,2525,1662
44708,25109,11836,13273,5675,5703,7105,6626
44709,18905,8784,10121,4334,5101,5059,4411
44710,9179,4295,4884,2518,2319,2399,1943
44714,9056,4229,4827,2084,2152,2510,2310
44718,11951,5698,6253,2614,2205,3833,3299
44720,39010,18779,20231,9497,8551,11534,9428
44721,13560,6567,6993,3557,3083,4067,2853
44730,6050,3005,3045,1387,1300,1942,1421
44802,1032,536,496,306,219,337,170
44804,1202,596,606,361,259,364,218
44805,32345,15531,16814,8680,8080,8314,7271
44807,2381,1197,1184,652,509,696,524
44809,293,158,135,72,76,90,55
44811,12867,6330,6537,3540,3099,3604,2624
44813,8051,3986,4065,2305,1605,2372,1769
44814,2929,1464,1465,778,547,962,642
44815,637,321,316,156,143,192,146
44816,42,21,21,3,7,15,17
44817,1562,772,790,487,342,476,257
44818,2644,1349,1295,739,600,788,517
44820,18102,8819,9283,4419,4032,5090,4561
44822,3240,1650,1590,1020,690,945,585
44824,4060,2010,2050,983,794,1331,952
44825,58,30,28,15,10,22,11
44826,1687,843,844,458,356,589,284
44827,7097,3493,3604,1992,1559,1989,1557
44828,166,79,87,46,54,25,41
44830,18962,9147,9815,5207,4312,5196,4247
44833,17121,8241,8880,4350,3662,4933,4176
44836,2654,1328,1326,709,594,798,553
44837,4514,2301,2213,1505,1065,1194,750
44838,266,141,125,65,54,84,63
44839,12519,6120,6399,2884,2399,3772,3464
44840,2900,1464,1436,826,641,900,533
44841,710,353,357,179,160,245,126
44842,5436,2659,2777,1419,1145,1604,1268
44843,2387,1191,1196,629,520,717,521
44844,764,391,373,197,183,229,155
44846,3301,1659,1642,899,568,1109,725
44847,3739,1890,1849,1026,854,1183,676
44849,2260,1134,1126,607,540,650,463
44850,148,84,64,34,32,41,41
44851,5308,2652,2656,1476,1186,1575,1071
44853,1397,709,688,388,293,430,286
44854,1749,863,886,450,383,506,410
44855,1271,648,623,379,290,373,229
44856,128,66,62,33,32,33,30
44857,23805,11535,12270,6699,5595,6673,4838
44859,1737,883,854,460,373,554,350
44861,64,30,34,23,18,15,8
44864,3204,1648,1556,799,650,1024,731
44865,3434,1713,1721,1056,822,889,667
44866,2259,1154,1105,750,521,627,361
44867,2351,1204,1147,646,562,734,409
44870,41030,19974,21056,10312,9584,11627,9507
44874,394,192,202,130,108,101,55
44875,13818,6714,7104,3735,2947,3876,3260
44878,3147,1610,1537,1082,685,884,496
44880,2864,1468,1396,860,613,888,503
44881,70,37,33,22,21,20,7
44882,2909,1453,1456,818,625,841,625
44883,29413,14655,14758,7700,7245,8031,6437
44887,1020,512,508,285,186,337,212
44889,6703,3409,3294,1751,1312,2236,1404
44890,11162,5462,5700,3256,2555,3136,2215
44901,2501,2500,1,60,1735,673,33
44902,5432,2801,2631,1542,1524,1519,847
44903,25602,12491,13111,6743,5380,7828,5651
44904,13906,6647,7259,3549,2699,4206,3452
44905,14513,8411,6102,3092,4487,4184,2750
44906,16718,7887,8831,3975,3600,4387,4756
44907,14313,6603,7710,3356,3376,3824,3757
45001,606,310,296,192,162,164,88
45002,13388,6724,6664,4092,3151,3980,2165
45003,697,347,350,184,163,209,141
45005,29963,14650,15313,7903,7279,8549,6232
45011,69677,34811,34866,22218,17917,20472,9070
45013,52613,25692,26921,13753,12469,15072,11319
45014,43917,21208,22709,11180,11782,12616,8339
45015,12038,5890,6148,3418,3402,3172,2046
45030,17921,8789,9132,4764,4243,5249,3665
45032,348,180,168,98,87,113,50
45033,276,132,144,88,70,70,48
45034,1184,603,581,375,217,403,189
45036,37504,20645,16859,10063,10677,10894,5870
45039,22814,11193,11621,6543,6314,6517,3440
45040,50627,24754,25873,17279,10741,16365,6242
45041,199,105,94,69,45,68,17
45042,26451,12939,13512,6461,6023,8055,5912
45044,52822,25416,27406,16743,13633,14405,8041
45050,8548,4149,4399,2387,2182,2271,1708
45051,177,0,177,0,0,0,177
45052,4004,2002,2002,993,744,1399,868
45053,3410,1744,1666,901,657,1189,663
45054,2471,1276,1195,650,499,895,427
45056,27038,13030,14008,7312,13064,3773,2889
45062,688,329,359,169,165,217,137
45064,2857,1461,1396,726,558,939,634
45065,4442,2145,2297,1370,1147,1246,679
45066,23839,11718,12121,7843,4847,7596,3553
45067,13898,6782,7116,4521,3811,3639,1927
45068,10479,5268,5211,2884,2081,3458,2056
45069,49060,24139,24921,14345,11080,15597,8038
45070,192,105,87,52,49,54,37
45101,2385,1123,1262,587,570,714,514
45102,22680,11247,11433,6701,6451,6414,3114
45103,31485,15515,15970,8909,8479,9145,4952
45106,12349,6106,6243,3515,2761,3624,2449
45107,9236,4522,4714,2535,2185,2732,1784
45111,376,195,181,89,64,151,72
45112,64,29,35,11,13,22,18
45113,3857,1945,1912,1130,792,1312,623
45115,78,39,39,17,22,17,22
45118,3614,1830,1784,989,773,1131,721
45120,3672,1811,1861,1070,824,1148,630
45121,9036,4508,4528,2342,2089,2526,2079
45122,11054,5571,5483,2990,2485,3537,2042
45123,8671,4267,4404,2508,2028,2369,1766
45130,3913,1972,1941,1082,929,1183,719
45131,238,118,120,55,51,71,61
45132,262,124,138,88,61,69,44
45133,23900,11628,12272,6416,5324,6633,5527
45135,4761,2373,2388,1512,1258,1251,740
45140,53267,26403,26864,16252,11551,17481,7983
45142,4444,2222,2222,1273,1054,1306,811
45144,4272,2111,2161,1133,943,1280,916
45145,40,21,19,19,9,9,3
45146,1580,819,761,483,358,478,261
45147,147,78,69,39,30,50,28
45148,1588,808,780,496,381,474,237
45150,31394,15090,16304,8414,6970,9207,6803
45152,11329,5632,5697,3328,2734,3374,1893
45153,1665,839,826,403,340,561,361
45154,9172,4492,4680,2747,2269,2575,1581
45155,366,188,178,111,95,84,76
45156,98,49,49,22,20,38,18
45157,9758,4958,4800,2789,2104,3105,1760
45158,370,176,194,123,93,99,55
45159,3392,1666,1726,970,805,1016,601
45160,699,311,388,162,157,203,177
45162,2519,1298,1221,643,529,884,463
45164,271,134,137,85,71,75,40
45166,98,55,43,30,22,27,19
45167,3764,1804,1960,895,739,1153,977
45168,1607,798,809,458,372,453,324
45169,4772,2375,2397,1242,1123,1438,969
45171,6054,3022,3032,1631,1403,1702,1318
45172,131,66,65,35,25,35,36
45174,2258,1134,1124,831,234,846,347
45176,9100,4551,4549,2436,2087,2883,1694
45177,22260,10801,11459,6010,5515,6228,4507
45202,15483,9156,6327,2437,6407,4688,1951
45203,2236,1014,1222,627,723,585,301
45204,6972,3530,3442,2249,2272,1673,778
45205,19389,9330,10059,6790,5628,4796,2175
45206,10745,5019,5726,2305,3495,2879,2066
45207,7974,3699,4275,3198,2202,1556,1018
45208,17614,8243,9371,3421,6321,4450,3422
45209,9605,4577,5028,1167,4782,2137,1519
45211,36111,17082,19029,9672,10629,9917,5893
45212,22253,11016,11237,5092,7959,5885,3317
45213,12013,5555,6458,2994,3240,3554,2225
45214,8738,4075,4663,2924,2493,2230,1091
45215,29623,14044,15579,8142,6856,8723,5902
45216,9570,4762,4808,2440,2544,2865,1721
45217,6566,3059,3507,1760,1593,2004,1209
45218,3846,1825,2021,997,964,1056,829
45219,16526,9129,7397,4399,8971,2109,1047
45220,15313,7906,7407,3512,7026,2759,2016
45223,12360,5838,6522,3855,3817,3200,1488
45224,19837,8924,10913,4796,4161,5830,5050
45225,9040,4034,5006,3530,2971,1772,767
45226,5476,2714,2762,993,2332,1338,813
45227,17486,8060,9426,4405,5113,5003,2965
45229,13020,6022,6998,3545,3127,3796,2552
45230,27536,13271,14265,7023,7094,8009,5410
45231,40893,19061,21832,11408,9654,11347,8484
45232,6358,2696,3662,2927,1844,1100,487
45233,15808,7718,8090,4439,2991,4842,3536
45236,24552,11610,12942,5201,6518,6990,5843
45237,20021,8979,11042,4956,4297,6065,4703
45238,45760,21832,23928,12435,12645,12371,8309
45239,28315,13412,14903,7906,7659,7749,5001
45240,27286,12720,14566,8276,6883,7489,4638
45241,23044,11168,11876,5196,4877,7166,5805
45242,22055,10602,11453,5827,3993,6959,5276
45243,14891,7149,7742,4101,2220,4908,3662
45244,28565,13980,14585,8752,5849,9297,4667
45245,18542,9099,9443,4456,4883,5511,3692
45246,15133,7138,7995,3773,4160,3563,3637
45247,22082,10757,11325,5332,4408,7070,5272
45248,24915,12030,12885,6557,5526,7300,5532
45249,12902,6306,6596,3293,3030,4118,2461
45251,22391,10800,11591,6485,5469,6402,4035
45252,4600,2248,2352,921,838,1620,1221
45255,21775,10405,11370,5756,4725,6482,4812
45301,130,63,67,36,34,36,24
45302,4280,2153,2127,1498,1029,1208,545
45303,2223,1114,1109,671,504,637,411
45304,7300,3639,3661,1981,1589,2053,1677
45305,10712,5197,5515,3199,2138,3539,1836
45306,2294,1159,1135,658,512,707,417
45307,338,165,173,96,87,94,61
45308,4682,2336,2346,1397,1035,1374,876
45309,12123,5897,6226,3013,2368,3626,3116
45310,244,129,115,62,73,50,59
45311,6367,3147,3220,1691,1411,1998,1267
45312,1435,729,706,373,275,456,331
45314,5916,2847,3069,1900,2287,1045,684
45315,4377,2079,2298,1155,847,1310,1065
45316,115,55,60,28,18,43,26
45317,1180,613,567,330,257,361,232
45318,5365,2682,2683,1467,1208,1436,1254
45319,293,147,146,91,62,98,42
45320,15691,7640,8051,4122,3613,4378,3578
45321,931,467,464,281,207,271,172
45322,21447,10176,11271,5530,4784,6196,4937
45323,5019,2460,2559,1159,1017,1479,1364
45324,40529,19705,20824,10232,14185,8991,7121
45325,2647,1309,1338,694,557,859,537
45326,1179,601,578,307,279,334,259
45327,8917,4374,4543,2381,1947,2749,1840
45328,525,258,267,186,127,135,77
45330,834,416,418,222,223,253,136
45331,22930,10996,11934,5639,4909,6409,5973
45332,612,317,295,169,136,175,132
45333,1345,697,648,396,308,407,234
45334,2037,1026,1011,609,466,549,413
45335,6939,3416,3523,1837,1599,2117,1386
45336,153,79,74,49,41,38,25
45337,1690,843,847,433,318,600,339
45338,5298,2675,2623,1448,1084,1580,1186
45339,1234,641,593,283,214,419,318
45340,830,409,421,224,167,268,171
45341,3883,1970,1913,911,809,1114,1049
45342,36784,17726,19058,9786,10183,9929,6886
45344,16955,8366,8589,4627,3765,4989,3574
45345,6144,3040,3104,1620,1344,1796,1384
45346,2293,1138,1155,673,509,670,441
45347,4324,2157,2167,1112,926,1343,943
45348,994,533,461,325,215,280,174
45349,427,210,217,147,102,115,63
45350,106,52,54,43,25,22,16
45351,274,144,130,85,63,57,69
45352,208,103,105,65,53,54,36
45353,196,100,96,57,54,56,29
45354,642,327,315,152,164,166,160
45356,25172,12224,12948,6663,6056,7134,5319
45358,356,169,187,111,68,105,72
45359,1970,961,1009,553,448,545,424
45360,335,173,162,94,85,108,48
45361,288,150,138,85,72,83,48
45362,1076,544,532,299,241,316,220
45363,1770,903,867,662,379,487,242
45365,30561,15102,15459,8830,7056,8695,5980
45368,4727,2314,2413,1259,1026,1424,1018
45369,3545,1761,1784,945,741,1169,690
45370,2452,1245,1207,577,381,920,574
45371,18333,9069,9264,4924,3444,5676,4289
45372,375,195,180,84,109,118,64
45373,35131,17236,17895,9430,8515,10022,7164
45377,15215,7447,7768,3764,3463,4492,3496
45378,407,214,193,122,99,123,63
45380,5477,2718,2759,1697,1117,1526,1137
45381,5509,2751,2758,1514,1138,1641,1216
45382,1269,639,630,362,311,388,208
45383,7037,3414,3623,1824,1516,2006,1691
45384,2001,973,1028,891,910,113,87
45385,37247,17922,19325,9522,8671,10693,8361
45387,5169,2440,2729,1122,884,1701,1462
45388,812,418,394,288,179,218,127
45389,521,256,265,141,121,133,126
45390,3461,1700,1761,994,727,981,759
45402,11420,5981,5439,2688,3354,3311,2067
45403,15006,7657,7349,4065,4541,4148,2252
45404,10833,5287,5546,3142,2848,2936,1907
45405,18948,8936,10012,5407,4796,5748,2997
45406,21914,10104,11810,6423,4986,6142,4363
45409,12868,6449,6419,3763,5865,1897,1343
45410,15339,7786,7553,3778,5079,4174,2308
45414,21055,10112,10943,5515,4848,5979,4713
45415,12631,6022,6609,2896,2463,3913,3359
45416,5740,2573,3167,1589,1164,1611,1376
45417,31281,14640,16641,9247,7225,8093,6716
45418,1351,655,696,398,367,395,191
45419,15159,7290,7869,4192,3671,4658,2638
45420,25438,12292,13146,5602,7665,7129,5042
45424,49930,24174,25756,13940,12792,14172,9026
45426,15239,6657,8582,3952,3380,4032,3875
45428,240,197,43,1,17,94,128
45429,25885,12221,13664,5591,5624,7477,7193
45430,7402,3621,3781,1848,1467,2382,1705
45431,26315,13034,13281,6789,8735,6282,4509
45432,15288,7535,7753,3622,3498,4641,3527
45433,2011,1106,905,640,983,358,30
45434,12163,6052,6111,3525,2201,3875,2562
45439,10000,4745,5255,2550,2775,2616,2059
45440,20734,10017,10717,4867,4962,5725,5180
45449,18175,8694,9481,4220,5259,4758,3938
45458,29880,14417,15463,7989,6074,9290,6527
45459,27749,12940,14809,5746,5342,7794,8867
45502,16110,8083,8027,3965,2941,5344,3860
45503,32999,15600,17399,8316,7535,8458,8690
45504,18465,8833,9632,4809,4932,4611,4113
45505,20197,9687,10510,5691,5092,5531,3883
45506,14055,6762,7293,4223,3378,3870,2584
45601,57842,31076,26766,13918,15307,17650,10967
45612,5303,2693,2610,1506,1202,1543,1052
45613,3597,1800,1797,1000,861,1023,713
45614,5080,2427,2653,1404,1164,1393,1119
45616,1559,774,785,393,355,504,307
45617,71,31,40,17,15,19,20
45618,30,19,11,13,7,7,3
45619,8200,4080,4120,2168,1990,2349,1693
45620,917,458,459,207,211,280,219
45621,313,156,157,79,92,88,54
45622,321,160,161,79,61,119,62
45623,3494,1740,1754,925,851,973,745
45624,31,17,14,0,1,19,11
45628,5211,2558,2653,1399,1158,1622,1032
45629,3438,1817,1621,1003,832,945,658
45630,118,55,63,21,20,44,33
45631,15048,7368,7680,3646,3476,4335,3591
45634,2112,1051,1061,606,532,579,395
45636,148,77,71,35,34,39,40
45638,21635,10439,11196,5505,5115,6083,4932
45640,15960,7762,8198,4245,3854,4525,3336
45642,33,14,19,6,14,6,7
45644,4249,2124,2125,1152,982,1326,789
45645,3036,1515,1521,842,723,920,551
45646,370,179,191,87,76,124,83
45647,2484,1270,1214,646,533,744,561
45648,13372,7391,5981,3169,3978,3788,2437
45650,435,227,208,84,85,161,105
45651,6047,2938,3109,1761,1436,1698,1152
45652,3519,1721,1798,935,853,1011,720
45653,4179,2018,2161,1085,993,1182,919
45654,917,483,434,252,192,283,190
45656,6639,3303,3336,1853,1642,1831,1313
45657,2744,1388,1356,772,718,760,494
45658,2787,1448,1339,951,626,728,482
45659,2973,1493,1480,881,751,833,508
45660,8297,4161,4136,2442,1925,2323,1607
45661,7657,3800,3857,2170,1903,2164,1420
45662,30219,14161,16058,7881,7911,7686,6741
45663,6762,3308,3454,1867,1669,1893,1333
45669,10399,5039,5360,2592,2329,3031,2447
45671,457,224,233,125,107,141,84
45672,1749,903,846,461,403,549,336
45673,385,189,196,106,87,98,94
45674,584,314,270,177,273,62,72
45678,1101,574,527,268,249,340,244
45679,2812,1390,1422,771,689,790,562
45680,13074,6229,6845,3378,3279,3580,2837
45681,1689,847,842,443,371,560,315
45682,2420,1231,1189,588,596,658,578
45684,1804,894,910,432,364,583,425
45685,1251,600,651,353,325,343,230
45686,3397,1687,1710,929,763,1044,661
45688,475,233,242,124,110,152,89
45690,14412,7053,7359,3865,3235,4064,3248
45692,8773,4228,4545,2396,2142,2500,1735
45693,8981,4354,4627,2477,2057,2467,1980
45694,12147,5905,6242,3122,2858,3400,2767
45695,674,352,322,151,126,205,192
45696,1438,724,714,399,317,457,265
45697,4894,2480,2414,1376,1128,1451,939
45698,341,170,171,78,78,99,86
45701,34122,17064,17058,8877,16644,5047,3554
45710,5541,2724,2817,1430,1295,1703,1113
45711,1115,562,553,299,250,337,229
45714,9951,4766,5185,2205,2205,2931,2610
45715,2630,1268,1362,709,562,738,621
45716,469,226,243,119,125,119,106
45719,1046,528,518,284,277,301,184
45721,29,20,9,5,6,11,7
45723,3740,1854,1886,860,792,1187,901
45724,1744,891,853,436,388,569,351
45727,516,266,250,124,105,178,109
45729,1289,661,628,308,245,451,285
45732,4776,2377,2399,1318,1126,1378,954
45734,549,295,254,132,111,166,140
45735,1730,881,849,430,409,542,349
45740,494,236,258,118,120,146,110
45741,918,454,464,236,213,295,174
45742,3014,1511,1503,742,625,991,656
45743,1449,737,712,353,336,448,312
45744,2728,1359,1369,692,538,846,652
45745,1140,575,565,268,243,380,249
45746,433,232,201,99,108,124,102
45750,27785,13339,14446,6413,6539,7876,6957
45760,3892,1847,2045,977,895,1071,949
45761,1745,879,866,434,445,532,334
45764,9431,5250,4181,2552,3009,2130,1740
45766,1382,681,701,342,334,437,269
45767,2800,1416,1384,633,612,813,742
45768,1703,829,874,405,375,530,393
45769,6642,3236,3406,1766,1500,1961,1415
45770,620,317,303,140,143,210,127
45771,3432,1685,1747,815,824,1029,764
45772,2149,1052,1097,534,491,617,507
45773,83,45,38,25,18,23,17
45775,1259,638,621,317,295,397,250
45776,765,392,373,183,189,235,158
45778,824,419,405,219,179,272,154
45779,755,367,388,184,162,191,218
45780,3254,1454,1800,745,867,865,777
45782,343,179,164,91,76,101,75
45784,3386,1705,1681,893,652,1160,681
45786,3253,1657,1596,936,717,916,684
45787,29,15,14,6,6,13,4
45788,1129,568,561,292,251,353,233
45789,177,99,78,43,43,56,35
45801,25303,14015,11288,6859,7672,6944,3828
45804,15758,7454,8304,4780,3771,4008,3199
45805,22514,11041,11473,6327,5286,5720,5181
45806,11158,5492,5666,2833,2297,3303,2725
45807,12221,6068,6153,3146,2492,3670,2913
45808,349,183,166,96,100,97,56
45809,157,79,78,44,29,56,28
45810,8460,4291,4169,2392,3427,1533,1108
45812,1943,947,996,514,437,566,426
45813,3530,1775,1755,940,779,1052,759
45814,2620,1275,1345,750,585,749,536
45816,291,148,143,80,81,81,49
45817,6736,3213,3523,1795,1648,1772,1521
45819,233,118,115,72,55,61,45
45820,543,250,293,166,125,154,98
45821,1435,718,717,405,275,456,299
45822,18943,9439,9504,4985,4122,5487,4349
45826,306,153,153,77,69,88,72
45827,2369,1239,1130,680,569,760,360
45828,6125,2993,3132,1850,1301,1731,1243
45830,6228,3115,3113,1860,1370,1791,1207
45831,3181,1599,1582,828,714,982,657
45832,2905,1429,1476,860,633,839,573
45833,10667,5289,5378,2945,2419,3050,2253
45835,490,254,236,107,97,153,133
45836,1479,752,727,434,330,439,276
45838,50,29,21,15,16,15,4
45840,54979,26493,28486,14449,14642,14908,10980
45841,929,478,451,254,188,326,161
45843,3701,1883,1818,1050,856,1105,690
45844,3256,1652,1604,961,713,1004,578
45845,3178,1591,1587,1048,704,886,540
45846,4437,2272,2165,1551,1015,1164,707
45849,1219,621,598,348,285,332,254
45850,3653,1854,1799,993,820,1160,680
45851,669,337,332,236,150,178,105
45853,1439,704,735,408,313,379,339
45854,498,240,258,161,129,136,72
45855,193,97,96,58,45,66,24
45856,5194,2592,2602,1640,1087,1474,993
45858,3083,1547,1536,949,692,918,524
45859,495,228,267,144,125,141,85
45860,2274,1168,1106,830,473,637,334
45861,296,143,153,93,71,85,47
45862,1507,761,746,372,346,465,324
45863,1254,623,631,365,275,387,227
45864,163,82,81,34,48,39,42
45865,4745,2401,2344,1435,899,1411,1000
45866,186,99,87,36,49,68,33
45867,1189,622,567,362,250,359,218
45868,567,287,280,143,126,180,118
45869,4534,2291,2243,1379,975,1386,794
45870,156,76,80,53,36,39,28
45871,1955,977,978,523,391,641,400
45872,4240,2079,2161,1232,1022,1182,804
45873,2238,1122,1116,617,526,610,485
45874,2100,1040,1060,553,426,641,480
45875,10989,5407,5582,3253,2412,3245,2079
45876,863,418,445,241,204,242,176
45877,2139,1089,1050,583,461,583,512
45879,6284,3007,3277,1716,1440,1792,1336
45880,2395,1188,1207,638,513,678,566
45881,1461,722,739,429,313,445,274
45882,3004,1466,1538,812,602,834,756
45883,3883,1999,1884,1321,851,1023,688
45884,145,74,71,43,35,43,24
45885,12661,6307,6354,3503,2811,3585,2762
45886,551,270,281,176,126,167,82
45887,4755,2392,2363,1376,1074,1325,980
45888,220,114,106,43,59,63,55
45889,1351,674,677,420,306,409,216
45890,671,321,350,182,151,206,132
45891,15275,7310,7965,4111,3401,4108,3655
45894,605,320,285,132,132,194,147
45895,17945,8842,9103,4841,4085,5298,3721
45896,2089,1037,1052,623,447,622,397
45897,101,46,55,23,21,35,22
45898,1314,668,646,374,275,403,262
45899,194,98,96,55,43,63,33
67950,146,74,72,50,29,46,21
73002,1062,534,528,283,229,328,222
73003,20617,9857,10760,6129,6592,5058,2838
73004,857,442,415,258,205,248,146
73005,9541,4573,4968,3099,2323,2354,1765
73006,3718,1875,1843,1028,782,1090,818
73007,2178,1101,1077,577,400,788,413
73008,19800,9611,10189,5294,5308,4884,4314
73009,1264,607,657,327,260,352,325
73010,17563,8774,8789,5187,4154,5241,2981
73011,416,226,190,103,88,132,93
73012,25851,12579,13272,8450,7397,7073,2931
73013,43933,21096,22837,12220,12564,11403,7746
73014,1431,707,724,383,294,439,315
73015,2877,1408,1469,797,606,751,723
73016,1850,916,934,592,422,563,273
73017,1780,886,894,516,383,521,360
73018,19936,9652,10284,5169,5414,5269,4084
73019,0,0,0,0,0,0,0
73020,20810,10368,10442,5728,4522,6511,4049
73021,352,177,175,84,58,117,93
73024,637,284,353,122,103,179,233
73025,11579,5837,5742,3878,2054,3930,1717
73026,10437,5347,5090,2644,1886,3720,2187
73027,1493,754,739,412,381,431,269
73028,3454,1696,1758,908,739,948,859
73029,1818,865,953,501,392,502,423
73030,4464,2176,2288,1220,1034,1183,1027
73032,222,107,115,61,49,65,47
73033,387,186,201,137,77,79,94
73034,39872,19594,20278,11265,10935,11102,6570
73036,18595,9863,8732,5065,5551,4762,3217
73038,2032,1028,1004,522,388,584,538
73040,1976,965,1011,632,417,507,420
73041,366,170,196,86,80,115,85
73042,1073,542,531,304,223,308,238
73043,125,65,60,20,12,49,44
73044,20226,9874,10352,5552,4905,5638,4131
73045,10378,5097,5281,2881,2357,3037,2103
73047,4774,3234,1540,897,1828,1340,709
73048,2020,968,1052,544,481,547,448
73049,5910,2983,2927,1647,1254,1859,1150
73050,1370,629,741,790,545,23,12
73051,10264,6606,3658,2211,3107,3184,1762
73052,6315,3134,3181,1723,1450,1660,1482
73053,745,360,385,223,163,205,154
73054,4189,2111,2078,1233,898,1282,776
73055,9942,4809,5133,2672,2112,2838,2320
73056,441,217,224,110,96,117,118
73057,2384,1144,1240,650,549,650,535
73058,332,184,148,68,53,117,94
73059,2924,1490,1434,829,601,860,634
73061,1596,806,790,502,387,444,263
73062,1396,681,715,325,265,400,406
73063,691,358,333,190,125,211,165
73064,20611,10060,10551,6112,5213,5938,3348
73065,6546,3226,3320,1878,1499,1932,1237
73066,417,208,209,85,89,161,82
73067,2161,1097,1064,584,444,648,485
73068,11707,5834,5873,3438,2867,3396,2006
73069,23912,12059,11853,5471,9854,5091,3496
73071,36711,18232,18479,9010,15755,7578,4368
73072,42797,21016,21781,12202,14523,9453,6619
73073,541,284,257,138,114,176,113
73074,1190,600,590,347,301,349,193
73075,9519,4625,4894,2503,2289,2654,2073
73077,7135,3476,3659,1883,1528,1981,1743
73078,7786,3920,3866,2594,1745,2411,1036
73079,643,325,318,192,151,175,125
73080,9276,4515,4761,2689,2242,2481,1864
73082,2980,1514,1466,806,652,819,703
73084,6518,3200,3318,1912,1313,1879,1414
73086,8345,4204,4141,2136,1846,2294,2069
73089,11522,5764,5758,3406,2649,3397,2070
73090,1198,729,469,290,341,395,172
73092,908,447,461,252,188,276,192
73093,2612,1318,1294,807,624,752,429
73095,1895,939,956,499,422,568,406
73096,13037,6493,6544,3504,5020,2622,1891
73097,187,95,92,49,36,52,50
73098,4227,2084,2143,1077,947,1151,1052
73099,57492,27846,29646,16814,15896,15506,9276
73102,3858,2910,948,281,2223,1068,286
73103,4315,2269,2046,703,1847,1206,559
73104,1664,832,832,504,656,343,161
73105,5210,2490,2720,1160,1366,1535,1149
73106,13581,7185,6396,3678,4940,3527,1436
73107,26561,13479,13082,7254,9032,6677,3598
73108,15350,8145,7205,5687,4942,3275,1446
73109,20594,10469,10125,6714,6028,4905,2947
73110,32666,15344,17322,9206,9908,7767,5785
73111,11781,5081,6700,3246,2595,2972,2968
73112,30943,14978,15965,6661,10295,8000,5987
73114,17422,8132,9290,6027,5587,3679,2129
73115,20541,9687,10854,5852,5541,5062,4086
73116,9241,4381,4860,1686,2570,2578,2407
73117,5191,2413,2778,1422,1228,1431,1110
73118,13571,6880,6691,2872,4901,3756,2042
73119,31347,15701,15646,11193,9497,6722,3935
73120,34824,16265,18559,7084,11633,8354,7753
73121,3053,1463,1590,661,509,942,941
73122,13164,6478,6686,3577,3676,3425,2486
73127,24077,11839,12238,7419,7195,5777,3686
73128,4200,2074,2126,1262,1164,1146,628
73129,20126,10398,9728,7006,5987,4860,2273
73130,19439,9293,10146,5326,4707,5472,3934
73131,3145,1694,1451,657,829,1090,569
73132,26432,12421,14011,7421,7576,6638,4797
73134,4312,1942,2370,795,1693,929,895
73135,20529,9834,10695,6630,6217,5007,2675
73139,17253,8370,8883,4573,5294,4021,3365
73141,2727,1339,1388,662,672,830,563
73142,10707,4951,5756,2574,3275,2959,1899
73145,2859,1782,1077,968,1769,115,7
73149,4643,2349,2294,1443,1411,1138,651
73150,4609,2351,2258,1111,871,1563,1064
73151,1446,707,739,472,184,539,251
73159,30350,14771,15579,8705,8899,7370,5376
73160,53666,26304,27362,16223,17819,12843,6781
73162,27758,13216,14542,6669,6583,8252,6254
73165,5809,2986,2823,1593,1275,1900,1041
73169,1782,925,857,511,460,527,284
73170,35343,17053,18290,9856,9247,10248,5992
73173,1299,649,650,391,358,383,167
73179,3082,1548,1534,943,855,905,379
73401,34927,16966,17961,9737,8547,9564,7079
73425,84,45,39,23,16,22,23
73430,1176,576,600,252,219,299,406
73432,974,493,481,249,232,253,240
73433,2761,1359,1402,745,563,775,678
73434,699,355,344,205,143,222,129
73437,107,59,48,28,23,28,28
73438,3708,1819,1889,1011,919,992,786
73439,7400,3680,3720,1591,1276,2064,2469
73440,398,206,192,99,79,101,119
73441,165,72,93,42,29,52,42
73442,428,217,211,107,88,130,103
73443,3585,1785,1800,1105,891,1025,564
73444,156,72,84,39,28,47,42
73446,8042,4051,3991,2424,1858,2093,1667
73447,1205,601,604,349,249,359,248
73448,5784,2787,2997,1614,1360,1549,1261
73449,2987,1477,1510,741,593,862,791
73450,1248,630,618,310,260,358,320
73453,661,342,319,161,159,178,163
73455,673,333,340,205,152,199,117
73456,2082,1035,1047,560,437,567,518
73458,952,474,478,270,219,264,199
73459,1132,584,548,300,255,316,261
73460,4747,2284,2463,1353,1158,1192,1044
73461,795,394,401,207,179,213,196
73463,3501,1718,1783,1012,802,900,787
73481,978,470,508,245,209,283,241
73487,232,121,111,64,41,72,55
73491,721,363,358,196,165,220,140
73501,20935,11919,9016,5116,7170,5583,3066
73503,10996,7011,3985,3950,6458,568,20
73505,49809,23896,25913,14652,15753,11731,7673
73507,22847,11360,11487,6336,6553,6399,3559
73520,149,71,78,37,34,39,39
73521,21636,10775,10861,6331,6218,5405,3682
73526,2133,1064,1069,576,482,618,457
73527,5184,2616,2568,1617,1255,1490,822
73528,680,339,341,197,145,194,144
73529,5344,2675,2669,1451,1168,1470,1255
73530,442,219,223,105,72,140,125
73531,401,200,201,98,82,123,98
73532,600,306,294,174,149,150,127
73533,28434,13818,14616,7442,6768,7639,6585
73537,643,321,322,190,102,161,190
73538,4675,2346,2329,1436,1113,1314,812
73539,218,105,113,47,50,59,62
73540,439,223,216,123,85,147,84
73541,3106,1506,1600,893,688,923,602
73542,4659,2342,2317,1287,1069,1243,1060
73543,1859,888,971,560,473,492,334
73544,268,137,131,70,62,87,49
73546,1232,599,633,345,265,331,291
73547,2319,1632,687,368,910,681,360
73548,519,253,266,108,74,146,191
73549,296,156,140,77,45,96,78
73550,2512,1189,1323,740,553,642,577
73551,65,34,31,21,12,21,11
73552,1612,840,772,464,346,494,308
73553,46,21,25,9,7,17,13
73554,3614,1748,1866,919,783,945,967
73555,214,109,105,55,46,62,51
73556,166,90,76,46,45,40,35
73557,427,218,209,68,99,157,103
73559,540,263,277,131,110,134,165
73560,829,407,422,282,174,219,154
73562,772,401,371,205,153,236,178
73564,551,285,266,101,92,186,172
73565,1092,536,556,306,208,267,311
73566,1674,825,849,470,347,451,406
73567,860,415,445,272,232,184,172
73568,1182,580,602,311,242,308,321
73569,537,266,271,148,99,152,138
73570,1128,564,564,311,215,316,286
73571,87,45,42,13,14,24,36
73572,3699,1797,1902,1052,816,1012,819
73573,2551,1298,1253,675,590,675,611
73601,10299,5043,5256,3140,2579,2469,2111
73620,1194,639,555,298,336,311,249
73622,266,138,128,60,63,72,71
73624,2142,1037,1105,758,625,505,254
73625,554,274,280,110,104,163,177
73626,1136,585,551,305,278,314,239
73627,628,322,306,197,141,173,117
73628,1583,782,801,462,334,402,385
73632,3433,1627,1806,933,771,868,861
73638,142,75,67,24,29,40,49
73639,602,300,302,135,113,192,162
73641,762,380,382,191,158,256,157
73642,187,102,85,36,36,52,63
73644,14147,7070,7077,4111,3850,3736,2450
73645,1538,776,762,412,330,430,366
73646,384,208,176,77,65,132,110
73647,519,265,254,130,114,144,131
73650,1020,499,521,304,258,268,190
73651,4268,2112,2156,1186,999,1172,911
73654,866,424,442,220,149,256,241
73655,864,441,423,177,145,281,261
73658,260,142,118,61,47,68,84
73659,160,88,72,29,22,57,52
73660,430,204,226,123,92,114,101
73661,420,204,216,120,84,105,111
73662,6093,3806,2287,1263,2182,1723,925
73663,1332,646,686,404,261,334,333
73664,1184,585,599,356,243,331,254
73666,180,91,89,51,35,45,49
73667,517,264,253,104,95,169,149
73669,1675,838,837,508,349,470,348
73673,319,170,149,70,68,79,102
73701,24808,12341,12467,7534,6938,6443,3893
73703,27951,13516,14435,6912,6879,7313,6847
73705,267,220,47,17,250,0,0
73716,510,271,239,110,100,151,149
73717,6846,3741,3105,1620,2370,1410,1446
73718,501,259,242,119,99,165,118
73719,83,44,39,23,12,21,27
73720,265,137,128,53,41,88,83
73722,427,211,216,112,75,121,119
73724,1190,581,609,365,267,281,277
73726,472,233,239,89,102,132,149
73727,267,131,136,75,50,82,60
73728,1861,928,933,449,383,526,503
73729,578,279,299,142,130,158,148
73730,734,373,361,195,152,206,181
73731,171,89,82,30,36,60,45
73733,221,127,94,59,44,69,49
73734,1067,544,523,326,226,318,197
73735,684,356,328,216,146,198,124
73736,356,175,181,76,76,111,93
73737,3367,1589,1778,825,710,956,876
73738,1134,571,563,297,238,317,282
73739,369,172,197,96,62,107,104
73741,1614,1309,305,155,410,773,276
73742,3824,1911,1913,1164,943,974,743
73743,122,63,59,38,30,36,18
73744,267,121,146,81,58,77,51
73746,37,19,18,8,11,13,5
73747,285,154,131,65,63,81,76
73749,448,224,224,89,58,120,181
73750,7025,3441,3584,1989,1604,1945,1487
73753,468,239,229,129,103,125,111
73754,1078,529,549,307,222,335,214
73755,905,482,423,185,159,298,263
73756,352,174,178,103,68,94,87
73757,178,83,95,35,42,42,59
73758,197,102,95,42,33,62,60
73759,1468,753,715,366,256,421,425
73760,470,222,248,128,100,134,108
73761,395,192,203,80,70,126,119
73762,2156,1087,1069,549,463,680,464
73763,1623,824,799,449,300,448,426
73764,144,74,70,33,30,47,34
73766,1096,531,565,309,218,341,228
73768,1568,797,771,480,318,437,333
73771,495,238,257,78,83,140,194
73772,6119,4033,2086,1187,2588,1448,896
73773,1744,856,888,444,398,516,386
73801,15228,7573,7655,4237,4014,4053,2924
73832,929,456,473,240,179,251,259
73834,1643,784,859,433,362,436,412
73835,309,152,157,83,59,88,79
73838,462,240,222,115,77,159,111
73840,691,359,332,186,129,211,165
73841,1482,1253,229,147,734,480,121
73842,494,240,254,116,86,172,120
73843,883,435,448,239,188,237,219
73844,269,138,131,67,48,80,74
73848,2156,1107,1049,599,480,602,475
73851,80,36,44,14,12,29,25
73852,2051,1028,1023,574,464,555,458
73853,379,188,191,99,83,88,109
73855,106,55,51,20,16,26,44
73857,623,314,309,186,134,171,132
73858,1666,783,883,439,340,412,475
73859,1459,726,733,410,302,386,361
73860,1337,672,665,333,262,388,354
73901,156,83,73,49,47,40,20
73931,510,265,245,145,123,124,118
73932,2092,1055,1037,588,409,564,531
73933,1697,831,866,463,324,428,482
73937,173,88,85,53,28,45,47
73938,781,396,385,248,148,243,142
73939,1695,945,750,506,743,277,169
73942,12953,6730,6223,4180,3894,3093,1786
73944,388,201,187,105,86,115,82
73945,2889,1487,1402,994,687,716,492
73946,45,22,23,6,4,13,22
73947,472,243,229,124,88,138,122
73949,1278,646,632,423,319,316,220
73950,1736,885,851,519,420,516,281
73951,1141,579,562,359,238,345,199
74001,367,188,179,97,72,113,85
74002,2333,1153,1180,663,434,667,569
74003,14249,6983,7266,3998,3653,3957,2641
74006,25750,12243,13507,6330,5537,6952,6931
74008,22461,11122,11339,6798,5731,6081,3851
74010,10501,5152,5349,2983,2320,2860,2338
74011,25448,12426,13022,7395,5966,7476,4611
74012,57526,27925,29601,17234,15450,16175,8667
74014,34579,17066,17513,10191,9180,9576,5632
74015,8064,3951,4113,2275,1935,2355,1499
74016,6005,3015,2990,1694,1350,1750,1211
74017,28057,13673,14384,7686,6893,7420,6058
74019,17648,8809,8839,5227,4068,5116,3237
74020,7294,3573,3721,1954,1542,2051,1747
74021,17359,8647,8712,5322,4300,4819,2918
74022,1760,889,871,398,326,551,485
74023,11741,6082,5659,3086,2904,3247,2504
74026,896,441,455,282,236,208,170
74027,1015,521,494,255,215,309,236
74028,1881,919,962,567,371,540,403
74029,5128,2495,2633,1380,1098,1344,1306
74030,3864,1867,1997,1085,874,964,941
74032,2219,1127,1092,643,516,654,406
74033,10163,4874,5289,3384,3069,2584,1126
74034,150,76,74,38,33,40,39
74035,4565,2805,1760,997,1419,1353,796
74036,6734,3347,3387,1965,1554,1941,1274
74037,15159,7360,7799,4750,3883,4095,2431
74038,2254,1143,1111,642,452,641,519
74039,3770,1904,1866,1105,859,1123,683
74041,2057,1030,1027,583,558,607,309
74042,540,284,256,176,114,143,107
74044,7406,3711,3695,2110,1623,2111,1562
74045,311,154,157,70,62,101,78
74046,115,67,48,28,20,40,27
74047,7163,3617,3546,2065,1611,2226,1261
74048,6092,2955,3137,1609,1298,1662,1523
74050,323,169,154,88,73,98,64
74051,1904,956,948,514,415,573,402
74052,1180,564,616,363,250,298,269
74053,4315,2151,2164,1406,1059,1210,640
74054,844,416,428,236,173,271,164
74055,38680,18934,19746,11957,9836,10986,5901
74056,5720,2846,2874,1524,1264,1571,1361
74058,4259,2093,2166,1186,916,1167,990
74059,5476,2688,2788,1600,1436,1436,1004
74060,586,286,300,171,115,151,149
74061,2095,1061,1034,551,430,618,496
74062,1123,557,566,323,257,340,203
74063,29808,14749,15059,8145,6787,8570,6306
74066,31060,15319,15741,8393,7625,8785,6257
74068,111,49,62,37,37,22,15
74070,13928,6877,7051,4163,3242,4031,2492
74071,180,98,82,49,34,66,31
74072,1816,906,910,469,390,517,440
74073,5118,2567,2551,1475,1132,1561,950
74074,29184,14709,14475,6983,12487,5820,3894
74075,23866,12103,11763,5494,11452,4109,2811
74078,2295,1202,1093,1478,817,0,0
74079,4504,2173,2331,1261,955,1254,1034
74080,2829,1443,1386,826,579,887,537
74081,1837,959,878,515,383,557,382
74082,107,62,45,30,27,30,20
74083,1031,526,505,255,185,347,244
74084,628,307,321,152,123,188,165
74085,2588,1289,1299,738,592,676,582
74103,2692,2218,474,176,1498,920,98
74104,12724,6526,6198,2974,5255,2984,1511
74105,26547,12712,13835,5830,7566,7599,5552
74106,17648,7940,9708,6040,4209,4198,3201
74107,19458,9307,10151,5958,5301,4916,3283
74108,7490,3706,3784,2423,2101,1845,1121
74110,14862,7350,7512,5289,4228,3544,1801
74112,20684,10092,10592,4955,6486,5551,3692
74114,15778,7502,8276,3413,4055,4705,3605
74115,22941,11404,11537,7827,6465,5530,3119
74116,3890,1989,1901,1310,1147,907,526
74117,87,40,47,19,26,21,21
74119,3561,1972,1589,238,1301,1221,801
74120,4940,2575,2365,1092,1747,1477,624
74126,10598,4896,5702,3598,2536,2753,1711
74127,17151,8259,8892,4896,4256,4721,3278
74128,12676,6289,6387,3841,3631,2964,2240
74129,18976,9333,9643,5735,5682,4291,3268
74130,2065,1042,1023,563,489,628,385
74131,2775,1426,1349,659,505,929,682
74132,7543,3710,3833,1967,1890,2126,1560
74133,43414,20741,22673,11259,12190,11843,8122
74134,15083,7623,7460,4927,4978,3727,1451
74135,20651,9681,10970,4394,5757,5413,5087
74136,30703,14640,16063,7240,10209,7175,6079
74137,25737,12385,13352,6895,5066,8170,5606
74145,17402,8408,8994,4332,5023,4300,3747
74146,15498,7843,7655,5417,5377,3088,1616
74301,11840,6099,5741,2845,2640,3524,2831
74330,2884,1448,1436,795,618,831,640
74331,7258,3631,3627,1498,1129,2104,2527
74332,1972,1004,968,536,403,551,482
74333,1221,593,628,350,244,343,284
74337,5060,2539,2521,1392,1121,1441,1106
74338,5480,2731,2749,1635,1322,1465,1058
74339,2606,1256,1350,790,563,644,609
74340,311,150,161,67,59,94,91
74342,2927,1541,1386,717,564,876,770
74343,3100,1520,1580,812,643,861,784
74344,14412,6805,7607,3083,2441,3720,5168
74346,7864,3954,3910,2243,1711,2207,1703
74347,2593,1285,1308,810,577,697,509
74349,318,160,158,70,69,111,68
74350,862,422,440,223,163,247,229
74352,6803,3473,3330,2024,1488,1937,1354
74354,18126,8737,9389,5161,4457,4428,4080
74358,270,143,127,85,61,72,52
74359,656,329,327,205,164,170,117
74360,31,18,13,4,4,9,14
74361,16293,7996,8297,4762,3969,4124,3438
74363,2892,1438,1454,824,609,830,629
74364,1750,902,848,496,427,472,355
74365,5110,2521,2589,1508,1177,1363,1062
74366,1474,744,730,352,288,448,386
74367,587,309,278,134,131,172,150
74368,117,54,63,50,29,21,17
74369,1803,898,905,478,379,497,449
74370,3537,1800,1737,927,728,994,888
74401,17476,8404,9072,5079,4290,4593,3514
74403,30709,14801,15908,8314,7919,7865,6611
74421,4607,2288,2319,1361,1007,1350,889
74422,824,425,399,198,158,258,210
74423,872,459,413,206,204,256,206
74425,1240,652,588,222,264,388,366
74426,9891,4833,5058,2424,1898,2720,2849
74427,1383,714,669,223,174,445,541
74428,882,440,442,245,179,239,219
74429,14445,7067,7378,4496,3720,3822,2407
74430,588,291,297,165,104,166,153
74431,918,463,455,283,202,224,209
74432,9730,4822,4908,2015,1711,2793,3211
74434,9067,4458,4609,2738,2029,2517,1783
74435,3185,1570,1615,790,650,922,823
74436,5078,2495,2583,1474,1210,1394,1000
74437,10448,5119,5329,2869,2339,2671,2569
74438,163,88,75,39,33,54,37
74441,5362,2748,2614,1480,1196,1544,1142
74442,920,465,455,238,194,252,236
74445,3226,1614,1612,989,779,855,603
74446,558,276,282,163,136,154,105
74447,17275,8604,8671,4687,4247,4465,3876
74450,1948,977,971,574,417,575,382
74451,4283,2119,2164,1080,874,1179,1150
74452,473,242,231,154,105,147,67
74454,3179,1574,1605,870,699,902,708
74455,3158,1584,1574,814,613,868,863
74456,247,119,128,77,54,71,45
74457,608,321,287,157,141,175,135
74458,147,74,73,43,32,32,40
74459,86,38,48,20,9,30,27
74460,283,127,156,74,57,103,49
74462,7875,3912,3963,2085,1634,2032,2124
74463,2033,1113,920,71,1083,768,111
74464,30111,14690,15421,8910,9395,6727,5079
74467,14995,7319,7676,4032,3390,4020,3553
74468,263,133,130,74,57,60,72
74469,2531,1287,1244,785,659,588,499
74470,1693,873,820,470,361,461,401
74471,1800,918,882,541,421,510,328
74472,554,288,266,169,138,147,100
74477,5,3,2,0,0,3,2
74501,29073,14898,14175,7081,7508,7919,6565
74521,217,110,107,49,46,61,61
74522,344,176,168,101,75,111,57
74523,6048,2968,3080,1581,1268,1628,1571
74525,10112,5331,4781,2690,2608,2637,2177
74528,174,89,85,43,34,48,49
74530,214,113,101,54,49,58,53
74531,1062,532,530,285,191,281,305
74533,849,420,429,245,172,231,201
74534,250,132,118,65,49,83,53
74535,126,59,67,36,33,43,14
74536,1760,846,914,464,352,512,432
74538,4200,2052,2148,1164,870,1096,1070
74540,172,87,85,35,38,48,51
74543,370,193,177,72,63,115,120
74546,824,404,420,240,174,234,176
74547,3463,1714,1749,939,789,917,818
74549,76,36,40,12,5,27,32
74552,1058,503,555,299,216,260,283
74553,1384,685,699,351,277,410,346
74554,1744,849,895,450,469,446,379
74555,861,431,430,228,188,237,208
74556,422,221,201,143,79,112,88
74557,464,244,220,95,62,139,168
74558,455,219,236,93,84,115,163
74560,635,315,320,152,135,193,155
74561,2175,1082,1093,574,497,582,522
74562,937,472,465,256,181,270,230
74563,2042,1043,999,537,442,554,509
74565,707,362,345,188,155,229,135
74567,242,121,121,56,45,64,77
74569,633,321,312,134,143,207,149
74570,1089,554,535,264,225,295,305
74571,3765,1895,1870,962,784,989,1030
74572,712,353,359,202,162,197,151
74574,1080,547,533,246,194,301,339
74576,210,109,101,48,44,44,74
74577,271,133,138,92,65,65,49
74578,6822,3412,3410,2010,1600,1779,1433
74601,20257,10050,10207,6101,5294,5144,3718
74604,12301,6010,6291,2858,2094,3537,3812
74630,702,362,340,139,136,226,201
74631,7709,3754,3955,2210,1698,1996,1805
74632,578,293,285,121,112,155,190
74633,471,247,224,116,101,147,107
74636,268,134,134,73,47,73,75
74637,1899,902,997,513,375,500,511
74640,312,151,161,71,60,106,75
74641,715,355,360,163,114,191,247
74643,615,306,309,179,113,189,134
74644,478,228,250,156,83,147,92
74646,233,126,107,52,28,87,66
74647,3765,1896,1869,1007,746,1095,917
74650,693,364,329,187,140,204,162
74651,743,363,380,232,188,197,126
74652,897,440,457,228,197,235,237
74653,3892,1951,1941,1311,920,933,728
74701,22365,10924,11441,6072,6791,5108,4394
74720,608,295,313,171,161,148,128
74722,286,139,147,92,65,70,59
74723,1729,871,858,466,334,484,445
74724,377,189,188,114,85,98,80
74726,2398,1211,1187,638,543,621,596
74727,2038,1019,1019,520,435,569,514
74728,11343,5566,5777,3375,2531,2996,2441
74729,2741,1360,1381,733,631,737,640
74730,4259,2035,2224,1233,1128,1028,870
74731,1747,844,903,403,350,529,465
74733,2853,1365,1488,719,636,795,703
74734,1087,545,542,277,224,333,253
74735,1549,770,779,362,287,448,452
74736,1178,591,587,342,272,309,255
74738,560,273,287,133,103,190,134
74740,2288,1144,1144,621,479,673,515
74741,972,485,487,231,197,289,255
74743,8537,4027,4510,2370,1907,2216,2044
74745,9912,4768,5144,2802,2414,2577,2119
74747,153,71,82,29,31,46,47
74748,642,341,301,190,134,146,172
74750,364,182,182,105,83,104,72
74753,52,25,27,10,11,19,12
74754,385,198,187,99,70,101,115
74755,83,46,37,14,17,20,32
74756,870,438,432,231,151,272,216
74759,1358,670,688,355,290,378,335
74760,295,140,155,83,63,82,67
74761,70,36,34,7,8,22,33
74764,3473,1701,1772,977,840,944,712
74766,1595,780,815,470,361,446,318
74801,21657,10431,11226,6393,5518,5634,4112
74804,19631,9340,10291,5355,5477,4623,4176
74820,30802,14859,15943,8400,8848,7486,6068
74824,1253,629,624,382,285,315,271
74825,2170,1094,1076,571,484,570,545
74826,1252,644,608,322,229,379,322
74827,387,189,198,86,58,119,124
74829,1521,1210,311,181,595,548,197
74830,229,114,115,73,37,63,56
74831,923,478,445,272,185,236,230
74832,936,457,479,266,195,258,217
74833,703,362,341,181,145,212,165
74834,7590,3770,3820,2149,1695,2129,1617
74836,171,84,87,36,35,54,46
74837,310,157,153,98,72,77,63
74839,770,375,395,203,169,215,183
74840,1924,977,947,527,413,570,414
74842,135,63,72,37,28,37,33
74843,340,165,175,87,73,105,75
74844,371,186,185,100,101,100,70
74845,494,257,237,157,112,123,102
74848,8326,4690,3636,2011,2398,2158,1759
74849,3132,1551,1581,896,671,849,716
74850,283,143,140,69,59,84,71
74851,9805,4388,5417,2528,2631,2965,1681
74852,1347,679,668,378,255,389,325
74854,1897,936,961,533,463,522,379
74855,4639,2254,2385,1219,970,1350,1100
74856,782,379,403,225,160,212,185
74857,9288,4769,4519,2511,2002,3146,1629
74859,6221,3074,3147,1777,1308,1614,1522
74860,1653,832,821,447,354,492,360
74864,5274,2600,2674,1486,1108,1517,1163
74865,1711,842,869,477,390,465,379
74867,1045,520,525,327,200,295,223
74868,13152,6362,6790,3837,3086,3416,2813
74869,710,357,353,172,138,230,170
74871,2415,1214,1201,635,506,671,603
74872,3692,1822,1870,1076,861,910,845
74873,11821,5841,5980,3635,2816,3135,2235
74875,1165,584,581,337,244,328,256
74878,1565,784,781,405,318,460,382
74880,2239,1111,1128,598,466,632,543
74881,4509,2283,2226,1267,942,1453,847
74883,2526,1274,1252,640,517,730,639
74884,6024,2947,3077,1655,1286,1695,1388
74901,1992,970,1022,469,466,558,499
74902,4095,1995,2100,1076,907,1202,910
74930,2155,1108,1047,619,467,629,440
74931,1411,729,682,390,330,407,284
74932,2286,1164,1122,635,521,676,454
74935,174,93,81,41,37,56,40
74936,1153,580,573,333,250,347,223
74937,5959,2985,2974,1932,1669,1327,1031
74939,1455,1097,358,150,541,518,246
74940,2697,1352,1345,783,632,792,490
74941,2713,1358,1355,785,641,697,590
74942,193,89,104,53,49,37,54
74943,112,57,55,27,23,30,32
74944,1272,646,626,381,327,319,245
74945,497,269,228,140,121,134,102
74946,137,69,68,38,33,39,27
74948,12788,6381,6407,3761,2976,3655,2396
74949,308,147,161,82,58,86,82
74951,1504,739,765,439,336,423,306
74953,11632,5677,5955,3318,2963,2877,2474
74954,4590,2208,2382,1389,1113,1218,870
74955,15344,7604,7740,4343,3612,4112,3277
74956,1905,963,942,554,447,513,391
74957,1170,583,587,305,240,308,317
74959,6736,3270,3466,1793,1448,1849,1646
74960,13643,6765,6878,4264,3410,3515,2454
74962,5092,2525,2567,1349,1020,1392,1331
74963,608,313,295,151,125,186,146
74964,2834,1433,1401,789,593,933,519
74965,5170,2597,2573,1638,1201,1362,969
74966,3719,1882,1837,1010,839,1012,858
89421,93,50,43,17,12,25,39
97001,229,117,112,64,69,40,56
97002,5623,2938,2685,1367,1153,1766,1337
97004,4388,2209,2179,1019,806,1622,941
97005,24906,12407,12499,6478,8736,6005,3687
97006,63036,31098,31938,17673,22699,15422,7242
97007,66954,32779,34175,19196,19229,19749,8780
97008,28969,13959,15010,7258,8126,8013,5572
97009,7762,3921,3841,1795,1416,2582,1969
97011,582,309,273,120,129,196,137
97013,22688,11067,11621,6641,5071,6284,4692
97014,1288,658,630,304,338,422,224
97015,19521,9475,10046,5389,5500,5508,3124
97016,6083,3075,3008,1510,1135,1905,1533
97017,2922,1478,1444,762,538,1024,598
97018,1952,952,1000,399,356,650,547
97019,3161,1554,1607,800,557,1126,678
97020,791,398,393,210,205,252,124
97021,1089,544,545,282,207,294,306
97022,3722,1890,1832,943,707,1286,786
97023,9832,5074,4758,2477,2115,3141,2099
97024,10242,4964,5278,2671,2971,2830,1770
97026,3815,1988,1827,1374,1102,932,407
97027,12131,5897,6234,3123,3020,3613,2375
97028,217,126,91,35,64,77,41
97029,285,133,152,59,55,84,87
97030,36693,17620,19073,10106,11289,8867,6431
97031,18375,9121,9254,5267,4476,5427,3205
97032,5043,2511,2532,1682,1370,1310,681
97033,60,29,31,13,9,15,23
97034,18905,8951,9954,4668,2581,6497,5159
97035,23912,11410,12502,5511,5324,7968,5109
97037,849,443,406,152,116,288,293
97038,15113,7582,7531,4576,3891,4102,2544
97039,472,238,234,98,101,127,146
97040,1244,622,622,266,242,444,292
97041,2817,1459,1358,826,637,829,525
97042,2923,1509,1414,708,545,1045,625
97045,51359,25506,25853,13564,12115,15646,10034
97048,6691,3367,3324,1621,1282,2164,1624
97049,1899,1005,894,372,427,695,405
97050,272,142,130,55,50,77,90
97051,15957,7996,7961,4658,4216,4456,2627
97053,3247,1649,1598,720,483,1178,866
97054,1579,831,748,382,287,580,330
97055,17350,8627,8723,4783,4217,5174,3176
97056,11497,5689,5808,2857,2574,3636,2430
97057,36,21,15,7,6,8,15
97058,19838,9772,10066,5264,4615,5239,4720
97060,21226,10522,10704,6573,5920,5982,2751
97062,27434,13483,13951,7994,7740,8283,3417
97063,1074,548,526,149,118,318,489
97064,3464,1754,1710,953,690,1124,697
97065,676,354,322,156,127,215,178
97067,2138,1126,1012,400,439,686,613
97068,28305,13839,14466,7932,5211,9811,5351
97070,20957,9777,11180,5035,6373,5672,3877
97071,28803,14649,14154,9763,7645,5887,5508
97080,40888,20046,20842,11884,10549,11904,6551
97086,26010,12877,13133,7487,6758,7689,4076
97089,11986,6058,5928,3206,2272,3920,2588
97101,3794,1901,1893,1080,867,1104,743
97102,205,102,103,25,16,55,109
97103,16859,8390,8469,3998,4002,4990,3869
97106,4550,2354,2196,1417,968,1468,697
97107,1530,789,741,326,305,440,459
97108,490,244,246,110,72,178,130
97109,577,307,270,181,105,189,102
97110,1284,590,694,304,332,304,344
97111,3156,1614,1542,893,661,1026,576
97112,1901,981,920,431,331,577,562
97113,14155,7220,6935,4861,3915,3635,1744
97114,4762,2366,2396,1487,1080,1292,903
97115,4139,2076,2063,1194,938,1262,745
97116,24104,11638,12466,7227,6496,6120,4261
97117,679,359,320,160,130,222,167
97118,775,392,383,108,98,261,308
97119,4420,2264,2156,1123,842,1604,851
97121,1383,682,701,388,347,353,295
97122,460,239,221,116,82,125,137
97123,44537,22788,21749,13656,13445,11688,5748
97124,48349,24109,24240,13219,16982,11973,6175
97125,157,79,78,31,20,61,45
97127,3740,1918,1822,1292,993,1000,455
97128,36141,17488,18653,10516,9471,8711,7443
97130,710,338,372,83,91,188,348
97131,2498,1211,1287,438,421,743,896
97132,28278,13879,14399,8013,7642,7548,5075
97133,4000,2022,1978,1059,827,1314,800
97134,175,85,90,19,26,34,96
97135,861,437,424,116,106,278,361
97136,1761,861,900,252,239,567,703
97137,1307,680,627,415,293,385,214
97138,10021,4896,5125,2180,2294,2970,2577
97140,23474,11581,11893,7800,5501,6976,3197
97141,13140,6713,6427,3409,2981,3762,2988
97144,195,113,82,61,52,65,17
97145,441,204,237,67,58,142,174
97146,5905,3046,2859,1410,1347,1740,1408
97147,408,189,219,56,72,109,171
97148,3406,1735,1671,859,592,1225,730
97149,574,280,294,96,71,160,247
97201,15484,7988,7496,2296,7210,2998,2980
97202,38762,18950,19812,7346,15005,10353,6058
97203,31042,14919,16123,8844,11762,6938,3498
97204,1036,812,224,26,421,468,121
97205,7688,4418,3270,515,3450,2113,1610
97206,47596,23618,23978,10222,17397,12970,7007
97208,0,0,0,0,0,0,0
97209,14950,8390,6560,733,7630,4409,2178
97210,10887,5399,5488,1314,4698,2928,1947
97211,31254,15398,15856,6168,12711,8310,4065
97212,24126,11645,12481,5290,7312,7675,3849
97213,29219,14298,14921,5774,9902,9018,4525
97214,23813,11906,11907,2955,12332,5954,2572
97215,16375,7952,8423,2983,5594,5079,2719
97216,15594,7580,8014,3759,4938,4066,2831
97217,31438,15686,15752,6028,12181,8616,4613
97218,14561,7215,7346,3847,4898,3894,1922
97219,38709,18831,19878,8748,11445,11897,6619
97220,28495,14013,14482,6986,8629,7867,5013
97221,11630,5603,6027,2672,2199,3869,2890
97222,34979,16978,18001,8177,9677,9843,7282
97223,46699,23067,23632,12353,13227,14113,7006
97224,31122,14519,16603,7391,7495,8468,7768
97225,24176,11685,12491,4871,6786,7006,5513
97227,3847,1936,1911,594,1903,934,416
97229,58217,28434,29783,17670,13878,18264,8405
97230,39752,19654,20098,10031,10870,10383,8468
97231,4280,2236,2044,856,831,1598,995
97232,11472,5544,5928,1408,4896,3002,2166
97233,39367,19768,19599,12749,12251,9544,4823
97236,36852,18105,18747,11407,10509,9728,5208
97239,14150,7001,7149,2113,5454,3854,2729
97266,33300,16586,16714,9351,10205,8867,4877
97267,30839,14970,15869,7304,7079,9141,7315
97301,53518,27747,25771,15900,17130,13169,7319
97302,37131,17920,19211,9331,9163,10406,8231
97303,38663,18587,20076,11601,10029,9813,7220
97304,28454,13659,14795,7953,6569,7860,6072
97305,40176,19915,20261,13061,11670,9060,6385
97306,27360,13042,14318,7418,6957,7710,5275
97317,24355,12853,11502,6695,6711,6476,4473
97321,24928,12346,12582,6611,5869,7429,5019
97322,34039,16571,17468,9390,9779,8211,6659
97324,1126,571,555,229,194,427,276
97325,6614,3212,3402,2041,1466,1833,1274
97326,961,474,487,195,180,315,271
97327,2871,1398,1473,703,583,888,697
97329,90,46,44,14,6,37,33
97330,41472,20823,20649,8900,15308,9766,7498
97331,2408,1179,1229,1990,415,3,0
97333,21377,10743,10634,4833,8657,4615,3272
97338,20045,9713,10332,5291,4186,5449,5119
97341,2325,1096,1229,238,352,724,1011
97342,267,134,133,45,50,106,66
97343,434,217,217,97,89,144,104
97344,1076,553,523,271,224,322,259
97345,574,309,265,112,88,180,194
97346,883,466,417,179,149,276,279
97347,1878,933,945,464,362,568,484
97348,1625,819,806,521,436,411,257
97350,182,98,84,27,27,74,54
97351,10307,5170,5137,3386,3186,2228,1507
97352,5604,2793,2811,1657,1318,1579,1050
97355,28613,14025,14588,7459,6338,7958,6858
97357,253,124,129,34,36,103,80
97358,2576,1280,1296,586,459,824,707
97360,2249,1163,1086,652,507,638,452
97361,11258,5435,5823,3198,3992,2285,1783
97362,4338,2117,2221,1326,1019,987,1006
97364,446,205,241,94,103,123,126
97365,10744,5300,5444,2346,2540,2935,2923
97366,1460,690,770,241,219,462,538
97367,9416,4446,4970,1753,1964,2745,2954
97368,3435,1720,1715,665,626,1090,1054
97369,193,95,98,9,20,74,90
97370,8271,4104,4167,2288,1807,2695,1481
97371,730,361,369,189,137,227,177
97373,178,175,3,10,107,37,24
97374,5266,2643,2623,1376,1022,1535,1333
97375,1252,656,596,321,246,441,244
97376,1301,627,674,190,148,474,489
97377,917,496,421,236,196,313,172
97378,8882,5341,3541,2112,2599,2646,1525
97380,2449,1219,1230,663,485,755,546
97381,14711,7116,7595,4332,3267,4010,3102
97383,9587,4700,4887,2830,2325,2561,1871
97384,23,14,9,9,7,6,1
97385,3257,1564,1693,786,576,847,1048
97386,13567,6789,6778,3605,2765,3859,3338
97388,888,412,476,100,108,236,444
97389,1676,834,842,499,379,442,356
97390,555,294,261,68,77,196,214
97391,5344,2627,2717,1341,1180,1687,1136
97392,5191,2552,2639,1359,1007,1629,1196
97394,4643,2207,2436,716,619,1511,1797
97396,3154,1599,1555,922,709,913,610
97401,40521,19826,20695,8226,17059,7814,7422
97402,50342,25100,25242,12328,16398,13216,8400
97403,11622,5865,5757,4077,4192,1904,1449
97404,32255,15652,16603,8157,8133,9256,6709
97405,44645,21631,23014,9223,11721,13544,10157
97406,105,57,48,14,13,35,43
97408,11711,5628,6083,2794,2341,3403,3173
97410,759,391,368,106,91,230,332
97411,6953,3389,3564,1179,1031,2100,2643
97412,521,272,249,122,89,171,139
97413,915,464,451,166,145,282,322
97414,273,143,130,53,49,76,95
97415,14051,6879,7172,2653,2283,3873,5242
97416,937,508,429,246,177,264,250
97417,2439,1214,1225,624,441,581,793
97419,1066,525,541,170,177,388,331
97420,27473,13587,13886,6211,6129,7781,7352
97423,6809,3329,3480,1508,1259,1966,2076
97424,17594,8625,8969,4269,3791,5079,4455
97426,9716,4802,4914,2478,2222,2849,2167
97429,684,350,334,149,67,220,248
97430,385,198,187,54,60,143,128
97431,2335,1169,1166,509,465,826,535
97434,928,473,455,205,167,297,259
97435,2349,1176,1173,556,472,689,632
97436,841,420,421,175,111,242,313
97437,2572,1276,1296,535,434,897,706
97438,1191,608,583,253,195,431,312
97439,14343,6892,7451,2127,2022,3682,6512
97441,260,136,124,62,49,75,74
97442,2232,1155,1077,554,447,649,582
97443,2232,1191,1041,517,438,693,584
97444,5181,2564,2617,814,718,1642,2007
97446,4812,2393,2419,1477,1159,1354,822
97447,794,423,371,162,150,290,192
97448,12244,6081,6163,2984,2705,3654,2901
97449,1959,998,961,254,241,573,891
97450,671,343,328,91,69,234,277
97451,387,204,183,89,52,138,108
97452,1420,725,695,368,300,477,275
97453,897,454,443,150,146,291,310
97454,1337,677,660,268,237,460,372
97455,2538,1267,1271,557,390,852,739
97456,2985,1513,1472,692,570,1000,723
97457,10208,5078,5130,2404,2103,2942,2759
97458,4733,2337,2396,1059,872,1386,1416
97459,14096,6917,7179,3106,3094,4049,3847
97461,683,363,320,134,146,254,149
97462,3938,1994,1944,844,622,1291,1181
97463,3877,1964,1913,852,660,1177,1188
97465,2145,1093,1052,298,315,670,862
97466,816,423,393,167,125,261,263
97467,5339,2670,2669,1040,906,1424,1969
97469,2596,1292,1304,611,534,770,681
97470,19985,9872,10113,4658,4990,5483,4854
97471,29100,14090,15010,6674,5603,8151,8672
97473,328,164,164,35,20,96,177
97476,217,110,107,30,32,62,93
97477,36874,18048,18826,9055,11004,9730,7085
97478,37011,18323,18688,9988,9590,10517,6916
97479,9505,4560,4945,2253,1842,2474,2936
97480,379,190,189,70,73,125,111
97481,679,352,327,132,131,222,194
97484,235,120,115,37,35,74,89
97486,714,346,368,120,92,223,279
97487,8449,4231,4218,2086,2005,2636,1722
97488,1011,530,481,176,149,342,344
97489,868,430,438,158,141,302,267
97490,326,170,156,70,45,128,83
97492,597,318,279,128,96,204,169
97493,323,165,158,53,51,91,128
97494,49,30,19,16,10,12,11
97495,1450,717,733,312,258,421,459
97496,7634,3726,3908,1880,1724,2087,1943
97497,1523,783,740,264,287,490,482
97498,1814,947,867,288,283,490,753
97499,1957,948,1009,409,348,608,592
97501,42117,20979,21138,11470,11498,11281,7868
97502,27694,13518,14176,7301,6274,7755,6364
97503,10528,5535,4993,3174,2749,2838,1767
97504,44444,21010,23434,10954,10004,11455,12031
97520,24469,11459,13010,5006,6021,6902,6540
97522,658,350,308,167,106,198,187
97523,6264,3102,3162,1298,1061,1834,2071
97524,14459,7103,7356,3749,3078,4211,3421
97525,4601,2304,2297,793,792,1530,1486
97526,34205,16539,17666,8179,6856,9220,9950
97527,33713,16236,17477,7636,6440,9145,10492
97530,6916,3431,3485,1238,1013,2275,2390
97531,522,270,252,124,98,171,129
97532,2378,1215,1163,417,344,729,888
97534,756,395,361,135,120,226,275
97535,5047,2446,2601,1132,1207,1307,1401
97536,965,498,467,181,132,336,316
97537,6918,3367,3551,1312,1099,2117,2390
97538,2063,1040,1023,379,348,647,689
97539,3329,1667,1662,622,534,984,1189
97540,7930,3760,4170,1927,1862,2204,1937
97541,1478,745,733,282,238,511,447
97543,736,367,369,163,104,271,198
97544,2206,1123,1083,426,382,686,712
97601,22459,11236,11223,5891,6048,5974,4546
97603,29525,14353,15172,7766,6755,7899,7105
97604,28,18,10,4,12,6,6
97620,111,56,55,18,26,44,23
97621,320,172,148,48,44,88,140
97622,558,285,273,96,78,172,212
97623,2310,1184,1126,572,404,728,606
97624,3500,1783,1717,661,474,1152,1213
97625,199,102,97,52,29,53,65
97626,88,50,38,9,10,43,26
97627,780,394,386,142,106,275,257
97630,5096,2729,2367,1041,1061,1632,1362
97632,1466,772,694,454,317,395,300
97633,1361,699,662,420,280,369,292
97634,212,110,102,51,37,81,43
97635,124,56,68,21,22,43,38
97636,387,187,200,96,79,101,111
97637,76,36,40,9,10,28,29
97638,507,272,235,131,82,169,125
97639,570,309,261,100,73,184,213
97640,99,51,48,7,12,43,37
97641,1313,676,637,297,210,349,457
97701,58993,28997,29996,14550,16324,16736,11383
97702,40583,20245,20338,10562,10130,11985,7906
97707,5814,2949,2865,1077,973,1729,2035
97710,120,69,51,29,23,43,25
97711,61,32,29,9,9,23,20
97712,38,19,19,9,10,12,7
97720,4530,2302,2228,1058,881,1346,1245
97721,271,147,124,61,60,82,68
97722,91,48,43,28,20,21,22
97730,252,123,129,29,17,86,120
97731,278,160,118,29,70,109,70
97732,139,72,67,45,22,40,32
97733,770,406,364,104,94,278,294
97734,2786,1447,1339,824,544,778,640
97735,165,92,73,31,23,41,70
97736,73,37,36,26,17,18,12
97737,496,264,232,75,69,164,188
97738,1941,969,972,511,388,539,503
97739,11018,5600,5418,2217,1729,3388,3684
97741,11912,6266,5646,3372,2954,3309,2277
97750,386,192,194,78,56,122,130
97751,129,71,58,28,30,29,42
97752,44,29,15,7,5,26,6
97753,2016,1025,991,381,289,647,699
97754,18574,9150,9424,4550,3795,5117,5112
97756,33554,16369,17185,9373,8412,8664,7105
97758,101,49,52,26,17,27,31
97759,6294,3105,3189,1461,828,2018,1987
97760,6757,3393,3364,1322,1053,2130,2252
97761,3987,2042,1945,1539,1193,870,385
97801,21521,11328,10193,5540,5723,6092,4166
97810,815,413,402,214,147,260,194
97812,851,460,391,190,167,294,200
97813,1302,614,688,364,261,389,288
97814,12382,6228,6154,2861,2476,3525,3520
97817,38,23,15,4,5,17,12
97818,4159,2213,1946,1505,1168,985,501
97819,29,15,14,1,1,3,24
97820,1095,520,575,230,199,325,341
97823,948,465,483,170,136,294,348
97824,1661,823,838,422,247,490,502
97825,244,130,114,43,30,91,80
97826,1085,551,534,333,235,306,211
97827,2628,1348,1280,624,425,812,767
97828,3124,1534,1590,664,576,904,980
97830,748,381,367,150,111,188,299
97833,895,464,431,243,157,293,202
97834,986,486,500,176,127,307,376
97835,361,200,161,125,76,105,55
97836,1983,1015,968,473,332,572,606
97837,95,48,47,24,20,27,24
97838,25346,12743,12603,8350,6609,6203,4184
97839,475,245,230,142,94,139,100
97840,98,54,44,23,23,41,11
97841,476,237,239,139,86,161,90
97842,153,79,74,29,15,39,70
97843,647,333,314,161,118,214,154
97844,3806,1893,1913,1194,850,1048,714
97845,2652,1299,1353,620,523,729,780
97846,1891,918,973,317,311,614,649
97848,195,103,92,55,33,53,54
97850,16955,8257,8698,4517,4708,4093,3637
97856,366,181,185,78,56,109,123
97857,457,226,231,101,68,147,141
97859,123,65,58,21,14,50,38
97862,11666,5789,5877,3574,2642,2962,2488
97864,262,143,119,59,45,77,81
97865,1160,587,573,199,159,365,437
97867,763,367,396,212,144,230,177
97868,1991,987,1004,544,418,541,488
97869,1135,558,577,237,185,335,378
97870,573,293,280,76,49,186,262
97873,228,117,111,47,40,59,82
97874,349,169,180,73,58,105,113
97875,2610,1320,1290,845,633,733,399
97876,837,433,404,181,120,273,263
97877,283,153,130,23,16,83,161
97880,272,144,128,64,36,72,100
97882,7760,4828,2932,2185,2725,1966,884
97883,2473,1218,1255,646,434,767,626
97884,157,84,73,25,22,50,60
97885,1383,682,701,321,220,431,411
97886,1140,597,543,275,219,354,292
97901,692,359,333,167,139,192,194
97903,109,56,53,15,22,34,38
97904,176,95,81,57,29,42,48
97905,133,72,61,16,13,52,52
97906,249,127,122,66,50,57,76
97907,560,295,265,107,83,157,213
97908,56,28,28,8,8,27,13
97909,51,32,19,20,13,10,8
97910,573,299,274,135,97,176,165
97911,109,55,54,34,21,37,17
97913,5527,2776,2751,1949,1278,1250,1050
97914,19205,10769,8436,5217,5499,4854,3635
97918,4537,2316,2221,1319,1002,1137,1079
97920,60,29,31,23,11,17,9
99362,46,24,22,5,4,10,27
15001,31964,15384,16580,7255,6921,9820,7968
15003,11861,5739,6122,2773,2816,3535,2737
15004,351,176,175,96,76,121,58
15005,9450,4584,4866,1940,1963,2992,2555
15006,240,116,124,58,47,85,50
15007,323,153,170,66,75,117,65
15009,15082,7058,8024,3295,2658,4477,4652
15010,28425,13607,14818,6711,6338,8359,7017
15012,15905,7633,8272,3565,3107,4933,4300
15014,3184,1476,1708,679,816,976,713
15015,1175,561,614,271,168,385,351
15017,16213,7535,8678,3441,3631,4689,4452
15018,821,421,400,192,177,268,184
15019,1719,888,831,391,346,557,425
15020,231,105,126,57,32,79,63
15021,7352,3657,3695,1691,1467,2393,1801
15022,10340,4906,5434,2207,2247,3037,2849
15024,9029,4350,4679,1955,1716,2839,2519
15025,15944,7514,8430,3665,3640,4876,3763
15026,3390,1719,1671,820,633,1235,702
15027,2201,1032,1169,481,446,613,661
15028,142,68,74,21,33,48,40
15030,1128,551,577,234,283,348,263
15031,513,266,247,129,135,153,96
15033,4910,2239,2671,1182,1081,1353,1294
15034,1792,858,934,306,397,565,524
15035,2129,1027,1102,459,536,617,517
15037,10894,5208,5686,2331,2126,3372,3065
15038,325,159,166,73,62,99,91
15042,8105,3910,4195,1769,1635,2635,2066
15043,2458,1237,1221,675,511,818,454
15044,27049,13211,13838,7719,4656,9352,5322
15045,4483,2171,2312,984,1082,1311,1106
15046,2640,1290,1350,634,577,807,622
15047,151,75,76,37,22,56,36
15049,895,412,483,135,180,283,297
15050,2431,1251,1180,633,483,825,490
15051,461,222,239,85,109,150,117
15052,3483,1715,1768,757,731,1135,860
15053,154,76,78,38,28,52,36
15054,375,168,207,97,87,95,96
15055,1360,607,753,230,305,417,408
15056,1140,545,595,272,238,341,289
15057,13930,6961,6969,3814,2892,4530,2694
15059,4193,1958,2235,1048,880,1194,1071
15060,790,385,405,192,186,226,186
15061,12799,6132,6667,2939,2938,3738,3184
15062,7731,3579,4152,1661,1671,2193,2206
15063,11677,5595,6082,2385,2343,3538,3411
15064,382,191,191,90,103,115,74
15065,11588,5517,6071,2537,2564,3549,2938
15066,12785,6161,6624,3124,2976,3903,2782
15067,2281,1094,1187,489,509,674,609
15068,38785,18593,20192,8887,8124,12080,9694
15071,9956,4909,5047,2473,2451,3120,1912
15072,101,53,48,25,21,28,27
15074,8874,4304,4570,2025,2006,2705,2138
15075,128,52,76,40,36,32,20
15076,849,430,419,196,164,279,210
15077,198,99,99,61,40,62,35
15078,523,243,280,109,115,151,148
15081,475,241,234,88,117,144,126
15082,350,166,184,89,87,94,80
15083,952,475,477,224,206,294,228
15084,10130,4950,5180,2312,2374,3190,2254
15085,7944,3852,4092,1763,1605,2498,2078
15086,300,156,144,67,72,113,48
15087,234,114,120,56,48,75,55
15088,535,261,274,136,129,152,118
15089,6262,3021,3241,1299,1265,2050,1648
15090,21202,10355,10847,6231,4086,7480,3405
15101,24292,11686,12606,5872,4592,7680,6148
15102,29529,14138,15391,6730,5744,9387,7668
15104,9038,4140,4898,2668,2095,2489,1786
15106,18536,8933,9603,3608,4737,5444,4747
15108,40153,19758,20395,9594,10058,12303,8198
15110,5565,2477,3088,1679,1308,1394,1184
15112,3292,1529,1763,815,823,996,658
15116,14427,6979,7448,3170,2949,4652,3656
15120,18931,8926,10005,4145,4527,5500,4759
15122,20131,9431,10700,4496,4326,5864,5445
15126,7014,3453,3561,1773,1782,2416,1043
15129,10920,5381,5539,2688,2438,3573,2221
15131,8240,3860,4380,1510,1634,2478,2618
15132,21472,9966,11506,5506,4696,5989,5281
15133,6432,3067,3365,1382,1424,1942,1684
15135,5139,2498,2641,1088,1055,1690,1306
15136,21849,10401,11448,5347,4976,6655,4871
15137,10228,4837,5391,2159,2325,3117,2627
15139,6307,2891,3416,1203,1408,1848,1848
15140,3294,1541,1753,796,831,958,709
15142,1163,576,587,293,164,487,219
15143,19660,9368,10292,5159,3301,6288,4912
15144,4142,1969,2173,799,916,1393,1034
15145,7132,3285,3847,1589,1765,2005,1773
15146,28323,13371,14952,5790,6398,8095,8040
15147,17395,8062,9333,3592,3637,5169,4997
15148,2814,1284,1530,740,725,734,615
15201,12713,6111,6602,2461,4214,3423,2615
15202,19685,9358,10327,4120,5840,5831,3894
15203,9949,5218,4731,800,5678,1849,1622
15204,8329,3907,4422,2156,1999,2459,1715
15205,21865,10557,11308,4585,6779,6139,4362
15206,28615,13280,15335,6021,9192,7467,5935
15207,11268,5304,5964,2503,2848,3346,2571
15208,10406,4595,5811,2841,2437,2808,2320
15209,12438,6017,6421,2758,2993,3905,2782
15210,25954,12253,13701,6810,7018,7479,4647
15211,11081,5527,5554,1500,4603,2712,2266
15212,27895,13574,14321,6158,7928,8256,5553
15213,30844,15149,15695,8243,17022,2278,3301
15214,14352,6636,7716,3747,3528,4033,3044
15215,12615,6149,6466,2961,2621,4068,2965
15216,23350,11314,12036,4897,7361,6697,4395
15217,27220,13379,13841,5217,10010,6098,5895
15218,13851,6319,7532,2883,3999,4154,2815
15219,16696,8544,8152,4325,6503,3477,2391
15220,17718,8492,9226,3367,5397,4674,4280
15221,31060,13948,17112,6769,7932,8872,7487
15222,3294,1641,1653,598,1419,742,535
15223,7236,3476,3760,1559,1905,2155,1617
15224,10141,4799,5342,1628,3975,2336,2202
15225,1084,551,533,187,272,334,291
15226,13974,6605,7369,2880,3909,3885,3300
15227,28156,13675,14481,6023,7095,8402,6636
15228,17595,8363,9232,4686,3738,5544,3627
15229,13825,6581,7244,3030,3712,4111,2972
15232,11374,5517,5857,873,7232,1616,1653
15233,4451,3064,1387,586,1875,1427,563
15234,14056,6733,7323,2764,3493,4119,3680
15235,34580,16095,18485,7356,7470,10580,9174
15236,29724,14031,15693,6343,6259,8627,8495
15237,41895,19892,22003,9134,9427,12697,10637
15238,13162,6393,6769,3143,2035,4270,3714
15239,21024,10348,10676,5165,4717,6405,4737
15241,20395,9949,10446,5917,2874,6739,4865
15243,13406,6160,7246,2952,2148,3898,4408
15260,0,0,0,0,0,0,0
15290,0,0,0,0,0,0,0
15301,49331,23672,25659,10751,11497,14649,12434
15310,290,157,133,55,59,105,71
15311,1391,699,692,331,281,474,305
15312,3579,1813,1766,838,725,1198,818
15313,377,183,194,72,74,123,108
15314,3788,1846,1942,900,854,1146,888
15315,776,378,398,193,179,210,194
15316,131,66,65,43,31,28,29
15317,36535,17693,18842,9179,7511,11346,8499
15320,5384,2586,2798,1274,1203,1614,1293
15321,1676,839,837,379,355,558,384
15322,2018,987,1031,468,449,598,503
15323,4542,2262,2280,1137,899,1445,1061
15324,632,277,355,143,156,158,175
15325,439,196,243,133,100,141,65
15327,1527,771,756,377,346,470,334
15329,1709,882,827,450,317,591,351
15330,5299,2698,2601,1112,906,1921,1360
15331,1090,549,541,260,269,302,259
15332,8148,4025,4123,1703,1580,2640,2225
15333,2150,1046,1104,538,479,612,521
15334,113,52,61,27,26,24,36
15337,744,388,356,183,155,246,160
15338,1606,791,815,381,367,492,366
15340,1469,763,706,333,262,515,359
15341,869,463,406,212,173,286,198
15342,4818,2328,2490,990,1004,1515,1309
15344,1450,710,740,266,295,508,381
15345,1642,837,805,373,391,506,372
15346,749,385,364,187,175,224,163
15347,582,291,291,113,146,192,131
15348,283,122,161,83,81,71,48
15349,1737,880,857,402,390,525,420
15350,425,208,217,90,102,134,99
15351,901,453,448,264,264,215,158
15352,987,485,502,262,194,328,203
15353,64,36,28,16,21,18,9
15357,1661,819,842,361,306,537,457
15358,923,441,482,216,217,263,227
15359,174,85,89,28,35,58,53
15360,1731,880,851,403,319,610,399
15361,151,70,81,29,30,54,38
15362,767,399,368,167,197,230,173
15363,760,371,389,174,183,225,178
15364,869,438,431,215,191,289,174
15366,164,86,78,31,32,58,43
15367,8731,4290,4441,3102,1319,3181,1129
15368,473,235,238,132,117,120,104
15370,14870,8107,6763,3306,4517,4160,2887
15376,1740,883,857,417,376,569,378
15377,724,396,328,179,167,230,148
15378,106,53,53,27,30,32,17
15379,132,70,62,29,23,46,34
15380,719,358,361,184,145,226,164
15401,32288,15113,17175,7219,7098,9359,8612
15410,905,441,464,199,192,318,196
15411,661,355,306,145,134,200,182
15412,470,225,245,92,84,151,143
15413,551,275,276,126,148,167,110
15417,9469,4441,5028,2107,2832,2436,2094
15419,4492,2176,2316,1451,1891,555,595
15420,251,118,133,59,69,63,60
15421,112,55,57,17,25,25,45
15422,220,109,111,60,47,58,55
15423,1781,920,861,392,352,572,465
15424,2489,1248,1241,562,542,704,681
15425,19270,9370,9900,4453,4400,5721,4696
15427,1091,547,544,214,219,359,299
15428,1806,927,879,380,386,607,433
15429,126,59,67,41,27,31,27
15430,314,161,153,91,72,99,52
15431,4744,2321,2423,1142,1059,1500,1043
15432,427,203,224,85,74,125,143
15433,741,365,376,156,126,253,206
15434,313,141,172,60,68,83,102
15435,437,206,231,101,94,111,131
15436,2740,1295,1445,689,657,775,619
15437,2573,1261,1312,511,610,858,594
15438,2221,1061,1160,491,471,646,613
15440,349,167,182,74,81,113,81
15442,2105,1010,1095,440,454,655,556
15443,377,182,195,130,90,90,67
15444,517,237,280,100,117,157,143
15445,2693,1313,1380,496,552,839,806
15446,324,160,164,59,63,103,99
15447,181,82,99,47,38,38,58
15448,192,100,92,54,49,49,40
15449,184,89,95,43,37,56,48
15450,2323,2128,195,88,1303,776,156
15451,955,457,498,253,207,298,197
15454,237,115,122,71,60,64,42
15455,298,139,159,80,56,88,74
15456,2976,1487,1489,692,656,926,702
15458,2379,1181,1198,550,473,803,553
15459,1763,905,858,383,390,503,487
15460,120,61,59,33,16,47,24
15461,4333,2056,2277,1053,1004,1258,1018
15462,398,207,191,118,119,94,67
15463,64,35,29,7,16,29,12
15464,1536,778,758,407,321,479,329
15466,458,231,227,119,103,132,104
15467,141,74,67,32,31,48,30
15468,2303,1086,1217,520,509,705,569
15469,2331,1161,1170,629,558,693,451
15470,982,500,482,197,187,339,259
15472,306,132,174,60,52,73,121
15473,3862,1892,1970,781,724,1179,1178
15474,2049,1004,1045,461,502,624,462
15475,1356,629,727,307,300,394,355
15476,157,71,86,47,29,52,29
15477,855,390,465,165,188,238,264
15478,6446,3168,3278,1563,1480,2043,1360
15479,2113,1055,1058,485,491,632,505
15480,1946,934,1012,425,400,582,539
15482,604,291,313,150,136,180,138
15483,513,256,257,113,126,146,128
15484,328,160,168,82,69,89,88
15486,2303,1142,1161,561,474,748,520
15489,389,191,198,109,85,113,82
15490,628,323,305,173,151,192,112
15492,108,56,52,28,19,40,21
15501,16861,8790,8071,3377,3985,5279,4220
15502,191,102,89,21,26,58,86
15510,2229,2222,7,15,1487,654,73
15520,293,148,145,75,70,93,55
15521,1872,956,916,518,389,546,419
15522,12036,5943,6093,2536,2396,3581,3523
15530,5368,2625,2743,1302,1159,1629,1278
15531,3861,1925,1936,886,816,1219,940
15532,142,70,72,25,34,52,31
15533,1370,670,700,320,301,414,335
15534,932,468,464,220,180,276,256
15535,2203,1131,1072,494,433,692,584
15536,459,222,237,104,106,133,116
15537,7952,3843,4109,1799,1635,2315,2203
15538,824,429,395,176,162,258,228
15539,498,255,243,135,125,125,113
15540,290,153,137,70,44,89,87
15541,3721,1856,1865,916,855,1178,772
15542,1175,597,578,291,254,377,253
15544,264,134,130,66,69,80,49
15545,2879,1454,1425,692,613,845,729
15546,386,197,189,100,95,103,88
15547,504,249,255,121,92,172,119
15550,1699,848,851,379,316,550,454
15551,860,447,413,178,180,270,232
15552,6115,2978,3137,1487,1371,1754,1503
15554,2553,1275,1278,609,584,828,532
15555,112,59,53,33,27,30,22
15557,3684,1851,1833,902,795,1079,908
15558,2126,1041,1085,601,443,578,504
15559,1968,1021,947,434,395,640,499
15560,175,91,84,45,43,47,40
15561,168,88,80,32,29,53,54
15562,201,95,106,65,42,45,49
15563,3345,1697,1648,704,658,1082,901
15564,50,21,29,9,9,22,10
15601,59483,29009,30474,12511,13525,17796,15651
15610,3738,1882,1856,815,727,1390,806
15611,543,268,275,104,129,155,155
15612,474,231,243,90,107,160,117
15613,13933,6832,7101,3048,2524,4546,3815
15615,387,190,197,94,65,146,82
15616,23,9,14,4,6,6,7
15617,367,182,185,79,94,126,68
15618,2634,1306,1328,586,528,844,676
15620,911,441,470,200,203,258,250
15621,47,21,26,15,15,12,5
15622,1387,724,663,274,265,452,396
15623,762,381,381,169,189,245,159
15624,410,198,212,88,89,106,127
15625,144,72,72,30,38,47,29
15626,5105,2448,2657,1074,982,1521,1528
15627,6544,3252,3292,1547,1356,2088,1553
15628,525,250,275,87,80,162,196
15629,676,324,352,144,156,208,168
15631,1075,517,558,256,265,332,222
15632,9363,4642,4721,2194,1706,3236,2227
15633,293,144,149,77,48,97,71
15634,523,247,276,121,127,168,107
15635,220,116,104,51,45,64,60
15636,3946,1929,2017,1226,652,1392,676
15637,1861,916,945,426,417,551,467
15638,288,150,138,57,67,95,69
15639,2301,1102,1199,550,476,710,565
15640,378,187,191,104,82,134,58
15641,500,232,268,105,115,138,142
15642,45286,21943,23343,10645,9032,14654,10955
15644,18836,9054,9782,4132,3957,5983,4764
15646,233,112,121,55,51,61,66
15647,314,159,155,58,73,107,76
15650,28432,13837,14595,6500,6111,8343,7478
15655,423,211,212,97,86,113,127
15656,10298,5057,5241,2322,2148,3224,2604
15658,8916,4379,4537,1677,1416,2998,2825
15660,323,151,172,65,61,110,87
15661,504,251,253,110,112,169,113
15662,271,137,134,64,73,75,59
15663,455,214,241,63,99,149,144
15665,1472,717,755,388,382,421,281
15666,16461,7947,8514,3424,3409,5072,4556
15668,13139,6459,6680,3157,1848,4342,3792
15670,3649,1836,1813,765,730,1262,892
15671,865,439,426,195,194,263,213
15672,3334,1672,1662,710,757,1116,751
15673,1296,634,662,302,266,425,303
15675,1003,479,524,242,239,312,210
15676,437,222,215,103,114,131,89
15677,389,195,194,81,60,147,101
15678,476,223,253,107,109,140,120
15679,3343,1688,1655,750,639,1193,761
15680,101,52,49,19,17,28,37
15681,5241,2718,2523,1343,1042,1701,1155
15683,8248,3971,4277,1817,1767,2536,2128
15684,841,409,432,171,172,285,213
15686,972,492,480,214,180,294,284
15687,1476,711,765,323,305,471,377
15688,641,308,333,126,139,224,152
15689,229,114,115,52,64,63,50
15690,9078,4466,4612,2218,2036,2710,2114
15691,70,31,39,16,12,22,20
15692,941,468,473,195,219,316,211
15693,189,89,100,54,47,56,32
15695,337,167,170,76,82,86,93
15696,384,176,208,83,91,113,97
15697,3038,1477,1561,621,794,892,731
15698,791,390,401,176,184,234,197
15701,34704,16750,17954,8609,11856,7404,6835
15710,266,125,141,59,67,68,72
15711,412,202,210,96,100,103,113
15712,151,80,71,37,35,42,37
15713,294,137,157,84,89,68,53
15714,5323,2606,2717,1354,1177,1506,1286
15715,621,318,303,160,139,154,168
15716,683,321,362,146,166,195,176
15717,10847,5707,5140,2615,2385,3228,2619
15721,234,129,105,57,50,70,57
15722,2432,1224,1208,584,477,780,591
15723,46,26,20,4,7,18,17
15724,2412,1232,1180,535,503,782,592
15725,1446,745,701,324,311,479,332
15727,168,80,88,51,49,33,35
15728,3701,1877,1824,940,840,1107,814
15729,1537,786,751,405,353,465,314
15730,69,32,37,7,23,23,16
15731,315,158,157,57,67,97,94
15732,1669,845,824,446,377,508,338
15733,108,56,52,29,30,19,30
15734,322,163,159,90,90,83,59
15736,613,290,323,119,149,172,173
15737,83,41,42,10,16,28,29
15738,265,138,127,65,63,78,59
15739,462,217,245,128,151,105,78
15741,83,45,38,14,17,27,25
15742,950,490,460,214,211,287,238
15744,105,57,48,30,23,33,19
15745,337,172,165,96,94,91,56
15746,135,55,80,29,28,32,46
15747,2027,1003,1024,544,376,631,476
15748,7060,3493,3567,1625,1583,2159,1693
15750,245,123,122,58,64,61,62
15752,54,21,33,12,13,13,16
15753,513,260,253,118,105,165,125
15754,502,252,250,117,109,152,124
15756,207,113,94,57,47,61,42
15757,1618,822,796,394,325,527,372
15759,3004,1515,1489,846,672,843,643
15760,152,76,76,36,36,50,30
15761,111,54,57,33,26,27,25
15762,823,413,410,215,157,264,187
15764,163,92,71,25,32,45,61
15765,1707,865,842,374,333,586,414
15767,14668,7094,7574,3850,3136,4281,3401
15770,184,99,85,31,31,60,62
15771,991,484,507,221,189,311,270
15772,1715,910,805,401,346,580,388
15773,516,252,264,125,88,150,153
15774,3029,1534,1495,674,621,1056,678
15775,751,374,377,157,143,245,206
15776,52,29,23,10,13,17,12
15777,170,79,91,38,41,60,31
15778,140,80,60,36,36,39,29
15779,414,268,146,77,143,129,65
15780,148,73,75,45,29,44,30
15781,94,49,45,15,21,30,28
15783,140,76,64,38,36,46,20
15784,67,30,37,11,13,25,18
15801,19270,9300,9970,4622,4144,5669,4835
15821,164,86,78,22,17,72,53
15823,1431,749,682,327,297,475,332
15824,5407,2680,2727,1414,1164,1562,1267
15825,9562,4625,4937,2122,2054,2759,2627
15827,231,107,124,64,57,71,39
15828,286,142,144,40,42,105,99
15829,1274,635,639,315,306,362,291
15832,328,175,153,41,37,129,121
15834,4533,2210,2323,1017,865,1374,1277
15840,1993,1027,966,439,397,654,503
15841,389,197,192,108,81,107,93
15845,3197,1594,1603,754,662,981,800
15846,3636,1834,1802,895,742,1183,816
15847,255,128,127,58,54,79,64
15848,1027,519,508,300,209,305,213
15849,1399,706,693,313,300,467,319
15851,6671,3338,3333,1687,1495,1942,1547
15853,6578,3267,3311,1574,1311,2144,1549
15856,889,468,421,166,164,359,200
15857,13212,6444,6768,2898,2543,4231,3540
15860,1065,561,504,208,176,362,319
15861,174,91,83,15,17,63,79
15863,225,114,111,52,49,79,45
15864,1845,930,915,453,394,616,382
15865,1295,632,663,301,324,374,296
15866,261,134,127,83,58,70,50
15868,1350,665,685,256,230,415,449
15870,1326,686,640,257,269,477,323
15901,4190,2001,2189,778,859,1201,1352
15902,12513,5922,6591,3154,2871,3611,2877
15904,16608,8000,8608,3558,3828,4451,4771
15905,21226,10104,11122,4532,4176,6199,6319
15906,11144,5266,5878,2652,2474,3179,2839
15909,5611,2719,2892,1222,1126,1761,1502
15920,922,451,471,222,194,269,237
15921,176,88,88,52,42,39,43
15922,177,91,86,27,40,52,58
15923,1770,915,855,455,357,516,442
15924,1034,509,525,236,220,311,267
15925,147,79,68,39,31,46,31
15926,2676,1350,1326,574,507,868,727
15927,1176,564,612,331,290,331,224
15928,1974,929,1045,328,285,561,800
15929,75,35,40,19,13,18,25
15930,241,127,114,44,55,70,72
15931,9148,4643,4505,1884,2078,2940,2246
15934,218,114,104,48,47,75,48
15935,2620,1316,1304,595,494,831,700
15936,1620,830,790,381,312,494,433
15937,779,364,415,158,154,222,245
15938,2583,1286,1297,601,546,778,658
15940,3992,2384,1608,959,1655,958,420
15942,2079,1035,1044,462,369,716,532
15943,3942,1935,2007,923,843,1129,1047
15944,3472,1754,1718,802,699,1109,862
15945,198,103,95,53,38,58,49
15946,7093,3525,3568,1617,1564,2101,1811
15948,550,280,270,155,143,148,104
15949,672,324,348,165,144,205,158
15951,453,219,234,86,95,141,131
15952,1413,658,755,341,304,435,333
15953,83,47,36,16,22,28,17
15954,2413,1181,1232,561,464,771,617
15955,2551,1284,1267,607,551,776,617
15956,2739,1360,1379,660,624,770,685
15957,755,370,385,189,160,249,157
15958,2301,1143,1158,596,519,671,515
15960,425,196,229,109,96,122,98
15961,854,431,423,183,179,248,244
15962,149,74,75,41,36,44,28
15963,11114,5333,5781,2374,2313,3296,3131
16001,40371,19644,20727,9227,9157,11964,10023
16002,15877,8178,7699,4236,2850,5274,3517
16020,1150,596,554,310,241,381,218
16022,368,169,199,119,94,102,53
16023,4169,1917,2252,841,643,1191,1494
16024,209,108,101,50,54,60,45
16025,5564,2773,2791,1386,1112,1769,1297
16027,306,156,150,92,84,75,55
16028,1886,961,925,380,392,575,539
16029,705,352,353,174,173,208,150
16030,316,147,169,79,90,80,67
16033,6165,3092,3073,1534,1319,2094,1218
16034,2054,1052,1002,496,461,672,425
16035,122,59,63,37,25,40,20
16036,200,93,107,40,34,70,56
16037,4589,2306,2283,1118,875,1590,1006
16038,3517,1755,1762,889,758,1076,794
16040,975,476,499,250,234,284,207
16041,1888,967,921,417,374,633,464
16045,1195,583,612,293,333,350,219
16046,14396,6953,7443,4176,3229,4640,2351
16048,139,72,67,33,29,45,32
16049,3241,1626,1615,774,717,960,790
16050,1546,763,783,428,349,474,295
16051,3043,1508,1535,695,645,998,705
16052,2447,1253,1194,574,473,860,540
16053,4020,1999,2021,929,663,1418,1010
16054,497,245,252,128,110,157,102
16055,8486,4219,4267,2117,1613,2791,1965
16056,4791,2269,2522,1072,878,1552,1289
16057,13909,6771,7138,4111,5174,2858,1766
16059,7738,3771,3967,1813,1297,2633,1995
16061,2761,1407,1354,671,535,991,564
16063,6559,3076,3483,1283,1316,2025,1935
16066,28060,13819,14241,8439,6589,9181,3851
16101,34042,16418,17624,8298,7387,9827,8530
16102,5755,2822,2933,1381,1279,1700,1395
16105,15448,7283,8165,3432,2956,4538,4522
16110,314,157,157,63,64,108,79
16111,1409,712,697,512,334,328,235
16112,1571,758,813,376,314,476,405
16113,448,228,220,105,93,141,109
16114,606,310,296,186,102,211,107
16115,3287,1637,1650,754,621,1101,811
16116,3074,1474,1600,668,613,1020,773
16117,17185,8255,8930,4002,3847,5185,4151
16120,2463,1239,1224,617,530,761,555
16121,4941,2263,2678,1312,1071,1355,1203
16123,2237,1153,1084,507,447,801,482
16124,2228,1143,1085,663,437,656,472
16125,18186,8751,9435,4508,3826,4976,4876
16127,16145,7958,8187,4583,4362,3887,3313
16130,2023,1020,1003,446,375,658,544
16131,933,482,451,277,176,273,207
16132,355,178,177,73,86,109,87
16133,1573,783,790,413,340,468,352
16134,3886,1928,1958,827,685,1233,1141
16136,801,381,420,178,204,199,220
16137,12941,7124,5817,2682,3024,4239,2996
16140,123,60,63,30,29,28,36
16141,1806,901,905,402,365,620,419
16142,7056,3323,3733,2306,1809,1513,1428
16143,2901,1451,1450,671,588,950,692
16145,2726,1352,1374,662,542,845,677
16146,14040,6602,7438,3744,3321,3913,3062
16148,16959,7847,9112,3613,3093,4977,5276
16150,7426,3589,3837,1836,1545,2285,1760
16151,77,37,40,21,17,26,13
16153,2624,1294,1330,659,523,806,636
16154,2492,1281,1211,572,447,910,563
16155,103,19,84,0,3,9,91
16156,3319,1678,1641,962,679,1026,652
16157,3477,1731,1746,733,712,1128,904
16159,4706,2318,2388,1037,942,1550,1177
16160,864,425,439,144,180,264,276
16161,644,296,348,123,133,181,207
16201,18214,8901,9313,3957,3977,5619,4661
16210,1014,515,499,248,229,288,249
16211,104,56,48,22,20,31,31
16212,339,164,175,61,82,102,94
16213,204,91,113,50,46,57,51
16214,10127,4573,5554,2762,3848,1906,1611
16217,101,47,54,17,12,29,43
16218,1195,624,571,277,216,412,290
16222,2526,1277,1249,708,512,724,582
16223,154,71,83,38,37,43,36
16224,1181,580,601,275,262,371,273
16226,8279,4045,4234,1843,1677,2497,2262
16228,371,174,197,72,87,117,95
16229,4997,2477,2520,1244,1003,1645,1105
16230,494,235,259,141,129,105,119
16232,4281,2133,2148,1079,894,1309,999
16233,1246,624,622,295,244,413,294
16235,1256,620,636,281,294,382,299
16236,262,126,136,62,68,69,63
16238,410,196,214,105,99,127,79
16239,4172,3295,877,543,1895,1092,642
16240,1533,798,735,339,352,473,369
16242,4693,2251,2442,1159,1029,1304,1201
16244,265,124,141,78,52,67,68
16245,207,97,110,45,53,61,48
16246,252,125,127,67,57,73,55
16248,3130,1547,1583,762,712,908,748
16249,2089,1069,1020,502,486,643,458
16250,315,167,148,75,72,98,70
16253,91,43,48,17,20,27,27
16254,3471,1726,1745,710,778,1028,955
16255,1943,944,999,440,431,554,518
16256,2084,1076,1008,986,468,375,255
16258,1869,927,942,429,454,597,389
16259,1934,982,952,471,372,621,470
16260,296,147,149,67,62,86,81
16262,3007,1470,1537,650,577,961,819
16263,317,148,169,89,72,94,62
16301,16321,7844,8477,4092,3440,4898,3891
16311,564,287,277,134,125,172,133
16312,25,12,13,9,4,7,5
16313,1848,964,884,427,361,615,445
16314,5507,2750,2757,1398,1089,1703,1317
16316,5436,2709,2727,1127,1007,1703,1599
16317,1456,732,724,351,309,448,348
16319,1355,688,667,343,269,440,303
16321,76,45,31,15,10,27,24
16322,158,86,72,35,22,51,50
16323,16372,7943,8429,3843,3444,4882,4203
16326,391,211,180,120,70,118,83
16327,2978,1513,1465,795,628,886,669
16328,80,43,37,18,12,17,33
16329,528,276,252,112,106,161,149
16331,88,46,42,28,10,35,15
16332,53,29,24,10,15,19,9
16333,240,119,121,38,52,81,69
16334,338,170,168,78,75,90,95
16335,28445,13668,14777,7121,6951,7742,6631
16340,1990,1037,953,466,321,687,516
16341,2030,1029,1001,492,391,610,537
16342,2281,1180,1101,466,407,806,602
16343,449,224,225,97,104,152,96
16344,523,263,260,146,120,132,125
16345,3543,1776,1767,744,586,1253,960
16346,3247,1516,1731,773,694,978,802
16347,2238,1124,1114,485,437,671,645
16350,2737,1414,1323,891,571,771,504
16351,1716,867,849,346,322,520,528
16352,245,132,113,45,50,83,67
16353,3348,1727,1621,676,550,1031,1091
16354,11379,5494,5885,2849,2398,3265,2867
16360,1383,700,683,377,287,420,299
16361,53,30,23,8,13,18,14
16362,1102,536,566,247,245,372,238
16364,1347,670,677,366,290,397,294
16365,18579,9106,9473,4038,4021,5612,4908
16370,358,195,163,60,54,106,138
16371,3260,1530,1730,716,627,904,1013
16372,499,253,246,113,148,148,90
16373,3510,1798,1712,930,703,1074,803
16374,1968,1021,947,412,377,644,535
16401,6581,4355,2226,1159,2292,2096,1034
16402,956,486,470,288,182,291,195
16403,7029,3060,3969,1662,1947,2217,1203
16404,3269,1652,1617,994,629,961,685
16405,922,470,452,258,154,306,204
16406,3509,1724,1785,913,687,1020,889
16407,11317,5485,5832,3088,2557,3171,2501
16410,1854,945,909,512,392,600,350
16411,1477,756,721,397,288,487,305
16412,10480,5173,5307,2291,3474,2906,1809
16415,8916,4274,4642,2356,1538,2786,2236
16416,203,101,102,61,51,55,36
16417,8329,4093,4236,2183,1708,2691,1747
16420,650,337,313,152,148,208,142
16421,2518,1231,1287,598,501,794,625
16422,401,204,197,110,78,130,83
16423,4450,2185,2265,1314,996,1331,809
16424,4676,2373,2303,1030,779,1456,1411
16426,3730,1908,1822,948,782,1245,755
16427,193,99,94,60,46,53,34
16428,12478,6223,6255,3372,2722,3840,2544
16433,5384,2740,2644,1376,1140,1632,1236
16434,2990,1536,1454,1203,675,702,410
16435,2108,1056,1052,581,482,638,407
16436,756,381,375,197,148,244,167
16438,8083,4032,4051,2286,1804,2373,1620
16440,891,448,443,217,193,283,198
16441,10136,5085,5051,2690,2107,3351,1988
16442,2958,1521,1437,792,652,981,533
16443,1425,736,689,398,332,440,255
16444,1717,735,982,1071,646,0,0
16501,2044,1010,1034,149,602,603,690
16502,16664,8124,8540,4625,5606,4076,2357
16503,16850,8506,8344,5921,4954,4031,1944
16504,17322,8082,9240,4361,5306,4176,3479
16505,17168,8126,9042,3834,3388,5386,4560
16506,23720,11468,12252,5857,4893,7345,5625
16507,11088,5592,5496,3370,3891,2379,1448
16508,16050,7634,8416,4101,4540,4224,3185
16509,26810,12845,13965,6005,6031,7810,6964
16510,25625,12782,12843,6966,5956,7631,5072
16511,11382,5294,6088,2934,2538,3215,2695
16546,1154,467,687,435,719,0,0
16563,1621,1018,603,948,673,0,0
16601,33870,16664,17206,9384,8211,9105,7170
16602,29554,13971,15583,7099,6922,8309,7224
16611,2410,1197,1213,585,515,738,572
16613,1535,778,757,400,295,495,345
16616,116,54,62,23,21,38,34
16617,2806,1349,1457,708,670,760,668
16619,347,181,166,89,76,112,70
16620,414,193,221,90,98,105,121
16621,737,385,352,174,159,240,164
16622,175,84,91,39,33,58,45
16623,567,279,288,131,120,170,146
16624,204,100,104,47,52,69,36
16625,3868,1894,1974,999,936,1056,877
16627,2278,1123,1155,513,487,696,582
16630,5080,2383,2697,1325,1306,1346,1103
16631,90,43,47,29,20,26,15
16633,200,98,102,63,58,41,38
16634,302,165,137,68,60,91,83
16635,11321,5436,5885,2679,2350,3495,2797
16636,742,377,365,152,160,231,199
16637,2873,1417,1456,691,662,873,647
16638,67,36,31,15,15,18,19
16639,1494,755,739,335,317,475,367
16640,817,416,401,161,148,251,257
16641,2598,1307,1291,624,633,784,557
16645,142,72,70,20,25,61,36
16646,2558,1230,1328,610,497,773,678
16647,764,370,394,154,136,225,249
16648,15538,7673,7865,3156,3113,4811,4458
16650,2036,1019,1017,502,453,616,465
16651,5813,3974,1839,843,2285,1701,984
16652,18028,10358,7670,3595,5497,5130,3806
16655,1601,791,810,385,389,472,355
16656,1297,631,666,336,274,405,282
16657,1343,692,651,328,252,412,351
16659,303,146,157,72,73,83,75
16661,951,485,466,239,215,286,211
16662,6040,2889,3151,1414,1246,1534,1846
16664,2104,1059,1045,682,471,565,386
16665,299,144,155,76,81,72,70
16666,2960,1477,1483,711,678,918,653
16667,1392,697,695,356,311,422,303
16668,3569,1783,1786,870,728,1112,859
16669,2351,1149,1202,606,520,703,522
16670,47,24,23,9,14,10,14
16671,505,250,255,116,100,173,116
16672,187,94,93,50,45,55,37
16673,5519,2705,2814,1338,1281,1610,1290
16674,736,351,385,202,148,208,178
16677,481,234,247,101,88,156,136
16678,2689,1303,1386,645,584,777,683
16679,844,427,417,190,159,286,209
16680,427,216,211,103,98,122,104
16682,117,60,57,28,23,39,27
16683,383,209,174,66,71,129,117
16685,249,125,124,66,50,77,56
16686,13488,6580,6908,3256,3027,4066,3139
16689,462,230,232,109,86,135,132
16691,314,164,150,62,56,98,98
16692,753,400,353,202,170,227,154
16693,4185,2124,2061,1059,1001,1200,925
16694,254,124,130,65,52,71,66
16695,1198,591,607,392,255,316,235
16699,1469,1468,1,2,805,600,62
16701,17980,8741,9239,4535,4317,5099,4029
16720,1392,720,672,295,247,410,440
16724,143,77,66,41,29,40,33
16725,166,80,86,44,31,58,33
16726,542,296,246,142,112,164,124
16727,211,103,108,57,43,59,52
16728,25,14,11,3,4,13,5
16729,761,377,384,197,144,248,172
16730,121,57,64,27,25,39,30
16731,2818,1381,1437,723,599,831,665
16732,293,143,150,52,60,102,79
16733,222,116,106,54,35,81,52
16734,287,152,135,65,59,84,79
16735,6309,3110,3199,1537,1268,1890,1614
16738,2679,2081,598,254,1271,812,342
16740,1032,522,510,272,208,288,264
16743,3942,1945,1997,1040,842,1135,925
16744,332,167,165,82,73,107,70
16745,611,320,291,165,134,173,139
16746,1265,644,621,286,242,414,323
16748,2997,1494,1503,777,624,811,785
16749,4319,2164,2155,1040,922,1245,1112
16750,417,207,210,109,85,139,84
16801,42812,22876,19936,6619,24174,6582,5437
16802,12764,6455,6309,8021,4733,9,1
16803,23685,12308,11377,3733,12326,4325,3301
16820,1217,620,597,377,276,333,231
16821,318,149,169,80,62,125,51
16822,2283,1151,1132,530,506,703,544
16823,26617,14163,12454,5588,7721,8108,5200
16825,240,124,116,61,44,84,51
16826,616,326,290,167,142,180,127
16827,3991,1920,2071,1012,828,1314,837
16828,4478,2201,2277,977,890,1419,1192
16829,666,340,326,159,142,188,177
16830,13695,6608,7087,3026,3113,3846,3710
16832,510,253,257,164,111,139,96
16833,5342,2615,2727,1225,1076,1619,1422
16834,299,157,142,73,56,94,76
16835,238,111,127,50,61,77,50
16836,1152,599,553,252,196,435,269
16837,186,91,95,52,41,57,36
16838,1821,914,907,437,394,531,459
16839,489,247,242,118,92,169,110
16840,510,248,262,105,101,142,162
16841,5934,3006,2928,1481,1329,1841,1283
16843,657,315,342,122,119,208,208
16844,2769,1409,1360,616,626,950,577
16845,1088,677,411,165,463,267,193
16847,335,157,178,95,93,83,64
16848,319,167,152,65,89,81,84
16849,331,165,166,75,56,119,81
16851,866,439,427,231,196,293,146
16852,371,200,171,137,82,88,64
16853,300,140,160,73,74,90,63
16854,947,458,489,258,218,249,222
16855,282,134,148,65,67,74,76
16858,3688,1840,1848,914,806,1148,820
16859,542,268,274,118,115,183,126
16860,451,242,209,89,87,161,114
16861,311,154,157,72,67,85,87
16863,718,368,350,163,120,252,183
16865,1839,903,936,437,365,636,401
16866,9881,5518,4363,1855,2627,3160,2239
16868,483,230,253,108,154,125,96
16870,7046,3589,3457,2051,1382,2588,1025
16871,46,27,19,4,4,10,28
16872,1551,729,822,645,321,328,257
16874,1371,686,685,351,285,434,301
16875,3945,1984,1961,1052,784,1291,818
16876,311,152,159,81,72,107,51
16877,1762,877,885,450,354,568,390
16878,1762,877,885,385,386,614,377
16879,532,272,260,150,122,153,107
16881,2232,1131,1101,544,499,684,505
16882,300,156,144,84,74,81,61
16901,10243,4923,5320,2298,2045,2975,2925
16911,332,164,168,67,64,115,86
16912,1776,901,875,469,403,468,436
16914,2347,1157,1190,630,480,686,551
16915,5929,2911,3018,1494,1192,1645,1598
16917,1437,732,705,379,285,439,334
16920,2006,969,1037,500,475,556,475
16921,475,231,244,75,83,149,168
16922,2002,993,1009,437,374,598,593
16923,1470,770,700,393,307,428,342
16925,3186,1627,1559,779,609,1002,796
16926,872,434,438,252,188,246,186
16927,651,344,307,164,133,214,140
16928,1387,717,670,373,308,366,340
16929,2320,1137,1183,532,470,734,584
16930,1300,647,653,359,264,373,304
16932,734,361,373,209,141,235,149
16933,7488,3523,3965,2069,2377,1671,1371
16935,1256,636,620,306,256,379,315
16936,2095,1078,1017,481,404,665,545
16937,172,87,85,47,32,54,39
16938,747,392,355,159,126,249,213
16939,295,148,147,74,76,80,65
16940,302,142,160,85,68,86,63
16941,69,32,37,13,7,27,22
16942,847,426,421,204,169,281,193
16943,549,280,269,113,95,166,175
16946,2484,1258,1226,598,568,748,570
16947,4818,2332,2486,1059,976,1379,1404
16948,1634,795,839,469,263,486,416
16950,3378,1658,1720,766,656,1029,927
17002,784,394,390,304,166,183,131
17003,11720,5645,6075,2846,3000,3225,2649
17004,5000,2382,2618,1667,1028,1054,1251
17005,368,177,191,87,76,117,88
17006,1052,536,516,329,206,283,234
17007,5591,2760,2831,1431,944,1945,1271
17009,2007,994,1013,501,495,563,448
17010,182,86,96,48,46,57,31
17011,34586,18261,16325,6814,9507,9837,8428
17013,34575,16572,18003,8349,9305,9018,7903
17015,20798,10273,10525,5000,3809,7055,4934
17016,799,297,502,83,89,102,525
17017,1755,879,876,410,366,526,453
17018,4313,2142,2171,916,895,1439,1063
17019,17721,8801,8920,4543,3863,5839,3476
17020,9047,4497,4550,2111,2134,2922,1880
17021,1088,585,503,271,252,300,265
17022,29602,14155,15447,7810,7442,7964,6386
17023,3535,1784,1751,952,794,998,791
17024,1893,935,958,541,403,620,329
17025,16778,8164,8614,4295,4352,5171,2960
17026,3616,1835,1781,990,772,1163,691
17027,2141,839,1302,729,1241,108,63
17028,3720,1933,1787,889,829,1273,729
17029,371,181,190,70,76,88,137
17030,832,410,422,204,190,213,225
17032,8192,4121,4071,2010,1767,2764,1651
17033,16972,8081,8891,5448,3847,4213,3464
17034,2414,1183,1231,466,721,723,504
17035,839,440,399,189,160,287,203
17036,21913,10570,11343,5826,4816,7094,4177
17037,1126,595,531,351,260,294,221
17038,8219,4163,4056,2201,2163,2394,1461
17039,37,19,18,8,8,17,4
17040,2787,1416,1371,765,559,867,596
17041,213,115,98,64,54,63,32
17042,37133,18200,18933,9006,8456,10753,8918
17043,5957,2940,3017,1249,1907,1645,1156
17044,21209,10272,10937,4835,4603,6243,5528
17045,3350,1681,1669,826,778,1042,704
17046,29790,14508,15282,8350,7176,8326,5938
17047,2526,1315,1211,848,580,631,467
17048,4046,2049,1997,1172,913,1089,872
17049,3360,1687,1673,906,743,958,753
17050,32815,15862,16953,8194,6938,10592,7091
17051,4653,2302,2351,1154,971,1382,1146
17052,1635,801,834,425,360,477,373
17053,5001,2456,2545,1096,1178,1654,1073
17055,34237,16326,17911,7907,7829,9940,8561
17056,128,61,67,23,32,47,26
17057,21329,10348,10981,5159,5218,6382,4570
17058,1909,931,978,527,469,477,436
17059,7579,3726,3853,1969,1622,2142,1846
17060,1334,691,643,396,320,328,290
17061,7157,3469,3688,1735,1579,2027,1816
17062,3979,2001,1978,1071,823,1271,814
17063,3311,1672,1639,881,708,929,793
17064,645,310,335,82,87,204,272
17065,4222,2082,2140,1134,1013,1296,779
17066,5348,2587,2761,1410,1207,1447,1284
17067,14232,6922,7310,3862,3095,3584,3691
17068,4298,2209,2089,1142,944,1241,971
17069,133,62,71,32,33,38,30
17070,15692,7657,8035,3637,3925,4793,3337
17071,108,61,47,21,25,38,24
17072,193,100,93,45,64,55,29
17073,5271,2669,2602,1617,1222,1425,1007
17074,7477,3660,3817,1964,1674,2346,1493
17075,123,51,72,34,25,31,33
17076,48,25,23,11,12,21,4
17077,46,17,29,17,17,8,4
17078,20218,9652,10566,4857,4321,6027,5013
17080,298,144,154,81,66,84,67
17081,352,179,173,86,94,89,83
17082,3588,1812,1776,974,784,1060,770
17083,109,50,59,23,31,29,26
17084,4340,2137,2203,1146,867,1263,1064
17086,2499,1236,1263,695,598,676,530
17087,2767,1384,1383,834,639,785,509
17088,823,403,420,210,198,202,213
17090,5216,2643,2573,1332,1254,1715,915
17093,801,393,408,248,163,215,175
17094,2392,1193,1199,610,564,651,567
17097,925,456,469,232,185,265,243
17098,2528,1238,1290,613,603,747,565
17099,1179,580,599,305,281,325,268
17101,2212,1292,920,99,858,641,614
17102,7628,4017,3611,1234,2901,2151,1342
17103,11848,5525,6323,3987,3202,3188,1471
17104,20962,9715,11247,7359,5973,5076,2554
17109,23131,10890,12241,5184,6635,6278,5034
17110,24433,11465,12968,6088,6405,7343,4597
17111,30714,15096,15618,7076,8197,9392,6049
17112,33850,16542,17308,7794,7432,11070,7554
17113,10749,5002,5747,3030,2682,2992,2045
17120,0,0,0,0,0,0,0
17201,25293,11810,13483,6385,6651,6042,6215
17202,30200,14888,15312,7831,6691,8916,6762
17210,193,101,92,44,36,57,56
17211,368,187,181,73,57,132,106
17212,702,367,335,183,142,208,169
17213,639,333,306,171,122,203,143
17214,1089,568,521,257,256,326,250
17215,347,169,178,107,84,91,65
17217,150,71,79,45,38,37,30
17219,405,203,202,124,80,117,84
17220,534,254,280,195,152,109,78
17221,637,314,323,162,146,197,132
17222,10749,5348,5401,2389,2068,2846,3446
17223,289,143,146,66,56,89,78
17224,1834,922,912,437,354,609,434
17225,18879,9356,9523,5377,4363,5587,3552
17228,1183,613,570,315,301,318,249
17229,1276,630,646,335,280,349,312
17233,5047,2513,2534,1257,1180,1440,1170
17235,672,338,334,184,182,175,131
17236,8895,4436,4459,2519,1938,2590,1848
17237,1917,947,970,723,484,427,283
17238,1794,921,873,464,382,552,396
17239,203,106,97,53,46,66,38
17240,3345,1700,1645,1050,770,950,575
17241,11853,5868,5985,3104,2631,3601,2517
17243,1329,672,657,315,292,401,321
17244,2407,1186,1221,665,555,673,514
17246,195,98,97,40,55,59,41
17247,366,125,241,0,0,1,365
17249,371,174,197,90,78,105,98
17250,68,38,30,14,19,23,12
17251,158,80,78,35,32,50,41
17252,3608,1818,1790,947,833,1099,729
17253,337,161,176,95,86,93,63
17254,89,49,40,16,27,23,23
17255,1125,568,557,272,226,366,261
17256,91,45,46,34,17,32,8
17257,27996,13765,14231,8255,9005,6221,4515
17260,1164,582,582,298,218,321,327
17261,193,130,63,55,9,34,95
17262,1462,722,740,496,322,366,278
17263,467,241,226,100,124,140,103
17264,2305,1185,1120,606,512,636,551
17265,496,255,241,107,107,163,119
17266,581,284,297,151,143,167,120
17267,2810,1413,1397,738,598,792,682
17268,28285,13765,14520,7363,6825,7952,6145
17270,115,62,53,34,28,35,18
17271,339,167,172,93,68,99,79
17272,294,138,156,69,86,75,64
17301,4053,2024,2029,1011,898,1297,847
17302,3083,1576,1507,888,681,1048,466
17304,3059,1572,1487,834,730,958,537
17306,318,165,153,100,77,85,56
17307,5899,2961,2938,1512,1356,1818,1213
17309,2086,1084,1002,522,421,662,481
17311,252,129,123,61,60,80,51
17313,10899,5312,5587,2843,2763,3042,2251
17314,5929,2985,2944,1704,1383,1923,919
17315,25756,12768,12988,6388,6099,8019,5250
17316,8266,4139,4127,2275,1742,2690,1559
17317,755,365,390,258,194,204,99
17318,344,163,181,85,94,107,58
17319,10417,5142,5275,2903,2596,3453,1465
17320,7823,3863,3960,1945,1551,2614,1713
17321,2238,1125,1113,594,443,778,423
17322,6012,3034,2978,1555,1290,2167,1000
17324,4219,2118,2101,954,905,1484,876
17325,27619,13392,14227,6439,7030,7393,6757
17327,7565,3779,3786,1794,1555,2597,1619
17329,2494,1260,1234,585,491,898,520
17331,50292,24547,25745,12443,11811,14791,11247
17339,6940,3512,3428,1715,1386,2553,1286
17340,10896,5422,5474,2985,2376,3377,2158
17343,180,88,92,44,38,57,41
17344,3656,1676,1980,989,948,922,797
17345,7679,3826,3853,1930,1954,2328,1467
17347,6202,3085,3117,1819,1578,1795,1010
17349,7570,3713,3857,1954,1418,2594,1604
17350,12886,6271,6615,3343,2785,3681,3077
17352,1292,653,639,360,259,445,228
17353,3228,1646,1582,732,667,1148,681
17355,261,135,126,74,57,90,40
17356,21610,10676,10934,5719,5188,6469,4234
17360,5927,2984,2943,1537,1252,2035,1103
17361,5806,2743,3063,1356,1078,1714,1658
17362,13397,6801,6596,3393,2897,4417,2690
17363,9413,4724,4689,2556,1808,3228,1821
17364,3907,2004,1903,1076,821,1318,692
17365,2510,1267,1243,539,502,894,575
17366,5499,2738,2761,1498,1410,1709,882
17368,7322,3636,3686,1800,1718,2442,1362
17370,5683,2870,2813,1670,1438,1789,786
17371,257,140,117,74,54,79,50
17372,4101,2103,1998,1131,991,1256,723
17401,17687,8607,9080,6044,5528,4127,1988
17402,36360,18325,18035,8097,9083,10496,8684
17403,39042,18789,20253,10999,10133,9969,7941
17404,35517,17081,18436,10173,9114,10030,6200
17406,22156,10887,11269,5307,5342,6792,4715
17407,2355,1181,1174,675,561,647,472
17408,22507,10885,11622,5200,4974,6784,5549
17501,4307,2071,2236,989,1002,1259,1057
17502,2464,1261,1203,669,605,810,380
17505,1785,881,904,742,426,325,292
17507,62,28,34,8,16,24,14
17508,423,206,217,123,66,142,92
17509,4664,2270,2394,1762,1050,1057,795
17512,17836,8584,9252,4604,4311,5225,3696
17516,4496,2315,2181,1179,925,1536,856
17517,15391,7625,7766,4489,3478,4423,3001
17518,1355,698,657,473,312,354,216
17519,6824,3418,3406,2326,1611,1735,1152
17520,4686,2274,2412,1225,1121,1379,961
17522,32483,15792,16691,8895,8263,8545,6780
17527,6080,3048,3032,2184,1418,1485,993
17529,4317,2157,2160,1635,958,853,871
17532,3381,1722,1659,991,732,1124,534
17535,2458,1254,1204,968,585,560,345
17536,2839,1448,1391,1026,643,685,485
17538,6045,3006,3039,1565,1130,2066,1284
17540,9791,4846,4945,3123,2300,2567,1801
17543,42626,20501,22125,11622,8840,12579,9585
17545,21256,10663,10593,5447,4597,6040,5172
17547,7378,3733,3645,2034,2290,2085,969
17550,790,362,428,199,138,228,225
17551,10857,5124,5733,3089,3911,2003,1854
17552,17831,8769,9062,4447,4607,5308,3469
17554,7525,3597,3928,1851,2077,2201,1396
17555,7525,3760,3765,2684,1590,1955,1296
17557,13811,6696,7115,3958,2811,3427,3615
17560,5118,2527,2591,1387,1028,1584,1119
17562,4464,2287,2177,1716,1074,989,685
17563,3849,1940,1909,1309,862,1026,652
17565,2537,1289,1248,685,516,923,413
17566,12019,5873,6146,3912,2743,2992,2372
17569,5448,2733,2715,1633,1234,1720,861
17570,291,130,161,82,73,87,49
17572,3859,1936,1923,1394,892,778,795
17576,129,66,63,28,19,33,49
17578,7485,3717,3768,2282,1621,2264,1318
17579,5935,2941,2994,1829,1308,1697,1101
17581,951,482,469,265,230,271,185
17582,2026,1026,1000,490,428,687,421
17584,8957,4268,4689,2070,1486,2496,2905
17601,49779,23928,25851,12314,10468,14542,12455
17602,52452,25840,26612,14718,14733,13501,9500
17603,61973,29934,32039,15872,18624,15949,11528
17606,392,108,284,0,0,0,392
17701,44661,22321,22340,11557,12484,11395,9225
17702,10721,5273,5448,2584,2499,3163,2475
17721,1604,772,832,385,349,461,409
17723,34,16,18,7,7,7,13
17724,5424,2666,2758,1471,1166,1478,1309
17727,72,41,31,5,5,31,31
17728,5120,2614,2506,1141,973,1794,1212
17729,159,86,73,18,12,56,73
17730,257,128,129,66,64,68,59
17731,185,93,92,21,21,49,94
17737,6220,3051,3169,1505,1335,1930,1450
17739,32,14,18,3,2,8,19
17740,12754,6281,6473,3359,2835,3855,2705
17742,39,16,23,5,9,11,14
17744,3175,1613,1562,738,603,1112,722
17745,19063,9209,9854,4850,6012,4382,3819
17747,3073,1578,1495,1009,703,807,554
17748,300,138,162,57,55,90,98
17749,244,126,118,66,61,76,41
17750,167,80,87,51,38,38,40
17751,7084,3474,3610,1904,1505,1990,1685
17752,4635,2259,2376,1252,1082,1361,940
17754,12233,5925,6308,2689,2358,3644,3542
17756,12408,5371,7037,2596,3162,3933,2717
17758,919,456,463,193,177,281,268
17760,557,282,275,111,97,179,170
17762,503,245,258,124,117,156,106
17763,309,148,161,88,60,93,68
17764,2327,1129,1198,535,430,677,685
17765,1162,591,571,273,252,389,248
17767,91,42,49,26,24,28,13
17768,377,200,177,59,68,114,136
17771,3158,1612,1546,738,588,1081,751
17772,2399,1192,1207,678,483,698,540
17774,1277,655,622,296,296,381,304
17776,295,152,143,51,35,89,120
17777,7056,3437,3619,1718,1495,2045,1798
17778,102,59,43,11,7,40,44
17779,235,115,120,46,43,62,84
17801,16671,8124,8547,3930,3920,4996,3825
17810,4683,3594,1089,586,2002,1576,519
17812,1480,744,736,377,341,400,362
17813,1979,992,987,521,471,534,453
17814,4860,2520,2340,1182,981,1494,1203
17815,30967,14611,16356,8113,9933,7258,5663
17820,5556,2720,2836,1302,1178,1717,1359
17821,18219,8726,9493,4158,3972,5456,4633
17822,0,0,0,0,0,0,0
17823,1273,648,625,335,268,365,305
17824,4115,1985,2130,906,800,1296,1113
17827,657,307,350,137,162,193,165
17829,244,121,123,85,37,72,50
17830,1947,990,957,465,416,570,496
17832,628,309,319,113,141,206,168
17834,3565,1725,1840,718,717,1054,1076
17835,219,100,119,55,61,60,43
17836,266,136,130,67,52,73,74
17837,19815,10285,9530,4768,6239,4581,4227
17840,533,269,264,130,116,178,109
17841,4779,2425,2354,1252,1058,1422,1047
17842,8910,4477,4433,2317,2049,2738,1806
17844,10042,5003,5039,2851,2270,2838,2083
17845,2245,1110,1135,616,495,630,504
17846,3738,1824,1914,878,748,1212,900
17847,12051,5928,6123,2869,2683,3477,3022
17850,645,336,309,163,152,221,109
17851,7841,3776,4065,1662,1738,2213,2228
17853,3221,1651,1570,969,786,863,603
17855,992,482,510,254,222,297,219
17856,3365,1655,1710,760,731,1104,770
17857,7505,3627,3878,1514,1680,2194,2117
17859,3106,1528,1578,651,576,974,905
17860,1994,1033,961,453,360,707,474
17861,143,70,73,34,32,45,32
17862,577,273,304,198,168,116,95
17864,2445,1237,1208,848,553,626,418
17865,92,51,41,23,18,35,16
17866,10310,6075,4235,1883,2992,2999,2436
17867,169,78,91,38,42,40,49
17868,1052,507,545,262,176,327,287
17870,14564,7015,7549,3728,3903,3823,3110
17872,9943,4771,5172,2508,2306,2746,2383
17876,1698,788,910,316,348,441,593
17878,1528,741,787,364,280,467,417
17880,72,37,35,24,22,18,8
17881,1556,755,801,385,391,424,356
17884,305,152,153,77,91,91,46
17885,141,78,63,31,21,43,46
17886,895,442,453,244,234,229,188
17887,1778,1564,214,89,783,719,187
17888,326,175,151,74,66,96,90
17889,2735,1398,1337,728,498,917,592
17901,23990,11582,12408,5452,5382,7165,5991
17920,331,159,172,55,66,108,102
17921,7676,4499,3177,1256,2266,2494,1660
17922,4783,2425,2358,1168,989,1617,1009
17923,433,220,213,81,93,144,115
17925,376,187,189,76,86,96,118
17929,1606,793,813,428,413,454,311
17930,476,230,246,127,120,135,94
17931,8472,5810,2662,1080,3178,2604,1610
17933,89,42,47,27,16,34,12
17934,469,234,235,106,96,138,129
17935,1737,859,878,404,383,513,437
17936,763,374,389,174,200,216,173
17938,2442,1245,1197,574,551,763,554
17941,834,432,402,196,177,241,220
17943,229,111,118,37,52,73,67
17944,205,112,93,46,50,64,45
17945,180,87,93,38,31,64,47
17946,263,140,123,47,58,77,81
17948,5029,2396,2633,1231,1127,1400,1271
17949,263,137,126,60,53,88,62
17951,325,158,167,74,67,102,82
17952,282,138,144,46,68,67,101
17953,469,232,237,95,99,146,129
17954,4564,2184,2380,1146,1141,1193,1084
17957,328,171,157,74,81,93,80
17959,1422,705,717,291,321,425,385
17960,3868,1974,1894,849,735,1274,1010
17961,6958,3324,3634,1530,1294,2178,1956
17963,9317,4680,4637,2206,2056,2790,2265
17964,798,383,415,170,171,237,220
17965,2067,1006,1061,494,510,577,486
17967,2457,1232,1225,512,488,826,631
17968,329,162,167,82,78,95,74
17970,3241,1571,1670,680,760,925,876
17972,11627,5626,6001,3008,2478,3505,2636
17974,344,166,178,67,63,90,124
17976,6937,3345,3592,1691,1531,1899,1816
17978,224,108,116,47,41,78,58
17979,168,77,91,25,32,61,50
17980,3238,1621,1617,750,735,941,812
17981,2751,1386,1365,616,641,777,717
17982,430,208,222,80,77,131,142
17983,1620,802,818,343,347,479,451
17985,1226,637,589,264,249,439,274
18011,5450,2676,2774,1456,1468,1728,798
18013,17802,8785,9017,4458,3848,5753,3743
18014,11387,5667,5720,2515,2230,3728,2914
18015,32832,16765,16067,9444,10796,7769,4823
18016,0,0,0,0,0,0,0
18017,37549,17662,19887,9073,7724,10834,9918
18018,32413,15268,17145,7071,9341,8279,7722
18020,20447,9908,10539,5187,3899,6802,4559
18030,623,314,309,141,141,193,148
18031,7528,3699,3829,2043,2251,1988,1246
18032,9285,4511,4774,2236,2497,2765,1787
18034,8256,4030,4226,2519,1924,2418,1395
18035,241,122,119,46,40,93,62
18036,12822,6430,6392,3088,2240,4506,2988
18037,7070,3432,3638,1659,1475,2416,1520
18038,3091,1568,1523,752,591,1104,644
18040,15742,7606,8136,4334,3267,4898,3243
18041,5424,2708,2716,1469,1370,1719,866
18042,41570,20680,20890,11349,12244,11286,6691
18045,26391,12695,13696,6212,5142,8045,6992
18046,64,31,33,22,12,24,6
18049,17341,8432,8909,3987,3979,5404,3971
18051,3327,1652,1675,907,602,1198,620
18052,26902,12796,14106,6307,6564,7720,6311
18053,2375,1196,1179,660,517,785,413
18054,4278,2136,2142,972,811,1506,989
18055,11780,5681,6099,2624,2598,3529,3029
18056,943,466,477,182,166,331,264
18058,9464,4754,4710,2465,1892,3125,1982
18059,1228,603,625,347,210,495,176
18062,24351,11777,12574,6651,5236,7026,5438
18063,548,260,288,90,128,169,161
18064,24073,11559,12514,5997,4593,7911,5572
18066,6005,3041,2964,1520,1235,2140,1110
18067,17852,8749,9103,4101,4106,5455,4190
18068,42,20,22,11,16,13,2
18069,8017,4039,3978,2389,1407,2800,1421
18070,739,381,358,169,161,239,170
18071,10578,5217,5361,2494,2513,3318,2253
18072,6571,3135,3436,1692,1536,2009,1334
18073,9350,4745,4605,2665,2110,2686,1889
18074,5775,2912,2863,1429,1261,1990,1095
18076,2662,1256,1406,577,621,664,800
18077,2370,1234,1136,493,385,891,601
18078,7074,3468,3606,1857,1201,2508,1508
18079,436,217,219,113,102,132,89
18080,11456,5692,5764,2692,2447,3908,2409
18081,357,188,169,86,68,112,91
18083,530,259,271,137,157,146,90
18085,1119,562,557,307,242,346,224
18086,398,204,194,84,69,122,123
18087,738,376,362,153,226,207,152
18088,8375,4128,4247,1779,1646,2838,2112
18091,5926,2953,2973,1407,1279,1904,1336
18092,3223,1637,1586,725,563,1218,717
18101,3897,1953,1944,1339,1165,902,491
18102,49779,24489,25290,17273,14727,11748,6031
18103,45336,21919,23417,11615,11466,12713,9542
18104,43236,20195,23041,10106,10066,12302,10762
18105,12,6,6,0,0,1,11
18106,6889,3300,3589,1741,1384,2151,1613
18109,16932,8158,8774,4497,4736,4418,3281
18195,0,0,0,0,0,0,0
18201,27516,13332,14184,7636,6636,7287,5957
18202,12083,5885,6198,3204,2539,3215,3125
18210,8258,4143,4115,2194,1629,2616,1819
18211,1304,657,647,274,246,475,309
18212,131,66,65,18,25,51,37
18214,2078,1066,1012,419,396,703,560
18216,1067,508,559,254,225,314,274
18218,2281,1113,1168,572,538,634,537
18219,1436,688,748,262,284,447,443
18220,344,186,158,72,73,116,83
18221,389,199,190,90,67,115,117
18222,9020,4510,4510,2179,1978,2772,2091
18223,115,61,54,13,23,41,38
18224,6017,2947,3070,1430,1398,1702,1487
18225,114,54,60,34,24,24,32
18229,8498,4217,4281,1959,1706,2831,2002
18230,132,65,67,31,34,41,26
18231,535,261,274,130,126,136,143
18232,3941,1884,2057,989,944,1059,949
18234,401,175,226,77,98,114,112
18235,19353,9460,9893,4323,4171,6147,4712
18237,3110,1534,1576,716,723,866,805
18239,232,123,109,35,43,84,70
18240,3891,1971,1920,771,846,1147,1127
18241,646,322,324,135,158,198,155
18242,235,119,116,46,64,71,54
18244,402,225,177,93,83,121,105
18245,348,172,176,64,72,114,98
18246,143,68,75,30,34,41,38
18248,631,317,314,139,123,223,146
18249,4129,2068,2061,947,715,1403,1064
18250,3034,1501,1533,690,691,917,736
18251,46,22,24,10,12,12,12
18252,11188,5447,5741,2580,2499,3189,2920
18254,871,436,435,172,155,289,255
18255,4337,2060,2277,914,812,1350,1261
18256,359,185,174,66,77,119,97
18301,28561,13682,14879,8384,7531,7855,4791
18302,17362,8741,8621,5001,3805,5943,2613
18321,1711,869,842,418,341,594,358
18322,2781,1347,1434,703,504,897,677
18323,275,138,137,55,27,101,92
18324,9714,4791,4923,3033,2024,3155,1502
18325,2465,1246,1219,535,476,855,599
18326,4152,2007,2145,982,798,1399,973
18327,700,363,337,134,197,229,140
18328,7759,3932,3827,2063,1695,2586,1415
18330,8927,4461,4466,2642,1870,3057,1358
18331,867,443,424,211,195,275,186
18332,3085,1534,1551,886,753,986,460
18333,712,344,368,184,145,202,181
18334,4156,2097,2059,1234,895,1330,697
18335,672,333,339,182,147,212,131
18336,4082,1918,2164,996,827,1221,1038
18337,14572,7228,7344,4036,2675,4991,2870
18340,174,88,86,50,24,64,36
18342,492,234,258,103,111,131,147
18343,3982,1971,2011,949,770,1361,902
18344,3589,1739,1850,994,821,1030,744
18346,2964,1511,1453,889,655,921,499
18347,3364,1705,1659,658,515,1138,1053
18349,132,64,68,28,17,50,37
18350,1931,970,961,337,295,596,703
18351,518,261,257,114,116,185,103
18352,1098,546,552,258,221,367,252
18353,12779,6417,6362,3355,2499,4599,2326
18354,951,471,480,235,201,293,222
18355,1492,766,726,363,350,487,292
18356,136,68,68,26,30,37,43
18357,104,53,51,9,19,42,34
18360,28362,13910,14452,7048,6313,9054,5947
18370,1096,558,538,258,199,387,252
18371,747,389,358,244,162,206,135
18372,3210,1613,1597,874,730,1057,549
18403,7087,3432,3655,1776,1544,2163,1604
18405,2561,1277,1284,620,544,764,633
18407,13862,6657,7205,3376,3225,3795,3466
18411,21985,10598,11387,5375,4351,6865,5394
18413,151,67,84,36,27,58,30
18414,5452,2703,2749,1311,1068,1789,1284
18415,1245,632,613,249,168,398,430
18417,1121,581,540,220,193,359,349
18419,4634,2310,2324,1154,1145,1412,923
18420,57,29,28,20,14,17,6
18421,4754,2312,2442,1136,996,1411,1211
18424,5613,2859,2754,1260,984,1935,1434
18425,1354,685,669,351,247,444,312
18426,4526,2244,2282,1056,697,1432,1341
18427,118,66,52,24,29,37,28
18428,12012,6157,5855,2488,2166,3591,3767
18430,33,20,13,9,5,11,8
18431,12666,6101,6565,2981,2620,3774,3291
18433,6508,3218,3290,1520,1430,2024,1534
18434,4192,1969,2223,935,1035,1187,1035
18435,795,405,390,174,135,260,226
18436,13853,6913,6940,3016,2365,4426,4046
18437,211,99,112,44,34,70,63
18438,1172,567,605,206,155,349,462
18439,500,251,249,94,90,167,149
18441,289,150,139,62,65,101,61
18443,458,242,216,100,68,158,132
18444,13778,6820,6958,3363,2718,4494,3203
18445,2329,1184,1145,487,435,812,595
18446,3733,1894,1839,938,808,1149,838
18447,10548,5025,5523,2128,2456,3165,2799
18451,448,228,220,85,59,167,137
18452,4802,2216,2586,986,981,1331,1504
18453,1104,562,542,219,182,375,328
18454,64,35,29,7,13,22,22
18455,105,49,56,31,25,26,23
18456,423,209,214,99,88,114,122
18457,82,45,37,26,14,20,22
18458,3017,1550,1467,714,522,1056,725
18459,51,25,26,6,5,18,22
18460,184,93,91,45,29,54,56
18461,404,215,189,76,79,124,125
18462,427,217,210,105,75,126,121
18463,199,94,105,41,45,63,50
18464,1193,580,613,264,151,426,352
18465,1340,676,664,264,260,415,401
18466,16681,8094,8587,5503,3802,5064,2312
18469,357,174,183,91,63,119,84
18470,2226,1148,1078,463,426,757,580
18471,685,323,362,195,90,236,164
18472,7521,5242,2279,1075,2453,2614,1379
18473,495,257,238,135,79,161,120
18503,1182,713,469,174,227,198,583
18504,21265,10121,11144,5321,5246,6165,4533
18505,20586,9972,10614,5174,5388,5369,4655
18507,4891,2364,2527,1019,1056,1455,1361
18508,12292,5837,6455,3042,3170,3136,2944
18509,13589,6517,7072,3162,4119,3434,2874
18510,14119,6587,7532,3621,4783,2947,2768
18512,12218,5758,6460,2532,2962,3458,3266
18517,5274,2506,2768,1171,1121,1536,1446
18518,8313,3916,4397,1692,1876,2464,2281
18519,5104,2447,2657,1120,1365,1427,1192
18602,257,126,131,51,22,80,104
18603,19320,9226,10094,4526,4201,5614,4979
18610,5008,2503,2505,1403,1016,1708,881
18612,18051,9542,8509,3849,4419,5470,4313
18614,2426,1222,1204,436,407,821,762
18615,1867,923,944,404,316,661,486
18616,738,374,364,122,122,218,276
18617,1924,936,988,539,487,511,387
18618,3793,1889,1904,817,811,1278,887
18619,273,133,140,50,62,72,89
18621,6248,3707,2541,1183,1756,2071,1238
18622,257,137,120,55,48,82,72
18623,2733,1351,1382,703,613,794,623
18624,718,380,338,111,107,237,263
18625,491,231,260,83,85,146,177
18626,516,245,271,67,42,168,239
18628,192,95,97,30,24,60,78
18629,1801,920,881,440,386,572,403
18630,3556,1812,1744,982,860,1015,699
18631,1286,619,667,275,249,396,366
18632,409,194,215,88,112,99,110
18634,13569,6467,7102,2879,3261,3750,3679
18635,3881,1922,1959,920,906,1204,851
18636,1438,711,727,356,299,453,330
18640,17155,8138,9017,3701,3881,4996,4577
18641,6812,3338,3474,1495,1555,2041,1721
18642,4345,2084,2261,914,1029,1293,1109
18643,12908,6145,6763,2785,2882,3812,3429
18644,7546,3577,3969,1595,1545,2377,2029
18651,8880,4256,4624,2189,2184,2489,2018
18653,132,64,68,35,33,42,22
18655,6278,3127,3151,1437,1297,1973,1571
18656,2195,1113,1082,558,475,731,431
18657,11985,6041,5944,2875,2574,3597,2939
18660,3702,1868,1834,824,803,1260,815
18661,5730,2919,2811,1157,1083,2002,1488
18701,3447,1669,1778,972,1420,289,766
18702,40295,19765,20530,9514,10746,10949,9086
18704,31206,14708,16498,6976,7491,8847,7892
18705,14806,7125,7681,3131,3565,4145,3965
18706,16105,7653,8452,3610,3868,4668,3959
18707,15557,7568,7989,4025,2960,5150,3422
18708,8817,4321,4496,2155,1617,3015,2030
18709,2903,1401,1502,558,738,872,735
18801,8266,4122,4144,1994,1555,2524,2193
18810,6162,2962,3200,1582,1332,1848,1400
18812,1644,858,786,361,267,598,418
18814,156,80,76,45,35,48,28
18816,128,62,66,37,18,45,28
18817,306,158,148,82,66,90,68
18818,1394,744,650,308,271,464,351
18821,1153,545,608,252,238,350,313
18822,3642,1836,1806,898,750,1103,891
18823,193,95,98,36,40,46,71
18824,1401,708,693,301,305,453,342
18825,111,57,54,19,18,36,38
18826,1910,978,932,457,354,580,519
18828,352,185,167,83,79,112,78
18829,868,446,422,253,195,234,186
18830,735,366,369,152,110,257,216
18831,1039,516,523,223,184,381,251
18832,1874,935,939,503,394,583,394
18833,2056,1057,999,510,395,650,501
18834,3691,1865,1826,870,726,1214,881
18837,3267,1639,1628,903,674,955,735
18840,10731,5110,5621,2564,2273,3199,2695
18842,278,143,135,66,51,98,63
18843,277,132,145,66,70,74,67
18844,1870,930,940,473,387,599,411
18845,297,157,140,63,40,96,98
18846,847,438,409,203,156,260,228
18847,6024,3000,3024,1472,1197,1877,1478
18848,9193,4575,4618,2163,1837,2832,2361
18850,2357,1176,1181,634,489,719,515
18851,706,373,333,171,111,224,200
18853,4252,2075,2177,1072,896,1226,1058
18854,1510,749,761,376,351,457,326
18901,27598,13299,14299,6233,5893,8307,7165
18902,20973,10424,10549,6718,3228,7818,3209
18912,39,27,12,5,13,15,6
18913,185,92,93,17,28,67,73
18914,21063,10360,10703,6390,4123,7206,3344
18915,1063,536,527,277,238,353,195
18917,2158,1091,1067,564,633,659,302
18920,361,196,165,65,44,142,110
18923,998,490,508,320,288,296,94
18925,6195,3031,3164,1925,1207,2035,1028
18929,9306,4552,4754,3033,1660,3462,1151
18930,2721,1390,1331,616,420,1052,633
18932,388,193,195,95,74,125,94
18935,116,61,55,20,26,42,28
18936,4,2,2,0,0,2,2
18938,13989,7024,6965,2949,1789,5041,4210
18940,28825,13894,14931,7777,5221,10413,5414
18942,3260,1669,1591,710,571,1204,775
18944,24479,12059,12420,6871,5460,8135,4013
18947,6172,3134,3038,1766,1022,2324,1060
18950,252,131,121,78,28,72,74
18951,34651,17223,17428,9097,8374,10756,6424
18954,9745,4807,4938,2665,1502,3422,2156
18955,1662,783,879,380,419,474,389
18960,12473,6168,6305,3133,2695,3982,2663
18962,515,252,263,110,108,187,110
18964,13812,6687,7125,3393,3201,3840,3378
18966,37999,18270,19729,9171,7032,12443,9353
18969,15273,7470,7803,4043,3477,4600,3153
18970,696,366,330,173,185,218,120
18972,3512,1790,1722,676,579,1344,913
18974,40953,19793,21160,9281,8564,11500,11608
18976,19795,9713,10082,5354,4033,6205,4203
18977,4291,2091,2200,984,503,1505,1299
18980,510,249,261,129,81,192,108
19001,17020,8196,8824,4457,4095,5220,3248
19002,32412,15540,16872,8755,5960,10541,7156
19003,12519,5854,6665,2838,3743,3526,2412
19004,9416,4551,4865,2461,1833,2746,2376
19006,21423,10198,11225,5068,3726,6685,5944
19007,21125,10370,10755,5333,5754,6021,4017
19008,20535,9851,10684,4717,3808,6447,5563
19009,864,412,452,241,242,211,170
19010,21103,9251,11852,5878,5402,5169,4654
19012,6670,3218,3452,1841,1444,2210,1175
19013,35130,16521,18609,11290,10048,8382,5410
19014,21206,10131,11075,5458,5331,6261,4156
19015,16632,7759,8873,4484,4375,4604,3169
19017,348,155,193,114,53,120,61
19018,23360,11257,12103,5381,6941,6589,4449
19020,55493,27460,28033,12622,15495,16254,11122
19021,10074,5050,5024,2490,2688,3243,1653
19022,3669,1805,1864,1065,959,1103,542
19023,22164,10298,11866,7682,6161,5511,2810
19025,5395,2606,2789,1465,805,1885,1240
19026,30738,14820,15918,7721,8731,8722,5564
19027,19067,8782,10285,4588,4453,5515,4511
19029,3971,2010,1961,896,985,1264,826
19030,12122,5830,6292,2856,2907,3856,2503
19031,4700,2075,2625,1164,784,1383,1369
19032,6606,3214,3392,1822,1898,1776,1110
19033,7777,3783,3994,1813,1935,2431,1598
19034,5999,2950,3049,1585,984,2010,1420
19035,3780,1761,2019,970,407,1149,1254
19036,12942,6191,6751,3148,3651,3636,2507
19038,31595,14831,16764,8013,7772,9417,6393
19040,20536,9895,10641,4845,4726,6276,4689
19041,6248,2830,3418,1498,1307,1507,1936
19043,2664,1295,1369,690,680,827,467
19044,15853,7722,8131,3953,4381,5227,2292
19046,17809,8296,9513,4080,3442,5470,4817
19047,35056,17074,17982,8169,8125,11282,7480
19050,28073,13005,15068,7286,7346,8468,4973
19053,25966,12804,13162,6059,6077,8598,5232
19054,17437,8570,8867,4522,4494,5324,3097
19055,13924,6931,6993,3593,3598,4246,2487
19056,15486,7628,7858,4010,3991,4749,2736
19057,17191,8478,8713,4335,4586,5297,2973
19060,11368,5593,5775,3479,1769,3960,2160
19061,19997,9594,10403,5191,5098,5859,3849
19063,35704,16958,18746,7665,7237,10908,9894
19064,24459,11791,12668,6124,5019,7514,5802
19066,5864,2777,3087,2010,925,1629,1300
19067,51334,24822,26512,13386,10748,17294,9906
19070,7277,3513,3764,1802,1774,2344,1357
19072,9539,4511,5028,2493,1723,3103,2220
19073,18332,8675,9657,4057,2927,5692,5656
19074,5890,2900,2990,1457,1535,1874,1024
19075,7354,3579,3775,1972,1579,2327,1476
19076,6525,3259,3266,1623,1778,1981,1143
19078,11067,5335,5732,2503,2732,3475,2357
19079,9168,4142,5026,2855,2323,2500,1490
19081,10337,4926,5411,2894,2542,2854,2047
19082,40997,19788,21209,12249,12782,11099,4867
19083,35878,17279,18599,9698,8189,11177,6814
19085,8932,4282,4650,2974,2739,1847,1372
19086,11420,5438,5982,2916,2065,3694,2745
19087,32225,15377,16848,9147,6807,9744,6527
19090,18832,9086,9746,4570,4789,5546,3927
19094,4406,2077,2329,1169,1149,1252,836
19095,7063,3106,3957,1386,1686,1790,2201
19096,13572,6325,7247,3375,2383,4034,3780
19102,4705,2165,2540,439,3017,594,655
19103,21908,10226,11682,1271,11442,3775,5420
19104,51808,25385,26423,14446,25634,6887,4841
19106,11740,6188,5552,677,5599,2882,2582
19107,14875,7664,7211,1622,8751,2807,1695
19109,0,0,0,0,0,0,0
19111,63090,30040,33050,16927,17832,16825,11506
19112,13,9,4,4,2,6,1
19113,120,70,50,31,27,40,22
19114,30907,14746,16161,6407,8233,8460,7807
19115,33207,15572,17635,6473,7644,9201,9889
19116,33112,15916,17196,6921,8510,9480,8201
19118,9808,4298,5510,2023,2689,2632,2464
19119,27035,11751,15284,5959,6546,8075,6455
19120,68104,31758,36346,23205,19791,18221,6887
19121,36572,16566,20006,11934,12229,7872,4537
19122,21653,9941,11712,8191,7070,3747,2645
19123,13416,6900,6516,2343,6128,2943,2002
19124,66691,31523,35168,23742,19704,16197,7048
19125,22958,11537,11421,5129,9057,5574,3198
19126,15758,7132,8626,4050,3818,4475,3415
19127,5913,3050,2863,410,4102,852,549
19128,35239,16930,18309,5558,14462,8559,6660
19129,10975,4976,5999,2432,4385,2413,1745
19130,24870,11961,12909,2867,12545,5297,4161
19131,43172,18922,24250,10727,12519,10395,9531
19132,36268,16522,19746,10341,9212,10445,6270
19133,26063,12317,13746,9218,7102,6486,3257
19134,60675,29619,31056,21368,18528,14206,6573
19135,33091,16073,17018,10131,9893,8419,4648
19136,40647,22857,17790,9277,14666,10606,6098
19137,8638,4237,4401,2293,2418,2441,1486
19138,32273,14142,18131,9262,8027,8431,6553
19139,41271,18224,23047,12183,11066,10707,7315
19140,54133,25301,28832,17736,14606,13945,7846
19141,31376,14000,17376,8956,8436,8190,5794
19142,29595,13939,15656,10754,8714,7287,2840
19143,64849,29217,35632,17809,18649,16419,11972
19144,43329,19392,23937,11230,12652,11628,7819
19145,47261,21931,25330,12527,13471,12278,8985
19146,35113,16877,18236,7303,14237,8441,5132
19147,36228,18135,18093,5561,16357,8593,5717
19148,49732,24281,25451,11116,16419,12659,9538
19149,55006,26368,28638,17115,16608,14047,7236
19150,23378,10071,13307,5324,5291,6551,6212
19151,29883,13416,16467,8705,7987,8729,4462
19152,33293,15558,17735,7192,8178,8845,9078
19153,12259,5609,6650,3237,3361,3271,2390
19154,34196,16609,17587,8442,9213,9215,7326
19301,6402,2998,3404,1564,1249,1976,1613
19310,3066,1530,1536,1088,704,842,432
19311,8584,4464,4120,2816,2055,2564,1149
19312,11539,5519,6020,3349,1483,4014,2693
19316,186,90,96,42,37,70,37
19317,9530,4651,4879,2499,1593,3304,2134
19319,1130,565,565,462,567,66,35
19320,52342,26044,26298,14427,13606,15071,9238
19330,5421,2683,2738,1549,1117,1798,957
19333,6895,3202,3693,1679,1722,1971,1523
19335,46984,23106,23878,13468,10616,15722,7178
19341,16709,8261,8448,4541,4180,5260,2728
19342,18099,8936,9163,4883,2785,5460,4971
19343,8142,4112,4030,2491,1405,2988,1258
19344,11919,5714,6205,3480,2492,3415,2532
19345,689,137,552,221,228,17,223
19348,22232,11039,11193,6135,4686,6654,4757
19350,10921,5582,5339,3223,1733,4155,1810
19352,10622,5177,5445,3887,2577,3202,956
19355,24760,12160,12600,6829,4934,8245,4752
19358,526,270,256,181,140,138,67
19362,5815,2943,2872,1749,1235,1811,1020
19363,17055,8519,8536,5576,4069,4783,2627
19365,7006,3413,3593,2080,1664,2053,1209
19367,171,84,87,36,44,63,28
19372,1360,653,707,341,418,393,208
19373,4273,2757,1516,994,1425,1425,429
19374,1252,746,506,397,436,294,125
19375,104,53,51,28,19,38,19
19380,49534,24091,25443,12222,11886,14540,10886
19382,52388,25719,26669,12528,15604,14867,9389
19383,3169,1278,1891,2266,901,2,0
19390,13425,6584,6841,3907,2882,3758,2878
19401,41753,20579,21174,11125,13644,10142,6842
19403,44260,22339,21921,9476,11407,13705,9672
19405,5127,2559,2568,1186,1733,1363,845
19406,23441,11694,11747,4928,7542,6167,4804
19422,18506,8797,9709,4442,3469,5857,4738
19425,13922,6931,6991,4614,2912,4663,1733
19426,38831,20952,17879,11509,9816,12581,4925
19428,16580,8293,8287,2852,6747,4215,2766
19435,100,45,55,27,14,28,31
19436,640,234,406,70,26,77,467
19437,757,371,386,192,71,290,204
19438,23765,11481,12284,6595,4898,7926,4346
19440,18038,9025,9013,4409,4460,5606,3563
19442,45,27,18,17,7,13,8
19444,10519,4942,5577,2521,2011,3249,2738
19446,55138,26367,28771,13196,13006,16448,12488
19453,1483,705,778,282,436,497,268
19454,27870,13340,14530,6829,6521,8823,5697
19456,737,364,373,202,160,240,135
19457,125,60,65,36,38,42,9
19460,40154,19763,20391,10031,10753,12286,7084
19462,14658,7232,7426,3427,3328,4467,3436
19464,45788,22146,23642,12410,12129,13028,8221
19465,17038,8411,8627,4365,3792,5466,3415
19468,25536,12304,13232,6920,6292,7808,4516
19472,74,35,39,20,17,15,22
19473,15726,7651,8075,4703,3375,5188,2460
19474,733,342,391,150,218,214,151
19475,11283,5790,5493,3188,2380,3623,2092
19477,146,59,87,5,4,18,119
19492,717,303,414,136,121,119,341
19501,1047,547,500,267,272,311,197
19503,1142,562,580,267,276,318,281
19504,4998,2515,2483,1269,958,1781,990
19505,3226,1599,1627,699,618,1094,815
19506,7356,3739,3617,1927,1459,2465,1505
19507,3280,1669,1611,923,679,1020,658
19508,15725,7889,7836,4131,3452,5076,3066
19510,7639,3741,3898,2344,1770,2383,1142
19511,215,107,108,47,44,50,74
19512,16954,8386,8568,3863,3674,5634,3783
19518,14734,7305,7429,4458,3063,4517,2696
19519,101,51,50,25,17,39,20
19520,5465,2700,2765,1255,904,1782,1524
19522,14229,7161,7068,3483,3019,4702,3025
19523,250,124,126,66,66,87,31
19525,14107,6954,7153,4333,2987,4537,2250
19526,11039,5367,5672,2478,2402,3454,2705
19529,3131,1601,1530,755,609,1079,688
19530,16432,7742,8690,4575,5884,3348,2625
19533,7686,4148,3538,1627,1979,2363,1717
19534,2041,1056,985,465,432,710,434
19535,23,13,10,1,5,9,8
19536,490,237,253,89,179,130,92
19538,64,35,29,10,15,17,22
19539,4597,2305,2292,1108,925,1633,931
19540,11723,5917,5806,3053,2336,4069,2265
19541,4403,2251,2152,1134,844,1653,772
19542,67,33,34,15,23,19,10
19543,5905,2956,2949,1927,1295,1849,834
19544,196,103,93,41,53,67,35
19545,428,212,216,110,109,124,85
19547,4222,2136,2086,999,831,1437,955
19549,326,180,146,93,84,90,59
19550,641,432,209,142,230,193,76
19551,5034,2512,2522,1184,1062,1662,1126
19554,374,200,174,105,104,115,50
19555,3406,1732,1674,745,753,1041,867
19559,362,180,182,98,100,94,70
19560,7805,3849,3956,1959,1922,2172,1752
19562,2622,1137,1485,537,537,625,923
19564,90,49,41,13,14,42,21
19565,8531,4192,4339,1956,1645,2639,2291
19567,5388,2696,2692,1410,1207,1626,1145
19601,32998,16141,16857,11392,9288,7800,4518
19602,17900,8830,9070,6092,5042,4336,2430
19604,27658,13513,14145,10375,8323,5909,3051
19605,18985,9187,9798,4387,3953,5714,4931
19606,34416,16625,17791,8800,8196,10196,7224
19607,22544,10620,11924,4834,5615,6102,5993
19608,22719,11153,11566,6352,5023,7211,4133
19609,9946,4768,5178,2438,2376,2807,2325
19610,15258,7166,8092,3473,2904,3832,5049
19611,10589,4943,5646,3265,2981,2238,2105
2802,786,372,414,146,194,267,179
2804,2607,1303,1304,668,541,897,501
2806,16310,7804,8506,4888,2182,5889,3351
2807,1051,538,513,169,197,351,334
2808,2401,1182,1219,708,563,764,366
2809,22938,11105,11833,5208,6110,6117,5503
2812,1497,754,743,411,326,573,187
2813,7831,3916,3915,1687,1417,2656,2071
2814,7496,3796,3700,1805,1425,2913,1353
2815,278,130,148,76,61,92,49
2816,32611,15786,16825,7967,6915,10759,6970
2817,6135,3054,3081,1619,1306,2255,955
2818,18082,8607,9475,4568,2862,6244,4408
2822,6111,3068,3043,1529,1196,2324,1062
2825,5377,2704,2673,1340,948,2050,1039
2826,791,400,391,193,171,290,137
2827,2172,1076,1096,569,402,821,380
2828,7704,3539,4165,1638,1292,2496,2278
2830,5976,2986,2990,1392,1292,2096,1196
2831,3515,1746,1769,905,627,1304,679
2832,4608,2245,2363,1128,890,1661,929
2833,784,392,392,184,152,264,184
2835,5405,2686,2719,1141,696,1985,1583
2836,136,69,67,33,50,44,9
2837,3492,1710,1782,715,495,1168,1114
2838,3400,1519,1881,840,927,895,738
2839,1902,952,950,487,407,686,322
2840,23335,10955,12380,5082,7227,6000,5026
2841,1392,1148,244,230,1034,127,1
2842,16095,7729,8366,3928,3484,4818,3865
2852,22551,10893,11658,5580,4257,7710,5004
2857,8412,4148,4264,1961,1378,3070,2003
2858,570,273,297,167,144,190,69
2859,6738,3335,3403,1697,1470,2336,1235
2860,45199,21577,23622,12364,13494,12270,7071
2861,26164,12622,13542,6092,6906,7938,5228
2863,19385,9829,9556,6257,6318,4499,2311
2864,33396,16139,17257,8212,7276,10661,7247
2865,16951,8197,8754,4217,3290,5576,3868
2871,17171,8428,8743,4432,2943,5724,4072
2872,218,107,111,26,23,73,96
2873,235,122,113,58,51,88,38
2874,5860,2955,2905,1715,998,2168,979
2875,307,150,157,82,70,118,37
2876,430,207,223,71,216,98,45
2878,15780,7646,8134,3326,2998,5212,4244
2879,20371,9766,10605,4796,3885,6728,4962
2881,7841,3589,4252,3949,2696,658,538
2882,14184,6936,7248,2377,4738,3613,3456
2885,10627,5042,5585,2189,2506,3371,2561
2886,29269,13896,15373,5961,6850,8678,7780
2888,19912,9437,10475,4305,4700,6375,4532
2889,28217,13710,14507,6431,6900,9223,5663
2891,21198,10131,11067,4712,4428,6505,5553
2892,4988,2465,2523,1172,1013,1773,1030
2893,29630,14335,15295,6464,8680,8533,5953
2894,722,361,361,204,158,271,89
2895,41186,19935,21251,10942,11482,11184,7578
2896,11537,5464,6073,2635,2017,3829,3056
2898,1696,854,842,462,375,597,262
2903,10780,5061,5719,2165,5126,1749,1740
2904,29359,13646,15713,6349,7854,7796,7360
2905,25223,11855,13368,8054,7383,6365,3421
2906,28387,13485,14902,5995,12132,5641,4619
2907,27445,13215,14230,9385,8376,6768,2916
2908,37467,17917,19550,11278,13518,8085,4586
2909,43540,21865,21675,14315,15448,9624,4153
2910,21000,9973,11027,5224,5750,6222,3804
2911,15574,7140,8434,3613,4326,4376,3259
2912,1370,693,677,506,862,0,2
2914,21963,10227,11736,4954,5886,6007,5116
2915,16897,7948,8949,3411,4007,5219,4260
2916,8139,3825,4314,1813,1832,2460,2034
2917,13762,6794,6968,3448,3803,3766,2745
2919,28790,13642,15148,6094,6621,8822,7253
2920,37547,19232,18315,7685,9962,10858,9042
2921,12361,6062,6299,3359,2324,4481,2197
29001,2148,1003,1145,579,472,647,450
29003,6989,3272,3717,1887,1552,1914,1636
29006,9565,4626,4939,2533,2200,2747,2085
29009,2440,1223,1217,590,497,678,675
29010,13491,7249,6242,3288,3816,3849,2538
29014,1891,947,944,443,403,618,427
29015,1738,820,918,454,363,555,366
29016,16393,8058,8335,4859,3531,5519,2484
29018,3749,1796,1953,942,835,1128,844
29020,22463,10527,11936,5658,4655,6354,5796
29030,1967,977,990,441,404,614,508
29031,1349,645,704,338,259,444,308
29032,4424,2212,2212,1287,1150,1295,692
29033,11603,5575,6028,2453,3769,3005,2376
29036,19140,9395,9745,5055,3369,6154,4562
29037,824,411,413,177,156,243,248
29038,2445,1223,1222,643,546,776,480
29039,4215,1968,2247,1283,1069,1140,723
29040,8767,4244,4523,2615,2541,2323,1288
29042,5868,2777,3091,1785,1519,1426,1138
29044,5652,2762,2890,1510,1168,1805,1169
29045,21871,10790,11081,6444,5920,6429,3078
29046,237,111,126,54,52,53,78
29047,3683,1794,1889,784,686,1140,1073
29048,4864,2307,2557,1213,926,1480,1245
29051,951,446,505,249,180,294,228
29052,2021,963,1058,545,431,631,414
29053,18830,9322,9508,5858,5064,5402,2506
29054,9612,4851,4761,2588,2148,3000,1876
29055,4337,2075,2262,1115,977,1255,990
29056,2448,1161,1287,656,504,723,565
29058,4746,2353,2393,1255,1094,1341,1056
29059,6068,2817,3251,1633,1336,1758,1341
29061,13717,6560,7157,3798,3350,4258,2311
29062,176,91,85,39,31,56,50
29063,32717,15638,17079,10260,8207,10142,4108
29065,677,302,375,160,132,213,172
29067,10949,6134,4815,2505,3120,3124,2200
29069,5020,2455,2565,1360,1087,1522,1051
29070,15330,7677,7653,3986,3431,4616,3297
29072,49566,24235,25331,14209,12744,14601,8012
29073,40775,20000,20775,11837,11421,11720,5797
29074,241,122,119,17,17,80,127
29075,2963,1435,1528,728,594,980,661
29078,15293,7505,7788,4403,3588,4558,2744
29079,151,70,81,34,32,47,38
29080,3240,1529,1711,831,657,945,807
29081,1352,651,701,324,255,388,385
29082,572,293,279,139,139,154,140
29101,3023,1463,1560,846,758,869,550
29102,18248,8636,9612,4869,3862,5076,4441
29104,1531,688,843,382,317,477,355
29105,1514,746,768,442,370,434,268
29107,3166,1554,1612,877,709,905,675
29108,20469,9892,10577,5802,5568,5023,4076
29111,1632,791,841,470,412,427,323
29112,4712,2279,2433,1196,1044,1463,1009
29113,1618,776,842,408,355,454,401
29114,2190,1028,1162,604,485,643,458
29115,31128,14326,16802,8726,8977,7353,6072
29117,1160,589,571,580,580,0,0
29118,15861,7422,8439,4103,3965,4514,3279
29122,54,22,32,9,11,19,15
29123,7617,3863,3754,2270,1968,2262,1117
29125,3072,1453,1619,770,644,933,725
29126,2267,1123,1144,579,501,700,487
29127,8333,4099,4234,1880,1575,2591,2287
29128,5866,3230,2636,1323,1725,1809,1009
29129,3164,1676,1488,795,794,912,663
29130,6655,3307,3348,1400,1314,2205,1736
29133,1044,532,512,272,235,310,227
29135,8919,4293,4626,2305,1929,2650,2035
29137,2539,1237,1302,662,569,744,564
29138,10883,5452,5431,3060,3028,2697,2098
29142,4890,2262,2628,1260,997,1297,1336
29145,837,427,410,172,170,298,197
29146,1767,839,928,452,365,502,448
29147,0,0,0,0,0,0,0
29148,6230,2897,3333,1282,1032,1830,2086
29150,40031,18620,21411,11585,10299,10008,8139
29152,2393,1396,997,882,1382,116,13
29153,15633,7520,8113,4484,3859,4336,2954
29154,28135,13552,14583,8126,7353,7982,4674
29160,8255,4060,4195,2228,1951,2489,1587
29161,11383,5518,5865,3084,2798,3425,2076
29162,4122,2698,1424,1023,1672,910,517
29163,1975,913,1062,554,404,575,442
29164,4690,2278,2412,1288,1057,1369,976
29166,904,454,450,205,235,264,200
29168,3582,1747,1835,1067,865,1029,621
29169,22845,11099,11746,4880,7255,5526,5184
29170,19988,9746,10242,5338,5349,5698,3603
29172,9293,4519,4774,2608,2472,2609,1604
29175,378,179,199,94,67,116,101
29178,3377,1658,1719,834,727,977,839
29180,14267,6754,7513,3831,3234,4196,3006
29201,20594,10482,10112,4132,12001,2842,1619
29202,135,71,64,12,77,24,22
29203,39843,18143,21700,11258,10775,10373,7437
29204,19952,9113,10839,5416,5464,5027,4045
29205,24822,12475,12347,5568,9912,5594,3748
29206,17788,8310,9478,4643,4133,4831,4181
29207,11592,8672,2920,3138,8305,143,6
29208,695,366,329,381,314,0,0
29209,33324,15986,17338,8693,10146,9054,5431
29210,40356,21113,19243,8493,16538,10010,5315
29212,28798,13765,15033,7285,6989,8763,5761
29223,50141,23334,26807,13331,14308,13528,8974
29225,1228,6,1222,1051,177,0,0
29229,44229,20664,23565,15365,13166,11857,3841
29301,31051,15006,16045,8913,8094,8511,5533
29302,16571,7805,8766,4166,3920,4823,3662
29303,25058,12518,12540,6854,8435,5805,3964
29306,15861,6829,9032,4934,3912,4120,2895
29307,18751,8666,10085,4250,4063,5079,5359
29316,22281,10729,11552,6507,6242,5955,3577
29320,530,259,271,151,134,146,99
29321,2596,1259,1337,628,644,760,564
29322,8781,4382,4399,2297,1859,2677,1948
29323,14446,7173,7273,3976,3389,4257,2824
29324,167,86,81,53,42,43,29
29325,15222,7183,8039,4206,3782,3931,3303
29329,278,138,140,88,68,74,48
29330,8401,4150,4251,2314,2100,2340,1647
29331,142,64,78,30,24,53,35
29332,2435,1204,1231,525,398,763,749
29333,374,185,189,78,96,112,88
29334,11331,5430,5901,3388,3114,3071,1758
29335,5654,3422,2232,1193,1732,1774,955
29338,85,41,44,24,17,27,17
29340,20763,9933,10830,5791,5264,5495,4213
29341,19330,9368,9962,5330,4732,5587,3681
29346,307,153,154,94,84,82,47
29349,30129,14615,15514,8394,6907,8702,6126
29351,1563,751,812,377,405,433,348
29353,4174,2038,2136,1071,914,1247,942
29355,810,395,415,190,176,259,185
29356,8074,3965,4109,1800,1497,2437,2340
29360,20977,10153,10824,5574,5037,5705,4661
29364,592,289,303,141,129,186,136
29365,10146,4960,5186,2762,2594,2889,1901
29368,68,33,35,12,8,31,17
29369,13044,6257,6787,3766,2888,4074,2316
29370,1045,490,555,279,236,307,223
29372,4507,2183,2324,1077,966,1324,1140
29373,297,134,163,73,76,78,70
29374,3534,1803,1731,924,723,1157,730
29375,95,48,47,31,24,23,17
29376,6909,3377,3532,2014,1503,2045,1347
29377,761,344,417,214,196,207,144
29378,207,102,105,72,61,56,18
29379,19186,9025,10161,4927,4209,5548,4502
29384,3945,1968,1977,838,757,1273,1077
29385,7221,3492,3729,2102,1833,2053,1233
29388,14470,7057,7413,3974,3318,4256,2922
29401,10895,4515,6380,2927,4086,1516,2366
29403,20818,9713,11105,4346,9160,4067,3245
29404,1348,819,529,439,839,69,1
29405,26328,13341,12987,6948,7694,7296,4390
29406,29314,14753,14561,8049,11526,6326,3413
29407,34827,16420,18407,7336,10994,8845,7652
29409,2100,1933,167,739,1320,27,14
29410,17816,8880,8936,4796,5556,4686,2778
29412,35850,17217,18633,6945,12062,9393,7450
29414,31883,15095,16788,6903,10675,8850,5455
29418,23540,11396,12144,6453,7443,6559,3085
29420,21834,10569,11265,7235,6198,6061,2340
29423,956,368,588,579,377,0,0
29424,389,204,185,269,117,1,2
29426,1741,843,898,474,375,514,378
29429,2737,1324,1413,634,500,938,665
29431,6071,2996,3075,1563,1403,1818,1287
29432,2853,1378,1475,789,590,755,719
29434,537,263,274,134,101,193,109
29435,4122,2025,2097,1102,894,1324,802
29436,4471,2182,2289,1121,923,1410,1017
29437,2380,1156,1224,585,499,797,499
29438,2408,1178,1230,406,361,717,924
29439,2399,1235,1164,269,659,787,684
29440,28469,13503,14966,7758,6370,8002,6339
29445,53588,27432,26156,15750,17447,13688,6703
29446,1138,551,587,273,221,366,278
29448,2356,1142,1214,673,527,645,511
29449,7749,3770,3979,1720,1509,2552,1968
29450,3105,1492,1613,872,734,965,534
29451,4205,2087,2118,777,606,1337,1485
29452,394,192,202,97,83,131,83
29453,1252,627,625,299,292,392,269
29455,20478,10147,10331,4198,5080,5722,5478
29456,27864,13592,14272,8863,8864,6942,3195
29458,2713,1321,1392,565,557,843,748
29461,30141,14823,15318,8300,7809,8573,5459
29464,43649,20907,22742,9668,12105,12918,8958
29466,28725,13951,14774,8948,6549,8954,4274
29468,2107,997,1110,535,440,591,541
29469,855,424,431,167,146,324,218
29470,4232,2105,2127,1104,970,1334,824
29471,1537,755,782,374,309,487,367
29472,9416,5611,3805,1953,2858,3041,1564
29474,2176,1033,1143,526,461,684,505
29475,2874,1400,1474,765,626,840,643
29477,6789,3305,3484,1703,1460,1963,1663
29479,7337,3505,3832,2126,1544,2062,1605
29481,1841,913,928,518,376,520,427
29482,1791,884,907,415,307,634,435
29483,66731,32053,34678,19951,18327,18390,10063
29485,45057,21736,23321,13322,12192,12389,7154
29487,2725,1307,1418,594,481,880,770
29488,22220,10586,11634,6292,5160,6036,4732
29492,10262,4956,5306,2851,3235,2769,1407
29493,117,55,62,25,20,30,42
29501,43220,20255,22965,11334,11127,12189,8570
29505,24279,11294,12985,6566,6306,6645,4762
29506,20960,9568,11392,5681,6153,5328,3798
29510,11060,5278,5782,3213,2615,3092,2140
29511,5146,2519,2627,1444,1285,1484,933
29512,19514,10722,8792,4500,5848,5553,3613
29516,829,399,430,225,185,252,167
29518,1232,586,646,305,251,359,317
29519,285,126,159,59,68,94,64
29520,14617,6778,7839,3957,3126,4309,3225
29525,2029,922,1107,551,415,618,445
29526,39033,19267,19766,10376,10912,9690,8055
29527,22027,10465,11562,6111,5667,6199,4050
29530,2915,1421,1494,827,771,760,557
29532,20871,9718,11153,5590,4969,5837,4475
29536,17722,8315,9407,5412,4447,4650,3213
29540,5599,2680,2919,1675,1291,1670,963
29541,9465,4739,4726,2501,2502,2895,1567
29543,606,283,323,91,110,163,242
29544,4909,2395,2514,1402,1253,1379,875
29545,1657,812,845,488,429,420,320
29546,2834,1355,1479,748,724,793,569
29547,2917,1405,1512,947,729,854,387
29550,32284,15452,16832,8843,7533,9099,6809
29554,9332,4400,4932,2486,2000,2795,2051
29555,6440,3078,3362,1995,1527,1758,1160
29556,12870,5930,6940,3735,2920,3512,2703
29560,13664,6367,7297,3951,3186,3679,2848
29563,2676,1215,1461,659,563,759,695
29564,985,443,542,262,199,280,244
29565,7127,3384,3743,2117,1697,2023,1290
29566,15179,7277,7902,2750,2712,4269,5448
29567,564,276,288,169,128,172,95
29568,12224,5915,6309,2930,2551,3428,3315
29569,15951,7618,8333,4305,3803,4567,3276
29570,3913,1902,2011,1060,949,1122,782
29571,15622,7133,8489,4372,3685,4260,3305
29572,7893,3872,4021,1136,1597,2201,2959
29574,11909,5356,6553,3153,2583,3381,2792
29575,15512,7410,8102,2634,2995,4507,5376
29576,24446,11658,12788,3719,3984,6540,10203
29577,26996,13714,13282,5800,8497,7391,5308
29579,32180,16035,16145,8222,11128,7777,5053
29580,1450,683,767,370,274,488,318
29581,4650,2248,2402,1172,1003,1410,1065
29582,14622,7231,7391,2080,2757,4201,5584
29583,5438,2618,2820,1484,1217,1495,1242
29584,2563,1266,1297,632,590,769,572
29585,13606,6476,7130,2420,1836,3711,5639
29588,36499,17918,18581,8941,9924,10143,7491
29590,3677,2329,1348,658,1355,1056,608
29591,5467,2581,2886,1497,1301,1487,1182
29592,1197,562,635,327,314,359,197
29593,1954,924,1030,490,483,605,376
29594,121,63,58,26,19,48,28
29596,2424,1199,1225,609,546,751,518
29601,10550,5716,4834,1788,3405,3280,2077
29605,34414,16429,17985,9628,9274,9241,6271
29607,34487,16126,18361,9056,10663,8799,5969
29609,27722,13514,14208,6973,7859,7673,5217
29611,28799,14047,14752,8225,8039,7529,5006
29613,2334,989,1345,888,1444,2,0
29614,2720,1187,1533,911,1753,21,35
29615,35151,16882,18269,7656,10036,9150,8309
29617,25685,12398,13287,6703,7333,6368,5281
29620,12934,6209,6725,3390,2762,3719,3063
29621,39101,18181,20920,10728,9155,10285,8933
29624,14610,6912,7698,3971,3672,3945,3022
29625,27538,13398,14140,6945,7302,7632,5659
29626,12364,6045,6319,3104,2809,3525,2926
29627,18367,8944,9423,4819,4075,5263,4210
29628,2759,1312,1447,678,591,825,665
29630,14186,7294,6892,3135,5926,2983,2142
29631,13318,7072,6246,2350,6909,2035,2024
29634,5589,2926,2663,3821,1764,3,1
29635,1254,651,603,262,225,412,355
29638,2944,1443,1501,818,614,860,652
29639,1742,814,928,500,566,284,392
29640,30574,14989,15585,8123,7485,8855,6111
29642,29561,14343,15218,8001,6652,8879,6029
29643,2756,1376,1380,610,539,804,803
29644,18578,9069,9509,5364,4597,5508,3109
29645,9982,4982,5000,2714,2372,3121,1775
29646,28159,13381,14778,7926,7120,7167,5946
29649,26235,11851,14384,7042,7390,6673,5130
29650,32632,15677,16955,9028,8378,9647,5579
29651,42844,21025,21819,12089,10627,12166,7962
29653,4811,2343,2468,1207,1069,1443,1092
29654,9937,4783,5154,2617,2221,2819,2280
29655,7796,3769,4027,2007,1636,2223,1930
29657,15116,7559,7557,4053,3806,4458,2799
29658,333,170,163,78,76,108,71
29659,118,71,47,32,20,37,29
29661,5648,2890,2758,1424,1305,1695,1224
29662,15090,7078,8012,3891,4278,4197,2724
29664,1808,914,894,383,336,589,500
29665,127,66,61,23,37,37,30
29666,6590,3159,3431,1755,1346,1821,1668
29667,269,135,134,79,64,74,52
29669,12387,6181,6206,3197,2857,3762,2571
29670,8673,4199,4474,2055,2219,2375,2024
29671,18030,8906,9124,4426,4046,5329,4229
29672,11868,5850,6018,2247,2434,3295,3892
29673,25348,12441,12907,7020,6225,7378,4725
29676,5201,2626,2575,655,625,1242,2679
29678,21676,10613,11063,5667,5586,5800,4623
29680,27285,13814,13471,8105,7563,8225,3392
29681,46979,22798,24181,14394,10460,14466,7659
29682,3818,1887,1931,983,861,1171,803
29683,291,141,150,71,76,85,59
29684,4862,2396,2466,1366,1126,1394,976
29685,1230,606,624,239,164,399,428
29686,1027,499,528,255,151,318,303
29687,39561,19006,20555,10654,10371,10986,7550
29689,3889,1961,1928,820,722,1276,1071
29690,20914,10272,10642,5808,5300,5829,3977
29691,11333,5621,5712,3152,2703,3125,2353
29692,4856,2325,2531,1215,1107,1372,1162
29693,14215,7017,7198,3644,3034,4073,3464
29696,4125,2037,2088,977,834,1225,1089
29697,12207,5952,6255,3471,3055,3379,2302
29702,10059,4938,5121,2725,2487,2913,1934
29704,3721,1877,1844,912,822,1253,734
29706,19847,9510,10337,5403,4664,5651,4129
29707,17742,8531,9211,4202,4262,4422,4856
29708,25035,12308,12727,7810,5651,7836,3738
29709,6498,3224,3274,1643,1519,1961,1375
29710,29449,14607,14842,8126,6559,9169,5595
29712,2317,1164,1153,573,499,762,483
29714,2927,1439,1488,783,678,893,573
29715,24823,11932,12891,7860,6076,7271,3616
29717,1251,617,634,343,274,369,265
29718,3856,1905,1951,1068,913,1143,732
29720,46041,22147,23894,12459,11226,12915,9441
29724,43,23,20,15,11,8,9
29726,1750,874,876,451,397,586,316
29727,1650,823,827,489,411,488,262
29728,10301,5089,5212,3065,2648,2789,1799
29729,2271,1103,1168,589,511,763,408
29730,52365,24861,27504,14256,15570,14095,8444
29732,53781,25641,28140,14315,14878,14860,9728
29733,1751,533,1218,1162,589,0,0
29741,2082,1016,1066,547,433,633,469
29742,2460,1233,1227,612,575,767,506
29743,1071,545,526,259,242,332,238
29745,28919,14213,14706,8175,6941,8832,4971
29801,26778,12595,14183,7001,6758,7086,5933
29803,36843,17873,18970,8052,7694,10781,10316
29805,5864,2936,2928,1613,1420,1811,1020
29809,2206,1085,1121,500,538,637,531
29810,4990,2330,2660,1531,1141,1290,1028
29812,11864,5688,6176,3442,2825,3277,2320
29816,1033,488,545,287,260,290,196
29817,4913,2314,2599,1373,1066,1410,1064
29819,1523,801,722,416,321,473,313
29821,1487,745,742,377,307,501,302
29824,8535,5177,3358,1635,2530,2676,1694
29826,164,76,88,36,39,53,36
29827,4624,2812,1812,899,1500,1400,825
29828,1003,484,519,252,211,264,276
29829,8651,4278,4373,2483,2303,2328,1537
29831,4146,2026,2120,1119,973,1198,856
29832,5335,2587,2748,1424,1194,1582,1135
29834,1687,858,829,476,442,444,325
29835,6566,3122,3444,1169,999,1662,2736
29836,482,240,242,111,71,176,124
29838,501,266,235,101,75,171,154
29840,251,114,137,59,48,70,74
29841,32494,15661,16833,8706,8589,8915,6284
29842,7675,3745,3930,2124,1860,2300,1391
29843,1291,669,622,330,273,390,298
29844,123,67,56,19,15,50,39
29845,1104,530,574,200,204,403,297
29847,5480,3001,2479,1417,1554,1615,894
29848,751,385,366,160,133,255,203
29849,294,140,154,73,57,103,61
29850,111,50,61,14,20,37,40
29851,7524,3682,3842,2074,1949,2087,1414
29853,6580,3150,3430,1840,1496,1881,1363
29856,3255,1626,1629,993,813,957,492
29860,14450,6962,7488,3869,3249,4394,2938
29899,1244,1244,0,0,713,464,67
29902,14779,7200,7579,4011,4245,3444,3079
29904,659,591,68,86,573,0,0
29905,3054,2423,631,1348,1681,25,0
29906,21765,10560,11205,7055,7797,4479,2434
29907,12570,6023,6547,3643,2856,3465,2606
29909,16394,7661,8733,1417,1466,2227,11284
29910,33954,17021,16933,9883,10651,8408,5012
29911,1725,839,886,460,397,521,347
29912,42,20,22,12,11,13,6
29915,416,211,205,49,39,134,194
29916,1533,743,790,407,312,478,336
29918,5278,3236,2042,1143,1688,1538,909
29920,9481,4525,4956,2178,1538,2602,3163
29921,227,107,120,45,53,65,64
29922,1214,583,631,364,290,354,206
29923,392,184,208,106,95,117,74
29924,4331,2031,2300,1155,954,1175,1047
29926,23742,11588,12154,4958,4658,5756,8370
29927,8237,4209,4028,2444,2522,2063,1208
29928,16110,7937,8173,2045,2916,3853,7296
29929,1135,573,562,290,245,321,279
29932,269,135,134,72,48,98,51
29934,1172,558,614,338,245,351,238
29935,3685,1719,1966,827,1397,864,597
29936,13354,7146,6208,3588,4044,3587,2135
29939,302,142,160,98,63,94,47
29940,3967,1869,2098,1118,862,1151,836
29941,497,241,256,72,73,129,223
29943,477,236,241,121,109,151,96
29944,5118,2489,2629,1544,1213,1418,943
29945,4841,2302,2539,1366,1068,1380,1027
51001,242,126,116,61,52,86,43
51023,105,55,50,33,13,39,20
56144,90,48,42,17,13,37,23
56164,49,25,24,11,3,23,12
56219,347,167,180,104,65,97,81
57001,1672,831,841,388,288,531,465
57002,863,454,409,204,254,252,153
57003,1879,974,905,636,479,521,243
57004,3356,1680,1676,898,727,922,809
57005,10473,5223,5250,3568,2628,2991,1286
57006,24530,12555,11975,6777,10468,4366,2919
57010,493,251,242,128,99,150,116
57012,1160,606,554,314,228,338,280
57013,4440,2192,2248,1263,954,1297,926
57014,1471,752,719,370,312,407,382
57015,787,409,378,218,173,244,152
57016,693,351,342,181,139,213,160
57017,1340,699,641,416,289,397,238
57018,1372,706,666,387,310,411,264
57020,1502,764,738,497,414,433,158
57021,276,147,129,68,58,86,64
57022,4996,2498,2498,1563,1213,1277,943
57024,428,220,208,123,90,124,91
57025,2795,1369,1426,835,576,799,585
57026,1392,740,652,369,379,385,259
57027,109,62,47,37,20,32,20
57028,3448,1671,1777,975,749,913,811
57029,2023,959,1064,500,343,558,622
57030,2816,1398,1418,881,561,911,463
57031,741,374,367,252,157,203,129
57032,5906,2929,2977,2043,2116,1317,430
57033,4713,2348,2365,1529,1028,1492,664
57034,712,381,331,176,137,221,178
57035,1200,616,584,371,263,339,227
57036,811,420,391,225,176,226,184
57037,819,406,413,197,157,251,214
57038,1667,871,796,485,341,548,293
57039,3265,1633,1632,960,723,935,647
57040,389,210,179,108,62,140,79
57041,97,55,42,16,19,48,14
57042,8415,4263,4152,2211,2164,2180,1860
57043,1378,680,698,309,224,406,439
57045,996,483,513,198,147,261,390
57046,626,321,305,169,116,213,128
57047,256,123,133,54,58,74,70
57048,1170,576,594,347,274,335,214
57049,5789,2896,2893,1650,1354,1744,1041
57050,191,103,88,55,36,51,49
57051,263,137,126,57,43,87,76
57052,452,224,228,139,96,119,98
57053,1893,953,940,521,421,568,383
57054,502,255,247,116,96,150,140
57055,1090,581,509,263,205,397,225
57057,152,81,71,50,33,48,21
57058,1973,982,991,538,355,563,517
57059,1522,736,786,407,265,395,455
57061,102,57,45,34,22,25,21
57062,2410,1832,578,292,960,746,412
57063,1006,512,494,311,198,269,228
57064,5072,2606,2466,1911,1656,1183,322
57065,397,200,197,91,75,142,89
57066,1508,747,761,361,220,447,480
57067,537,268,269,174,84,179,100
57068,1471,757,714,409,321,520,221
57069,11988,5801,6187,3206,5202,2069,1511
57070,1387,684,703,346,231,396,414
57071,2758,1391,1367,773,735,756,494
57072,584,291,293,157,107,205,115
57073,711,350,361,162,121,215,213
57075,893,453,440,191,149,309,244
57076,521,277,244,181,122,131,87
57077,1324,655,669,406,423,323,172
57078,19089,9824,9265,4539,4757,5561,4232
57103,34480,17242,17238,9853,8943,10059,5625
57104,25901,13998,11903,6054,9371,6761,3715
57105,22268,10736,11532,5212,6440,5644,4972
57106,39852,19210,20642,11049,13913,9482,5408
57107,8044,4089,3955,2465,2637,1921,1021
57108,17267,8363,8904,5202,4854,4639,2572
57110,12309,5964,6345,3850,2862,3740,1857
57117,61,60,1,0,0,14,47
57197,959,342,617,480,479,0,0
57201,24983,12396,12587,6894,6318,6779,4992
57212,2062,1055,1007,510,407,588,557
57213,485,242,243,115,92,161,117
57214,75,37,38,21,16,19,19
57216,1044,531,513,224,157,359,304
57217,244,123,121,54,45,82,63
57218,327,176,151,93,60,102,72
57219,567,281,286,99,97,158,213
57220,767,391,376,200,153,266,148
57221,808,405,403,289,151,174,194
57223,1356,675,681,407,286,394,269
57224,195,105,90,52,41,51,51
57225,1873,920,953,463,328,498,584
57226,2072,1057,1015,541,429,559,543
57227,434,230,204,110,66,133,125
57231,1695,834,861,407,282,468,538
57232,299,163,136,65,54,97,83
57233,118,65,53,21,15,37,45
57234,1274,615,659,326,252,316,380
57235,844,447,397,266,168,250,160
57236,118,64,54,29,15,47,27
57237,665,340,325,155,108,200,202
57238,483,258,225,147,86,158,92
57239,223,123,100,20,29,77,97
57241,1048,529,519,424,222,245,157
57242,432,228,204,170,90,105,67
57243,604,312,292,171,116,194,123
57245,126,68,58,31,26,37,32
57246,161,88,73,38,25,64,34
57247,320,175,145,51,30,129,110
57248,1057,520,537,317,214,217,309
57249,994,518,476,230,167,336,261
57251,127,73,54,19,14,46,48
57252,4800,2399,2401,1198,954,1442,1206
57255,538,271,267,150,100,153,135
57256,127,67,60,36,28,21,42
57257,810,401,409,323,182,193,112
57258,385,182,203,101,89,116,79
57259,505,261,244,139,85,162,119
57260,1093,524,569,285,177,301,330
57261,321,159,162,62,52,74,133
57262,4963,2459,2504,1689,1086,1188,1000
57263,450,228,222,137,95,133,85
57264,219,121,98,58,50,52,59
57265,225,120,105,61,38,57,69
57266,607,331,276,196,134,170,107
57268,443,241,202,121,87,122,113
57269,413,216,197,109,85,128,91
57270,904,582,322,195,347,202,160
57271,247,127,120,87,29,81,50
57272,173,94,79,62,35,49,27
57273,1316,661,655,405,254,377,280
57274,2813,1387,1426,665,500,790,858
57276,1178,609,569,364,234,333,247
57278,748,381,367,216,148,206,178
57279,1058,546,512,251,167,311,329
57301,18375,9014,9361,4994,4592,4711,4078
57311,1616,796,820,580,351,415,270
57312,516,269,247,134,119,145,118
57313,1128,555,573,253,160,306,409
57314,734,381,353,187,144,225,178
57315,987,491,496,279,179,284,245
57317,526,271,255,134,83,143,166
57319,1003,488,515,261,166,273,303
57321,388,195,193,112,63,139,74
57322,296,152,144,75,68,89,64
57323,215,111,104,43,43,61,68
57324,383,205,178,90,75,123,95
57325,3054,1444,1610,814,632,921,687
57328,1134,571,563,285,192,302,355
57329,258,124,134,79,44,62,73
57330,625,319,306,172,101,190,162
57331,459,243,216,138,76,137,108
57332,730,382,348,228,142,195,165
57334,895,460,435,288,238,213,156
57335,244,123,121,48,30,90,76
57337,140,73,67,39,17,39,45
57339,1525,741,784,698,396,317,114
57340,355,188,167,118,69,96,72
57341,151,74,77,46,27,37,41
57342,558,301,257,143,99,180,136
57344,155,78,77,40,31,46,38
57345,1238,637,601,287,224,346,381
57346,68,39,29,25,22,16,5
57348,527,290,237,132,100,175,120
57349,1493,748,745,370,248,428,447
57350,14534,7256,7278,3874,3311,4054,3295
57353,829,419,410,222,171,256,180
57355,1352,682,670,409,282,363,298
57356,1993,978,1015,776,411,438,368
57358,34,17,17,8,9,11,6
57359,649,345,304,155,127,214,153
57361,198,102,96,95,46,36,21
57362,2149,1036,1113,469,360,613,707
57363,1003,554,449,304,219,301,179
57364,56,31,25,10,15,13,18
57365,522,274,248,114,111,179,118
57366,2228,1081,1147,584,375,635,634
57367,210,106,104,40,38,58,74
57368,1226,633,593,391,274,295,266
57369,2495,1229,1266,625,479,702,689
57370,814,412,402,244,161,225,184
57371,234,112,122,53,53,67,61
57373,437,233,204,108,72,125,132
57374,343,176,167,103,47,105,88
57375,647,330,317,159,92,193,203
57376,1010,510,500,199,142,280,389
57379,84,44,40,20,15,26,23
57380,3470,1697,1773,1226,672,842,730
57381,490,252,238,106,83,149,152
57382,1591,749,842,351,275,417,548
57383,732,365,367,190,123,206,213
57384,839,443,396,212,160,279,188
57385,1221,630,591,275,239,357,350
57386,209,110,99,62,45,53,49
57401,30061,14436,15625,7754,8067,7920,6320
57420,75,35,40,20,17,9,29
57421,88,49,39,22,18,22,26
57422,235,128,107,41,45,87,62
57424,291,152,139,73,43,98,77
57426,63,33,30,18,9,17,19
57427,620,329,291,186,144,173,117
57428,710,350,360,189,119,173,229
57429,94,43,51,25,26,26,17
57430,2243,1138,1105,553,444,614,632
57432,465,231,234,151,80,127,107
57433,383,207,176,70,73,118,122
57434,566,296,270,157,107,164,138
57435,247,129,118,55,37,78,77
57436,384,201,183,72,62,144,106
57437,1286,608,678,217,112,356,601
57438,1580,755,825,427,298,419,436
57439,52,30,22,11,17,12,12
57440,612,309,303,223,134,124,131
57441,607,328,279,164,102,182,159
57442,1664,832,832,376,282,454,552
57445,2068,1033,1035,606,394,569,499
57446,472,239,233,82,64,146,180
57448,348,184,164,55,44,110,139
57449,146,84,62,28,28,41,49
57450,672,325,347,151,96,196,229
57451,2293,1179,1114,579,410,723,581
57452,278,139,139,64,47,71,96
57454,558,300,258,124,80,183,171
57455,96,57,39,20,8,32,36
57456,862,436,426,241,163,230,228
57457,90,48,42,16,8,33,33
57460,365,194,171,105,73,104,83
57461,392,206,186,94,69,136,93
57465,371,179,192,104,67,102,98
57466,124,73,51,29,11,44,40
57467,293,163,130,82,50,85,76
57468,247,133,114,58,39,91,59
57469,3305,1629,1676,897,590,880,938
57470,143,77,66,32,18,48,45
57471,674,336,338,193,123,170,188
57472,953,489,464,199,137,265,352
57473,161,77,84,44,26,46,45
57474,197,103,94,51,48,64,34
57475,160,81,79,31,25,50,54
57476,463,243,220,128,78,144,113
57477,117,64,53,16,20,43,38
57479,666,343,323,205,142,211,108
57481,598,325,273,206,116,174,102
57501,16309,7920,8389,4192,4023,4953,3141
57520,153,75,78,21,25,50,57
57521,167,92,75,40,28,54,45
57522,463,243,220,120,72,153,118
57523,1094,535,559,272,194,296,332
57528,748,380,368,214,129,221,184
57529,395,207,188,117,65,108,105
57531,228,119,109,52,36,81,59
57532,2835,1417,1418,748,590,834,663
57533,1900,954,946,435,319,526,620
57534,183,97,86,55,26,59,43
57536,469,243,226,132,85,134,118
57537,83,48,35,19,22,24,18
57538,322,168,154,88,64,84,86
57540,106,58,48,32,18,34,22
57541,167,87,80,58,27,49,33
57543,870,434,436,225,152,230,263
57544,419,226,193,110,82,121,106
57547,139,81,58,31,36,33,39
57548,1380,706,674,614,405,250,111
57551,2279,1117,1162,789,513,534,443
57552,554,291,263,134,97,171,152
57553,153,83,70,54,27,48,24
57555,3834,1882,1952,1617,1063,741,413
57559,638,311,327,144,120,196,178
57560,436,235,201,191,98,95,52
57562,98,47,51,37,26,23,12
57563,240,109,131,89,66,58,27
57564,995,539,456,277,182,315,221
57566,1060,505,555,500,280,191,89
57567,1406,690,716,317,246,417,426
57568,689,370,319,164,118,213,194
57569,445,232,213,127,74,116,128
57570,2064,999,1065,934,526,435,169
57571,14,7,7,0,1,6,7
57572,1847,950,897,831,486,381,149
57574,104,55,49,21,8,48,27
57576,204,105,99,48,31,73,52
57577,1211,600,611,552,333,226,100
57579,1330,666,664,456,272,331,271
57580,4449,2160,2289,1109,860,1248,1232
57584,125,66,59,31,22,32,40
57585,226,116,110,57,38,62,69
57601,4003,1914,2089,1067,794,1020,1122
57620,515,261,254,122,90,145,158
57621,378,186,192,180,102,76,20
57622,318,156,162,153,77,65,23
57623,1042,519,523,382,215,287,158
57625,4230,2043,2187,1776,1092,957,405
57626,971,498,473,309,183,283,196
57630,32,17,15,8,4,12,8
57631,361,193,168,66,52,139,104
57632,634,309,325,134,89,206,205
57633,414,210,204,113,75,129,97
57634,115,61,54,25,18,40,32
57636,164,77,87,68,41,35,20
57638,1675,817,858,352,264,506,553
57639,371,174,197,178,91,86,16
57640,176,98,78,31,25,55,65
57641,272,140,132,63,43,77,89
57642,1881,940,941,740,448,417,276
57644,335,169,166,97,57,97,84
57645,127,72,55,33,25,29,40
57646,199,109,90,40,25,71,63
57648,320,161,159,54,44,102,120
57649,217,107,110,58,43,65,51
57650,29,16,13,4,3,12,10
57651,115,66,49,22,29,41,23
57652,402,194,208,152,99,81,70
57656,723,363,360,212,155,201,155
57657,203,109,94,48,28,82,45
57658,446,244,202,183,119,103,41
57660,76,39,37,24,9,21,22
57661,88,42,46,43,22,16,7
57701,43462,21717,21745,12274,13104,10744,7340
57702,32980,16205,16775,7840,7013,10018,8109
57703,14205,7250,6955,4143,4205,3876,1981
57706,2903,1653,1250,1123,1724,51,5
57714,872,420,452,426,232,160,54
57716,486,243,243,186,111,124,65
57717,7937,3952,3985,2255,1801,2186,1695
57718,6307,3196,3111,1775,1679,1934,919
57719,6217,3081,3136,2233,1827,1612,545
57720,651,333,318,166,136,215,134
57722,283,149,134,52,50,91,90
57724,176,96,80,55,37,49,35
57725,162,90,72,36,33,48,45
57730,5315,2648,2667,1129,795,1587,1804
57732,1979,1044,935,352,371,741,515
57735,1327,687,640,287,205,424,411
57738,170,90,80,41,30,54,45
57741,63,40,23,9,9,30,15
57744,2238,1157,1081,557,446,783,452
57745,2109,1074,1035,476,392,721,520
57747,5870,2968,2902,1217,938,1820,1895
57748,318,162,156,131,80,65,42
57750,295,147,148,87,66,79,63
57751,844,426,418,168,132,309,235
57752,2245,1084,1161,938,661,451,195
57754,3793,1918,1875,869,804,1295,825
57755,116,63,53,39,23,34,20
57756,1126,555,571,511,324,199,92
57758,200,111,89,59,38,56,47
57759,546,328,218,177,113,128,128
57760,1353,701,652,348,215,401,389
57761,1210,599,611,341,247,349,273
57762,531,277,254,115,87,198,131
57763,282,151,131,52,52,83,95
57764,1923,965,958,893,512,353,165
57766,237,113,124,49,41,71,76
57767,149,72,77,35,37,41,36
57769,3515,1776,1739,903,784,1172,656
57770,5271,2581,2690,2305,1407,1117,442
57772,2048,1038,1010,894,535,422,197
57773,133,72,61,23,31,48,31
57775,230,127,103,60,43,78,49
57776,15,10,5,2,3,4,6
57779,333,182,151,76,66,110,81
57780,102,49,53,25,11,40,26
57782,61,32,29,11,14,19,17
57783,14290,6901,7389,3309,4047,3602,3332
57785,9377,4605,4772,2321,1886,2790,2380
57787,365,192,173,92,83,103,87
57788,485,257,228,109,86,172,118
57790,1111,564,547,274,241,329,267
57791,190,101,89,58,40,56,36
57792,129,67,62,40,23,40,26
57793,1913,975,938,496,361,616,440
57794,644,317,327,277,180,141,46
57799,660,282,378,386,269,4,1
58439,162,77,85,77,37,26,22
58623,7,3,4,3,1,3,0
58649,14,5,9,2,0,6,6
58653,45,23,22,10,8,16,11
68719,20,12,8,7,3,7,3
69201,267,120,147,133,81,28,25
69212,89,47,42,23,14,23,29
69216,68,41,27,16,10,24,18
82701,30,15,15,7,3,11,9
37010,4679,2349,2330,1481,1118,1432,648
37012,2292,1128,1164,581,527,688,496
37013,78406,37890,40516,22450,30163,19153,6640
37014,1855,924,931,486,366,641,362
37015,17184,8585,8599,4568,4281,5175,3160
37016,793,387,406,179,150,269,195
37018,2259,1136,1123,517,435,797,510
37019,694,374,320,149,152,242,151
37020,5036,2513,2523,1579,1302,1346,809
37022,5469,2797,2672,1424,1251,1762,1032
37023,1811,908,903,585,432,508,286
37025,6226,3129,3097,1693,1461,1935,1137
37026,2201,1120,1081,586,501,714,400
37027,49035,23813,25222,14693,8309,17173,8860
37028,676,335,341,173,126,227,150
37029,5628,2791,2837,1474,1316,1780,1058
37030,6982,3346,3636,1789,1620,2065,1508
37031,3712,1876,1836,942,926,1166,678
37032,4493,2274,2219,1341,1083,1395,674
37033,7805,3860,3945,1840,1648,2265,2052
37034,6591,3304,3287,1890,1713,1944,1044
37035,3766,1899,1867,1108,872,1188,598
37036,5862,2989,2873,1531,1459,1802,1070
37037,6312,3156,3156,1953,1886,1736,737
37040,44924,21786,23138,13948,15684,10380,4912
37042,66916,32779,34137,22332,25240,13748,5596
37043,39945,19272,20673,10605,10678,11240,7422
37046,3665,1835,1830,910,689,1339,727
37047,2345,1169,1176,670,522,638,515
37048,6030,2968,3062,1564,1249,2048,1169
37049,3244,1657,1587,915,722,1021,586
37050,1699,836,863,427,331,537,404
37051,3677,1856,1821,990,800,1128,759
37052,2656,1344,1312,674,565,849,568
37055,27024,12996,14028,7585,6718,7563,5158
37057,834,412,422,211,184,262,177
37058,7081,3520,3561,1651,1432,2138,1860
37059,1552,767,785,424,350,489,289
37060,2230,1124,1106,571,455,727,477
37061,5153,2503,2650,1412,1126,1388,1227
37062,10745,5287,5458,3224,2551,3287,1683
37064,48118,23399,24719,14010,10741,15094,8273
37066,42758,20725,22033,11264,10897,12053,8544
37067,23652,11321,12331,6367,6480,7332,3473
37069,18899,9212,9687,6310,2751,6888,2950
37072,30215,14649,15566,7412,7382,9352,6069
37073,13350,6517,6833,3761,3226,3964,2399
37074,6965,3423,3542,1896,1626,2052,1391
37075,59256,28752,30504,16645,14003,17750,10858
37076,35230,16854,18376,8403,11721,9520,5586
37078,674,341,333,133,131,233,177
37079,2578,1319,1259,709,566,820,483
37080,7384,3713,3671,1703,1554,2497,1630
37082,6107,3065,3042,1612,1283,2260,952
37083,13909,6800,7109,3829,3442,3788,2850
37085,4035,2008,2027,1164,958,1306,607
37086,31513,15474,16039,10805,10092,7918,2698
37087,41132,20023,21109,11292,10572,11471,7797
37090,12922,6379,6543,3268,2827,4217,2610
37091,21005,10129,10876,5632,5098,6102,4173
37095,1854,965,889,403,402,643,406
37096,5503,2757,2746,1299,1155,1524,1525
37097,2294,1150,1144,641,521,616,516
37098,5382,2657,2725,1545,1354,1547,936
37101,6422,3169,3253,1722,1476,1840,1384
37110,32495,15934,16561,8639,7896,8904,7056
37115,37316,17709,19607,9821,11141,9822,6532
37118,1264,638,626,333,267,432,232
37122,46463,22832,23631,13129,10848,14855,7631
37127,15786,7849,7937,4319,4633,4471,2363
37128,38966,18965,20001,11710,13542,9709,4005
37129,49103,24477,24626,14096,13747,14029,7231
37130,52070,25854,26216,13554,20728,11071,6717
37132,2776,1420,1356,1725,1035,16,0
37134,3061,1524,1537,827,658,874,702
37135,9681,4809,4872,3320,2245,3035,1081
37137,2725,1382,1343,729,643,846,507
37138,22191,10745,11446,5562,5192,7078,4359
37140,1365,1305,60,43,801,455,66
37141,1224,598,626,360,333,307,224
37142,1902,971,931,553,411,596,342
37143,3818,1930,1888,982,780,1352,704
37144,3344,1699,1645,891,721,996,736
37145,2157,1105,1052,600,456,668,433
37146,7182,3541,3641,2230,1823,2161,968
37148,22320,10983,11337,6636,6072,5946,3666
37149,2210,1127,1083,515,454,764,477
37150,4894,2422,2472,1275,1067,1404,1148
37151,565,296,269,162,153,151,99
37153,5520,2787,2733,1697,1286,1788,749
37160,32744,16202,16542,9673,8731,8318,6022
37165,70,32,38,17,14,20,19
37166,13446,6608,6838,3475,3308,3716,2947
37167,49322,24122,25200,14892,14502,13698,6230
37171,917,466,451,223,184,305,205
37172,28714,14074,14640,7729,7679,8100,5206
37174,26418,12847,13571,8871,8124,6692,2731
37175,1015,522,493,200,177,284,354
37178,2112,1040,1072,566,486,571,489
37179,11767,5815,5952,4042,2956,3598,1171
37180,3033,1492,1541,942,778,813,500
37181,1534,800,734,440,337,467,290
37183,3229,1617,1612,841,702,976,710
37184,5844,2907,2937,1601,1326,1802,1115
37185,8638,4214,4424,2149,1827,2404,2258
37186,9184,4535,4649,2733,2200,2619,1632
37187,6829,3398,3431,1842,1771,1998,1218
37188,13643,6584,7059,4261,3532,3991,1859
37189,3320,1602,1718,814,837,1007,662
37190,8787,4282,4505,2189,2032,2532,2034
37191,4020,1985,2035,1168,1066,1225,561
37201,2137,1734,403,149,1328,559,101
37203,11883,6211,5672,2021,5482,2928,1452
37204,12031,5631,6400,2437,4893,2874,1827
37205,24057,11049,13008,4955,5754,6868,6480
37206,25699,12714,12985,6775,9085,6729,3110
37207,34880,16142,18738,11069,9466,9205,5140
37208,16067,7329,8738,4420,5127,4122,2398
37209,35457,18081,17376,8461,13862,8819,4315
37210,16067,7887,8180,4602,5245,3954,2266
37211,74755,38173,36582,19507,29260,17419,8569
37212,20148,9595,10553,5207,10442,2845,1654
37213,218,181,37,33,70,98,17
37214,28973,13870,15103,5873,9471,8518,5111
37215,21190,9784,11406,4046,5324,6163,5657
37216,17848,8647,9201,3901,5519,5355,3073
37217,29599,15090,14509,7763,11139,7324,3373
37218,14855,6536,8319,3628,3566,4130,3531
37219,1162,687,475,56,685,314,107
37220,5786,2842,2944,1277,1127,1857,1525
37221,36610,16904,19706,8362,10555,10883,6810
37228,1160,426,734,228,489,162,281
37240,754,323,431,219,535,0,0
37243,0,0,0,0,0,0,0
37246,0,0,0,0,0,0,0
37301,1429,720,709,399,335,379,316
37302,3730,1843,1887,932,902,1157,739
37303,25461,12217,13244,6507,6067,7071,5816
37305,889,447,442,223,209,237,220
37306,2760,1391,1369,756,620,782,602
37307,4870,2437,2433,1232,1194,1406,1038
37308,2772,1397,1375,659,642,892,579
37309,2138,1100,1038,569,451,624,494
37310,4135,2048,2087,1099,910,1300,826
37311,27373,13307,14066,7419,8660,6680,4614
37312,30962,14881,16081,7716,7337,8602,7307
37313,1731,852,879,439,413,479,400
37315,1556,689,867,605,938,8,5
37317,2403,1189,1214,505,457,701,740
37318,1978,949,1029,492,453,570,463
37321,19113,9323,9790,5321,4927,5001,3864
37322,8239,4084,4155,2056,1894,2409,1880
37323,30439,14909,15530,8227,7675,8759,5778
37324,5322,2587,2735,1361,1248,1440,1273
37325,1845,929,916,500,372,560,413
37326,467,180,287,70,73,89,235
37327,11174,5584,5590,3014,2589,3082,2489
37328,1364,700,664,371,320,391,282
37329,5588,2742,2846,1451,1159,1637,1341
37330,6784,3368,3416,1605,1461,2143,1575
37331,7656,3673,3983,1826,1539,2153,2138
37332,2609,1282,1327,704,598,772,535
37333,534,266,268,134,103,154,143
37334,21700,10347,11353,5579,4681,6228,5212
37335,2778,1392,1386,742,647,845,544
37336,4202,2108,2094,1020,924,1332,926
37337,1470,740,730,319,326,465,360
37338,3093,1540,1553,841,729,895,628
37339,2018,992,1026,576,449,579,414
37340,607,300,307,121,135,199,152
37341,12085,6021,6064,2995,2775,3914,2401
37342,3593,1779,1814,988,924,1000,681
37343,40042,19417,20625,9711,9618,11677,9036
37345,2311,1121,1190,626,571,602,512
37347,7559,3732,3827,1778,1814,2252,1715
37348,1131,587,544,300,239,349,243
37350,1866,882,984,516,230,586,534
37351,390,168,222,80,143,92,75
37352,3268,1587,1681,784,709,903,872
37353,4513,2249,2264,1098,948,1424,1043
37354,16483,8215,8268,4279,3946,4520,3738
37355,25596,12538,13058,6952,6285,6957,5402
37356,2486,1176,1310,563,534,647,742
37357,5512,2759,2753,1565,1254,1649,1044
37359,783,397,386,176,168,257,182
37360,1732,879,853,410,338,565,419
37361,1478,753,725,400,347,415,316
37362,3395,1692,1703,902,815,1028,650
37363,32244,15759,16485,8375,7928,9697,6244
37365,1314,653,661,346,276,378,314
37366,828,411,417,203,173,224,228
37367,10247,5596,4651,2448,2404,3102,2293
37369,956,470,486,213,170,302,271
37370,4652,2334,2318,1151,1015,1442,1044
37373,3074,1552,1522,686,627,994,767
37374,2047,1025,1022,540,491,589,427
37375,3711,1783,1928,1004,1295,711,701
37376,418,206,212,76,85,150,107
37377,15310,7362,7948,4240,2439,4667,3964
37379,26835,13125,13710,6707,6136,8372,5620
37380,6289,3051,3238,1527,1389,1887,1486
37381,8855,4405,4450,2007,1704,2591,2553
37385,8131,4056,4075,2020,1705,2415,1991
37387,3323,1672,1651,789,787,879,868
37388,24494,11744,12750,6482,5385,6897,5730
37391,1598,801,797,347,336,479,436
37394,105,53,52,21,21,34,29
37396,257,130,127,39,54,86,78
37397,10127,4969,5158,2569,2369,2965,2224
37398,14347,6924,7423,3488,3059,4014,3786
37402,3917,2031,1886,796,1172,1068,881
37403,5811,2747,3064,2254,2221,796,540
37404,13327,6626,6701,3690,4113,3394,2130
37405,14597,6952,7645,2644,5413,3521,3019
37406,14627,6537,8090,4437,3628,3760,2802
37407,8932,4291,4641,2986,2590,2177,1179
37408,1486,803,683,300,562,384,240
37409,2851,1397,1454,563,983,755,550
37410,3886,1651,2235,1337,997,908,644
37411,17587,8153,9434,4360,4713,5161,3353
37412,20951,9911,11040,4519,5878,5618,4936
37415,23873,11437,12436,4771,7220,6345,5537
37416,14486,6857,7629,3430,3659,4294,3103
37419,6100,2963,3137,1212,1346,1923,1619
37421,46228,22353,23875,10558,12443,12934,10293
37601,36182,17185,18997,8479,10048,9879,7776
37604,34245,16957,17288,6950,10851,8788,7656
37614,2107,929,1178,1310,793,4,0
37615,19560,9528,10032,4667,5070,5941,3882
37616,4874,2436,2438,1182,1090,1442,1160
37617,14251,7177,7074,3104,3267,4396,3484
37618,12747,6331,6416,2965,2834,4052,2896
37620,39102,18964,20138,8978,8988,11362,9774
37640,3743,1904,1839,763,782,1206,992
37641,8567,4247,4320,2081,1908,2557,2021
37642,14947,7330,7617,3595,3293,4542,3517
37643,33689,16209,17480,7822,7718,9614,8535
37645,5145,2526,2619,1233,1231,1511,1170
37650,12750,6172,6578,2863,2726,3577,3584
37656,3677,1853,1824,790,753,1183,951
37657,972,467,505,189,215,306,262
37658,4386,2210,2176,957,941,1357,1131
37659,27585,13689,13896,6467,6868,8166,6084
37660,40038,18827,21211,9328,8842,11117,10751
37663,14617,7128,7489,3447,2915,4597,3658
37664,26880,12762,14118,6241,5581,7869,7189
37665,5589,2707,2882,1387,1340,1534,1328
37680,766,382,384,174,178,231,183
37681,6121,3053,3068,1473,1327,1886,1435
37682,667,288,379,246,387,17,17
37683,13021,7189,5832,2680,3356,3867,3118
37686,7072,3533,3539,1541,1620,2302,1609
37687,5038,2639,2399,1135,1180,1522,1201
37688,1018,508,510,195,150,317,356
37690,4122,2050,2072,1040,980,1241,861
37691,894,458,436,202,187,264,241
37692,4770,2431,2339,1073,1003,1551,1143
37694,1955,1003,952,459,403,658,435
37701,6817,3234,3583,1659,1693,1877,1588
37705,4559,2264,2295,1113,942,1447,1057
37708,6563,3286,3277,1534,1435,2011,1583
37709,3732,1910,1822,961,857,1138,776
37710,1141,560,581,273,239,370,259
37711,5044,2494,2550,1322,1139,1503,1080
37713,1488,772,716,321,295,500,372
37714,4547,2281,2266,1133,1039,1347,1028
37715,1000,492,508,248,235,295,222
37716,25749,12570,13179,6164,5802,7672,6111
37719,168,85,83,39,36,52,41
37721,12733,6178,6555,3254,3149,3835,2495
37722,6060,3018,3042,1367,1263,1931,1499
37723,944,488,456,205,182,315,242
37724,2874,1431,1443,595,948,756,575
37725,16919,8424,8495,3971,3476,5104,4368
37726,2037,1015,1022,490,398,622,527
37727,2043,1028,1015,437,370,688,548
37729,1456,720,736,364,348,430,314
37730,59,34,25,16,12,20,11
37731,711,365,346,151,137,224,199
37732,139,70,69,37,32,41,29
37733,64,36,28,7,10,17,30
37737,5785,2844,2941,1351,1220,1933,1281
37738,5288,2679,2609,986,1278,1586,1438
37742,5837,2872,2965,1441,1219,1823,1354
37743,25588,12526,13062,5869,5645,7415,6659
37745,18401,8911,9490,4411,4310,5090,4590
37748,17857,8765,9092,4220,3851,5343,4443
37752,6516,3137,3379,1657,1625,1740,1494
37753,814,414,400,184,189,249,192
37754,4729,2385,2344,1249,1004,1489,987
37755,3688,1833,1855,1017,970,1059,642
37756,2810,1364,1446,734,609,816,651
37757,9337,4544,4793,2349,2455,2592,1941
37760,12931,6203,6728,3547,3657,3100,2627
37762,3126,1497,1629,723,695,858,850
37763,15794,7811,7983,3524,3292,4776,4202
37764,9258,4575,4683,2340,2128,2784,2006
37765,546,270,276,136,113,145,152
37766,18850,9108,9742,4556,4185,5249,4860
37769,5990,2909,3081,1450,1275,1724,1541
37770,2646,1326,1320,670,584,781,611
37771,15380,7476,7904,4121,3931,4088,3240
37772,11146,5572,5574,2462,2216,3586,2882
37774,18321,8922,9399,3406,2902,4602,7411
37777,11274,5653,5621,2496,2960,3522,2296
37779,3978,1989,1989,1138,967,1160,713
37801,25124,12092,13032,6452,6177,7112,5383
37803,31668,15163,16505,7952,6461,9434,7821
37804,24682,11862,12820,6384,6323,6623,5352
37806,2868,1418,1450,696,628,899,645
37807,9923,4990,4933,2639,2398,2919,1967
37809,2278,1120,1158,586,508,681,503
37810,1928,989,939,485,434,604,405
37811,3215,1617,1598,710,682,1014,809
37813,17444,8406,9038,4786,4338,4647,3673
37814,33071,16103,16968,8491,8246,8716,7618
37818,4998,2462,2536,1259,1159,1412,1168
37819,713,358,355,175,158,217,163
37820,7495,3733,3762,2001,1754,2153,1587
37821,22608,10787,11821,5605,5236,6468,5299
37825,8399,4096,4303,2024,1933,2486,1956
37826,4361,2145,2216,1078,908,1370,1005
37828,1430,680,750,331,212,412,475
37829,1804,893,911,477,396,552,379
37830,29700,14022,15678,7130,6399,8498,7673
37840,10021,4912,5109,2549,2273,2950,2249
37841,9605,4661,4944,2812,2291,2595,1907
37843,3725,1837,1888,864,773,1155,933
37845,494,255,239,124,107,160,103
37846,5030,2524,2506,1418,1241,1507,864
37847,2714,1368,1346,768,688,756,502
37848,246,122,124,42,54,92,58
37849,25459,12318,13141,6729,6235,7322,5173
37851,36,18,18,9,10,12,5
37852,2558,1285,1273,621,646,743,548
37853,3815,1893,1922,920,879,1146,870
37854,13108,6416,6692,3062,2674,3876,3496
37857,21309,10434,10875,5358,4685,6225,5041
37860,4113,2108,2005,1093,1061,1170,789
37861,8340,4107,4233,2019,1833,2440,2048
37862,20934,10145,10789,4864,5348,5489,5233
37863,6569,3350,3219,1558,1867,1748,1396
37865,20912,10271,10641,5379,4738,6314,4481
37866,1699,835,864,354,309,562,474
37869,5031,2483,2548,1248,1161,1456,1166
37870,4580,2253,2327,1021,917,1398,1244
37871,9134,4528,4606,2410,2146,2752,1826
37872,2041,1015,1026,553,439,616,433
37873,4073,2027,2046,946,892,1223,1012
37874,14979,7276,7703,3941,3399,4320,3319
37876,29246,14370,14876,7457,6744,9018,6027
37877,8464,4118,4346,1989,1847,2568,2060
37878,514,270,244,82,104,170,158
37879,10634,5246,5388,2622,2500,3121,2391
37880,3477,1769,1708,702,655,1104,1016
37881,2291,1152,1139,597,517,658,519
37882,2724,1368,1356,471,449,885,919
37885,5067,2524,2543,1009,906,1388,1764
37886,4418,2171,2247,1031,870,1444,1073
37887,7511,4859,2652,1386,2721,2189,1215
37888,2741,1341,1400,703,601,838,599
37890,6668,3270,3398,1737,1488,1831,1612
37891,3626,1751,1875,928,851,1082,765
37892,2007,984,1023,569,509,554,375
37902,1586,787,799,76,914,412,184
37909,15168,7178,7990,2997,6321,3072,2778
37912,20673,9762,10911,4740,6876,5175,3882
37914,19663,9343,10320,4810,4339,5779,4735
37915,5647,2531,3116,1714,1541,1660,732
37916,12507,6645,5862,4359,7667,235,246
37917,24072,11758,12314,4934,7498,6715,4925
37918,42835,20794,22041,10948,11774,11716,8397
37919,28194,13570,14624,5811,8810,7522,6051
37920,39087,19112,19975,8230,12702,10353,7802
37921,28233,13488,14745,7972,8810,7319,4132
37922,33180,16304,16876,9890,6762,11145,5383
37923,27457,13489,13968,6036,9168,7151,5102
37924,11259,5419,5840,2764,2902,3197,2396
37931,26109,12799,13310,6987,7367,7548,4207
37932,14527,7179,7348,3939,3699,4588,2301
37934,24107,11764,12343,6641,3920,8128,5418
37938,17085,8381,8704,4663,3664,5191,3567
38001,4719,2238,2481,1281,1072,1273,1093
38002,38927,19235,19692,12989,9570,11558,4810
38004,9866,4831,5035,3255,2446,2923,1242
38006,5207,2476,2731,1460,1273,1322,1152
38007,91,42,49,21,19,29,22
38008,9721,4528,5193,2673,2190,2710,2148
38011,9908,4862,5046,3084,2354,2893,1577
38012,14575,6769,7806,4246,3355,4214,2760
38015,2828,1398,1430,778,644,848,558
38016,43079,20347,22732,11477,14147,11591,5864
38017,48642,23795,24847,14898,9939,16700,7105
38018,35059,16548,18511,9672,10689,9973,4725
38019,15601,7352,8249,4569,3805,4208,3019
38021,59,29,30,16,20,11,12
38023,6146,3037,3109,1752,1468,1863,1063
38024,27406,13099,14307,7502,6484,7667,5753
38028,6883,3466,3417,1670,1080,2501,1632
38029,80,44,36,17,12,27,24
38030,977,491,486,245,229,269,234
38034,2998,1494,1504,801,669,890,638
38036,478,221,257,130,105,125,118
38037,1773,859,914,474,420,513,366
38039,1804,858,946,546,420,505,333
38040,5193,2535,2658,1450,1220,1438,1085
38041,5085,3753,1332,707,2257,1553,568
38042,796,390,406,194,181,227,194
38044,865,414,451,209,172,255,229
38046,108,49,59,19,14,42,33
38047,91,47,44,25,22,30,14
38049,4984,2716,2268,1161,1489,1490,844
38050,459,219,240,116,93,132,118
38052,3907,1922,1985,1029,848,1102,928
38053,27932,13691,14241,7645,6333,8483,5471
38054,284,215,69,66,192,25,1
38057,3649,1778,1871,996,816,1033,804
38058,10236,4991,5245,3209,2474,3045,1508
38059,7663,3734,3929,2220,1843,2147,1453
38060,9496,4704,4792,2532,2770,2516,1678
38061,977,487,490,244,198,303,232
38063,17403,8274,9129,5232,4289,4643,3239
38066,2630,1334,1296,597,536,898,599
38067,1476,740,736,369,261,437,409
38068,10941,5332,5609,2877,2389,3143,2532
38069,2376,1167,1209,595,487,792,502
38070,175,85,90,44,38,55,38
38075,6936,5147,1789,998,2995,2146,797
38076,847,422,425,205,141,306,195
38077,43,22,21,3,9,12,19
38079,5559,3892,1667,865,2143,1625,926
38080,2568,1245,1323,684,552,695,637
38103,12180,7515,4665,1005,7103,2998,1074
38104,23409,11847,11562,3896,8301,6947,4265
38105,6184,3279,2905,1335,2074,2002,773
38106,27222,12771,14451,8016,6211,7257,5738
38107,17698,8304,9394,5063,4775,4883,2977
38108,18729,9264,9465,5767,4913,4806,3243
38109,46594,21139,25455,13969,10580,12243,9802
38111,41742,20198,21544,11445,13614,10034,6649
38112,17472,8339,9133,5226,5246,4429,2571
38114,26905,12470,14435,7846,6836,7061,5162
38115,39129,17904,21225,13051,13710,8647,3721
38116,40404,18511,21893,12881,10843,10990,5690
38117,26125,12274,13851,5989,6942,7037,6157
38118,41465,19547,21918,14569,12614,10381,3901
38119,22330,10117,12213,5277,6060,6051,4942
38120,14237,6742,7495,3208,3136,4065,3828
38122,25270,12827,12443,7246,8233,6237,3554
38125,36150,16956,19194,11257,10581,10537,3775
38126,7334,3339,3995,2975,1853,1640,866
38127,45248,20607,24641,16439,11857,11541,5411
38128,44863,20680,24183,15842,12954,10931,5136
38131,0,0,0,0,0,0,0
38132,7,2,5,1,4,2,0
38133,20787,10077,10710,6158,5553,6102,2974
38134,41948,21348,20600,10531,14590,10774,6053
38135,30657,14715,15942,9027,6998,9557,5075
38138,24045,11489,12556,5574,4253,7438,6780
38139,16086,7879,8207,4889,2100,5991,3106
38141,22462,10470,11992,7999,6626,6113,1724
38152,834,146,688,372,460,2,0
38201,10093,4896,5197,2645,2473,2596,2379
38220,1849,875,974,455,366,573,455
38221,3308,1648,1660,648,559,1027,1074
38222,2629,1356,1273,488,493,817,831
38224,956,483,473,293,209,262,192
38225,6283,3022,3261,1498,1407,1779,1599
38226,345,174,171,74,70,120,81
38229,2931,1459,1472,739,670,891,631
38230,3736,1798,1938,954,831,1049,902
38231,1664,818,846,448,354,513,349
38232,1998,1027,971,454,445,603,496
38233,2852,1380,1472,722,626,818,686
38235,441,220,221,123,91,116,111
38236,662,331,331,173,145,199,145
38237,16627,8161,8466,4466,5688,3559,2914
38240,2259,1105,1154,591,489,633,546
38241,898,465,433,195,172,279,252
38242,20151,9514,10637,5092,4414,5496,5149
38251,2751,1410,1341,614,591,785,761
38253,1156,574,582,312,260,352,232
38254,85,44,41,22,19,26,18
38255,2299,1140,1159,551,486,667,595
38256,3089,1524,1565,493,427,965,1204
38257,4397,2071,2326,1040,932,1285,1140
38258,1500,728,772,356,322,430,392
38259,860,430,430,207,179,255,219
38260,3804,1893,1911,1026,848,1106,824
38261,16919,8035,8884,4270,4055,4689,3905
38301,36613,17426,19187,10447,9539,9545,7082
38305,49808,23338,26470,14029,13580,13505,8694
38310,6145,3040,3105,1600,1266,1690,1589
38311,786,387,399,144,139,254,249
38313,3204,1603,1601,820,729,973,682
38315,3876,1925,1951,1025,873,1095,883
38316,2917,1430,1487,724,629,893,671
38317,2537,1201,1336,629,526,675,707
38318,476,254,222,120,110,108,138
38320,10686,5162,5524,2536,2208,3019,2923
38321,2431,1176,1255,559,526,742,604
38326,2533,1275,1258,450,431,850,802
38327,477,225,252,89,102,153,133
38328,730,370,360,181,175,215,159
38329,3220,1622,1598,752,644,920,904
38330,4404,2062,2342,1179,972,1165,1088
38332,1120,553,567,268,227,322,303
38333,523,263,260,104,109,167,143
38334,1911,956,955,521,427,505,458
38337,1366,672,694,322,302,434,308
38339,637,322,315,146,133,195,163
38340,12935,6153,6782,3782,3622,3053,2478
38341,2252,1148,1104,516,440,707,589
38342,1438,702,736,385,258,465,330
38343,15619,7420,8199,3985,3441,4467,3726
38344,8684,4162,4522,2221,1842,2469,2152
38345,2089,1014,1075,579,483,638,389
38347,270,144,126,54,72,71,73
38348,1037,511,526,252,238,311,236
38351,17603,8399,9204,4744,4241,4877,3741
38352,494,250,244,113,100,173,108
38355,5882,2860,3022,1989,1694,1427,772
38356,2193,1031,1162,561,459,688,485
38357,2757,1348,1409,708,600,789,660
38358,12121,5691,6430,3371,2673,3374,2703
38359,278,135,143,66,59,75,78
38361,994,480,514,248,206,289,251
38362,1145,542,603,360,347,303,135
38363,6097,2965,3132,1524,1372,1607,1594
38365,16,9,7,4,6,6,0
38366,2267,1169,1098,561,472,683,551
38367,2843,1412,1431,735,683,793,632
38368,1985,964,1021,520,477,563,425
38369,1887,908,979,491,368,561,467
38370,670,328,342,141,118,188,223
38371,1235,594,641,288,220,367,360
38372,17595,8474,9121,4437,3848,4989,4321
38374,2052,971,1081,538,444,568,502
38375,9251,4476,4775,2417,2013,2559,2262
38376,233,112,121,51,43,80,59
38379,1171,598,573,272,239,321,339
38380,574,298,276,96,84,167,227
38381,1640,806,834,420,379,481,360
38382,9515,4608,4907,2469,2108,2644,2294
38387,375,189,186,81,88,115,91
38388,1840,901,939,467,444,540,389
38390,907,451,456,221,202,277,207
38391,1174,600,574,264,233,404,273
38392,776,398,378,181,172,240,183
38401,54469,26178,28291,14568,13619,15632,10650
38425,3724,2844,880,441,1625,1125,533
38449,2811,1379,1432,661,604,883,663
38450,2778,1374,1404,694,618,813,653
38451,4814,2405,2409,1281,1062,1578,893
38452,1091,537,554,276,225,341,249
38453,373,190,183,88,77,117,91
38454,1208,616,592,305,256,399,248
38455,227,111,116,42,47,80,58
38456,4559,2258,2301,1729,1000,1076,754
38457,808,387,421,206,175,246,181
38459,453,229,224,99,110,133,111
38460,1410,704,706,403,321,405,281
38461,1379,689,690,379,276,431,293
38462,10297,5001,5296,2711,2307,2876,2403
38463,2817,1455,1362,733,659,833,592
38464,22293,10748,11545,5777,5025,6172,5319
38468,5201,2591,2610,1407,1182,1418,1194
38469,4092,2014,2078,1077,886,1197,932
38471,530,261,269,106,102,169,153
38472,2656,1329,1327,645,583,813,615
38473,1061,526,535,269,253,316,223
38474,7802,3776,4026,2107,1721,2334,1640
38475,635,337,298,187,138,165,145
38476,1228,609,619,303,259,406,260
38477,2766,1409,1357,629,527,947,663
38478,17733,8504,9229,4438,4138,4980,4177
38481,896,445,451,183,186,284,243
38482,1535,763,772,402,342,474,317
38483,5663,2812,2851,1766,1340,1575,982
38485,6502,3158,3344,1586,1395,1799,1722
38486,967,483,484,231,230,315,191
38487,1057,545,512,288,230,335,204
38488,2524,1286,1238,675,552,790,507
38501,36687,18261,18426,9018,12284,8460,6925
38504,901,467,434,208,170,297,226
38505,1806,1057,749,1206,600,0,0
38506,26521,12893,13628,6804,6027,7625,6065
38541,1613,811,802,377,309,451,476
38542,22,11,11,3,4,10,5
38543,560,267,293,122,110,159,169
38544,6543,3236,3307,1619,1516,1920,1488
38545,1474,729,745,405,330,463,276
38547,1975,998,977,514,456,584,421
38548,731,392,339,181,153,227,170
38549,3679,1842,1837,780,694,995,1210
38551,4106,2051,2055,951,768,1193,1194
38552,275,134,141,70,55,95,55
38553,2312,1148,1164,618,528,664,502
38554,827,429,398,194,184,232,217
38555,18809,8995,9814,4617,4217,4897,5078
38556,12540,6135,6405,3141,2662,3614,3123
38558,6970,3307,3663,312,296,871,5491
38559,1340,664,676,343,308,364,325
38560,1425,695,730,396,312,437,280
38562,6554,3233,3321,1478,1356,1998,1722
38563,2330,1143,1187,643,590,667,430
38564,453,238,215,63,63,143,184
38565,1098,555,543,339,282,289,188
38567,784,392,392,214,182,237,151
38568,2034,1047,987,481,437,646,470
38569,363,179,184,86,76,115,86
38570,9898,4788,5110,2470,2159,2780,2489
38571,13848,6908,6940,3493,2861,3915,3579
38572,10649,5287,5362,2170,2025,2990,3464
38573,2198,1118,1080,578,457,621,542
38574,8413,4159,4254,2257,1869,2323,1964
38575,1172,555,617,266,257,357,292
38577,1153,575,578,259,205,366,323
38578,177,67,110,1,1,4,171
38579,1063,526,537,254,223,320,266
38580,1743,850,893,480,438,466,359
38581,4112,2088,2024,1035,991,1209,877
38582,1426,718,708,323,258,454,391
38583,23825,11691,12134,5935,5265,6759,5866
38585,3717,1851,1866,899,827,1073,918
38587,1301,655,646,284,273,401,343
38588,1011,519,492,230,187,329,265
38589,200,110,90,59,31,58,52
42223,6152,3387,2765,2447,3129,559,17
42602,47,24,23,2,7,16,22
72338,9,5,4,4,2,3,0
73949,410,203,207,129,74,120,87
75001,12414,6185,6229,1986,6096,3016,1316
75002,63140,31093,32047,21584,15594,19564,6398
75006,46364,23012,23352,13315,13900,12697,6452
75007,51624,25189,26435,14734,12994,17085,6811
75009,8785,4385,4400,2923,1985,2568,1309
75010,21607,10257,11350,6239,6578,6589,2201
75013,30347,14905,15442,10791,7301,9679,2576
75019,38666,18982,19684,12635,8193,14299,3539
75020,21872,10411,11461,5598,4935,6046,5293
75021,8036,3957,4079,1998,1682,2438,1918
75022,22545,11288,11257,8315,3684,8339,2207
75023,45452,22006,23446,11856,11556,14288,7752
75024,36039,17582,18457,9617,12144,11277,3001
75025,50926,24807,26119,16141,11524,17940,5321
75028,42226,20823,21403,14318,8381,15508,4019
75032,27986,13947,14039,9367,6327,8535,3757
75034,72723,35807,36916,25234,20914,19659,6916
75035,47553,23059,24494,16702,14209,13045,3597
75038,27802,13912,13890,7087,12848,6000,1867
75039,11032,5579,5453,1354,6815,2342,521
75040,59406,29217,30189,19677,16331,16076,7322
75041,30700,15281,15419,10564,8991,7088,4057
75042,37881,19027,18854,12921,11108,9080,4772
75043,58094,27957,30137,17409,15915,15855,8915
75044,40811,19713,21098,10830,10461,12885,6635
75048,20328,9934,10394,6607,5463,6251,2007
75050,41041,20490,20551,12906,13466,10010,4659
75051,39285,19115,20170,14135,11834,8594,4722
75052,88996,43219,45777,30187,25475,24896,8438
75054,5053,2470,2583,1852,1616,1299,286
75056,47852,23890,23962,14717,15374,13899,3862
75057,12900,6542,6358,3742,4779,2920,1459
75058,2982,1437,1545,938,640,842,562
75060,45980,23126,22854,15318,12825,11979,5858
75061,53442,27031,26411,17503,17425,12587,5927
75062,44537,22121,22416,13147,14473,11006,5911
75063,35090,17134,17956,8914,14997,8536,2643
75065,10748,5321,5427,3249,2862,3207,1430
75067,60982,30071,30911,17149,24206,14278,5349
75068,34934,17214,17720,12413,11734,8013,2774
75069,34108,16705,17403,10303,9142,8425,6238
75070,74734,36387,38347,25685,20903,20279,7867
75071,36090,18189,17901,12357,10861,9205,3667
75074,44622,22659,21963,13631,14337,11213,5441
75075,33262,16289,16973,8042,7999,9634,7587
75076,7378,3739,3639,1557,1229,2314,2278
75077,35330,17266,18064,10229,7751,12031,5319
75078,10592,5267,5325,3915,2502,3235,940
75080,44009,21900,22109,11504,13691,10570,8244
75081,34156,16583,17573,8579,9681,9589,6307
75082,21182,10430,10752,6022,4731,7289,3140
75087,28145,13618,14527,8443,6557,8233,4912
75088,24712,12163,12549,7181,5468,8584,3479
75089,30251,14832,15419,10433,7499,9416,2903
75090,23724,11552,12172,7418,6742,5637,3927
75092,22839,10934,11905,5883,6011,6120,4825
75093,47187,22576,24611,12799,10622,16443,7323
75094,20579,10248,10331,7769,4955,6011,1844
75098,48197,23603,24594,16886,14281,12514,4516
75101,646,322,324,243,168,144,91
75102,1322,659,663,364,293,370,295
75103,12851,6366,6485,3304,2680,3455,3412
75104,45373,21192,24181,14898,11914,13293,5268
75105,301,159,142,78,62,70,91
75109,3658,1845,1813,995,711,1117,835
75110,28132,13757,14375,8820,7215,6840,5257
75114,4660,2341,2319,1538,1187,1386,549
75115,48877,22451,26426,14441,11785,14491,8160
75116,19669,9431,10238,6275,5329,4731,3334
75117,3722,1824,1898,987,717,1049,969
75119,26601,13081,13520,8523,6914,6786,4378
75124,4446,2182,2264,1165,917,1315,1049
75125,6691,3335,3356,2306,1664,1828,893
75126,33396,16263,17133,12002,9834,8568,2992
75127,1593,801,792,434,325,480,354
75132,294,150,144,88,115,55,36
75134,20276,9288,10988,7114,5918,5126,2118
75135,5910,2912,2998,1898,1371,1679,962
75137,18861,8884,9977,5573,4450,5505,3333
75140,6958,3452,3506,1878,1522,1801,1757
75141,5374,3739,1635,1100,2382,1449,443
75142,18982,9500,9482,5890,4601,5414,3077
75143,14619,7268,7351,3498,2892,4422,3807
75144,3291,1635,1656,847,619,979,846
75146,17993,8314,9679,5833,4853,5070,2237
75147,6602,3243,3359,1800,1503,1854,1445
75148,5842,2851,2991,1455,1155,1608,1624
75149,56065,26792,29273,19158,15292,14475,7140
75150,58730,27921,30809,17898,17403,15129,8300
75152,4606,2319,2287,1465,1149,1312,680
75153,605,319,286,188,118,187,112
75154,36041,17558,18483,12027,9001,10500,4513
75155,2579,1347,1232,916,680,688,295
75156,14580,7208,7372,3338,2827,4058,4357
75157,310,146,164,84,64,98,64
75158,4139,2062,2077,1171,865,1291,812
75159,18339,9932,8407,5284,5432,5061,2562
75160,23627,11371,12256,7007,5878,6438,4304
75161,6165,3135,3030,1485,1207,2127,1346
75163,2285,1102,1183,414,354,701,816
75164,671,340,331,197,164,215,95
75165,37966,18610,19356,11619,10515,9656,6176
75166,3070,1514,1556,970,849,869,382
75167,8436,4270,4166,2712,1903,2603,1218
75169,14644,7165,7479,3828,3010,4325,3481
75172,3956,2041,1915,1233,1292,1011,420
75173,4353,2192,2161,1292,1030,1407,624
75180,23031,11133,11898,8593,6915,5294,2229
75181,25908,12492,13416,9234,6493,8146,2035
75182,5118,2542,2576,1477,889,1859,893
75189,22406,11240,11166,7523,6301,6063,2519
75201,9409,5070,4339,547,6034,2145,683
75202,1666,927,739,74,1132,378,82
75203,15721,8186,7535,5220,5142,3706,1653
75204,26279,13656,12623,3918,15458,5004,1899
75205,23061,10981,12080,7039,6150,6452,3420
75206,36248,18952,17296,5438,19871,7676,3263
75207,9648,7334,2314,558,6107,2812,171
75208,30171,15925,14246,9345,9029,8125,3672
75209,13653,6697,6956,2816,4106,4115,2616
75210,7482,3660,3822,2425,2084,1890,1083
75211,73146,36755,36391,27138,23757,15526,6725
75212,24884,12349,12535,9797,6815,5426,2846
75214,32950,15956,16994,7407,11249,9088,5206
75215,14648,7470,7178,3602,3744,4551,2751
75216,49416,23730,25686,15286,12705,12235,9190
75217,80324,39974,40350,31195,23928,17705,7496
75218,21665,10476,11189,4570,5937,6909,4249
75219,22124,12433,9691,3415,9432,6306,2971
75220,41891,22836,19055,14243,15614,8893,3141
75223,13947,7237,6710,4686,4343,3424,1494
75224,34034,16713,17321,12305,10401,7463,3865
75225,20892,9847,11045,6075,2941,6625,5251
75226,3506,2048,1458,499,1911,912,184
75227,55029,27190,27839,20098,16399,13131,5401
75228,66551,32181,34370,21555,20372,15888,8736
75229,31571,16168,15403,9203,7846,8952,5570
75230,26934,12974,13960,6184,5812,7911,7027
75231,37052,19251,17801,11543,13970,7976,3563
75232,28682,13546,15136,8658,7308,7100,5616
75233,14043,6846,7197,4685,4193,3106,2059
75234,28794,14071,14723,8135,7538,7593,5528
75235,17177,9501,7676,4634,6713,4209,1621
75236,15949,7391,8558,5958,5217,3612,1162
75237,17101,7314,9787,5824,5829,4037,1411
75238,30483,14988,15495,9004,9447,7295,4737
75240,24296,12648,11648,7374,9310,4944,2668
75241,27066,12393,14673,8705,6682,6523,5156
75243,55406,26998,28408,15894,19438,13614,6460
75244,13266,6552,6714,3245,4027,3469,2525
75246,2770,1478,1292,729,1029,652,360
75247,468,281,187,44,52,152,220
75248,33395,16129,17266,6970,8627,9873,7925
75249,13373,6331,7042,4642,3902,3597,1232
75251,2331,1041,1290,208,1423,350,350
75252,24112,11904,12208,4770,8510,6760,4072
75253,18450,9300,9150,7186,5886,3899,1479
75254,23253,11626,11627,5456,10526,4888,2383
75270,0,0,0,0,0,0,0
75287,49004,23731,25273,10148,22502,12388,3966
75390,0,0,0,0,0,0,0
75401,18552,9136,9416,5811,5206,4427,3108
75402,15920,7849,8071,3992,3730,4497,3701
75407,14120,7050,7070,4502,3857,3824,1937
75409,11831,5861,5970,3958,3604,2862,1407
75410,4334,2184,2150,1036,805,1203,1290
75411,1118,572,546,248,217,331,322
75412,778,382,396,171,138,223,246
75413,305,145,160,89,69,84,63
75414,3136,1570,1566,896,692,931,617
75415,144,76,68,35,16,49,44
75416,2893,1433,1460,789,619,827,658
75417,2456,1181,1275,582,517,657,700
75418,14411,8309,6102,3091,4119,3903,3298
75420,1076,546,530,276,235,311,254
75421,1003,508,495,257,211,306,229
75422,2883,1405,1478,731,603,864,685
75423,2982,1474,1508,853,607,886,636
75424,3297,1643,1654,899,752,1045,601
75426,5301,2562,2739,1200,1051,1530,1520
75428,10089,4892,5197,2864,3557,2152,1516
75431,2052,1046,1006,631,459,540,422
75432,3323,1578,1745,880,694,871,878
75433,2773,1394,1379,738,549,788,698
75435,1185,588,597,276,268,315,326
75436,1876,923,953,509,406,496,465
75437,1078,558,520,277,222,337,242
75438,972,501,471,250,200,278,244
75439,868,424,444,250,194,240,184
75440,6350,3198,3152,1478,1166,1718,1988
75441,142,67,75,34,27,45,36
75442,8858,4348,4510,2635,1964,2650,1609
75446,3180,1584,1596,833,676,872,799
75447,1080,548,532,295,200,331,254
75448,655,325,330,146,121,198,190
75449,1186,592,594,317,214,332,323
75450,331,183,148,75,71,106,79
75451,1211,608,603,307,221,341,342
75452,4090,1984,2106,1203,866,1216,805
75453,3255,1643,1612,885,670,994,706
75454,5699,2824,2875,1983,1521,1500,695
75455,28293,13973,14320,9721,7506,6683,4383
75457,6522,3156,3366,1887,1450,1681,1504
75459,4326,2135,2191,1318,1100,1171,737
75460,23592,11028,12564,6695,6077,5810,5010
75462,11350,5536,5814,3037,2413,3240,2660
75468,888,428,460,222,138,291,237
75469,371,190,181,70,70,105,126
75470,288,137,151,85,68,86,49
75471,1424,739,685,454,363,328,279
75472,3548,1774,1774,839,666,1085,958
75473,3855,1920,1935,931,721,1163,1040
75474,14882,7480,7402,3847,3078,4693,3264
75475,129,62,67,29,23,44,33
75476,1304,648,656,313,246,401,344
75477,977,475,502,257,204,274,242
75478,932,485,447,250,205,261,216
75479,1849,897,952,455,341,533,520
75480,1646,834,812,324,261,464,597
75481,395,195,200,98,76,114,107
75482,24385,11910,12475,6860,5875,6504,5146
75486,2346,1243,1103,688,509,664,485
75487,1541,774,767,412,340,429,360
75488,1161,604,557,323,242,330,266
75489,993,469,524,333,260,235,165
75490,2211,1110,1101,634,521,617,439
75491,4801,2376,2425,1287,959,1502,1053
75492,516,251,265,107,88,138,183
75493,611,278,333,248,155,145,63
75494,10862,5490,5372,2689,2187,3007,2979
75495,7095,3495,3600,2060,1379,2255,1401
75496,3351,1675,1676,910,721,947,773
75497,3350,1730,1620,651,522,973,1204
75501,36298,18455,17843,10036,9872,10010,6380
75503,24379,11434,12945,6709,5755,6498,5417
75550,808,409,399,190,148,222,248
75551,11007,5257,5750,2861,2357,2953,2836
75554,1806,906,900,441,382,500,483
75555,1611,824,787,425,308,484,394
75556,1107,550,557,292,256,321,238
75558,1636,826,810,444,397,425,370
75559,5568,2663,2905,1430,1122,1455,1561
75560,1088,539,549,265,223,324,276
75561,5395,2631,2764,1545,1235,1481,1134
75562,176,93,83,42,31,50,53
75563,4282,2094,2188,1023,877,1210,1172
75565,361,184,177,108,87,112,54
75566,782,374,408,148,133,228,273
75567,4225,2103,2122,1271,939,1200,815
75568,2876,1404,1472,714,588,832,742
75569,2874,1362,1512,871,911,658,434
75570,11518,6925,4593,2360,3845,3188,2125
75571,2846,1327,1519,734,573,762,777
75572,3491,1690,1801,890,775,990,836
75573,181,86,95,48,40,54,39
75574,1868,963,905,516,365,560,427
75601,15849,7804,8045,3878,4244,4062,3665
75602,23286,11678,11608,7890,6776,5769,2851
75603,5456,2693,2763,1304,1120,1654,1378
75604,29934,14602,15332,9160,8498,7623,4653
75605,27823,13297,14526,6641,6924,7660,6598
75630,2588,1304,1284,442,349,813,984
75631,2787,1397,1390,795,744,708,540
75633,13977,6832,7145,3923,3356,3675,3023
75638,6036,2979,3057,1488,1288,1665,1595
75639,3460,1772,1688,913,765,1065,717
75640,4652,2340,2312,1368,987,1438,859
75641,223,106,117,58,52,64,49
75642,229,111,118,66,57,62,44
75643,2074,1055,1019,533,467,590,484
75644,11444,5520,5924,3130,2534,3003,2777
75645,9778,4939,4839,2560,2063,3025,2130
75647,13196,6384,6812,3752,3195,3597,2652
75650,8611,4282,4329,2705,2058,2516,1332
75651,2189,1094,1095,649,522,607,411
75652,16638,9856,6782,3570,5247,4966,2855
75654,12417,6045,6372,3632,2922,3259,2604
75656,4804,2283,2521,1348,1066,1220,1170
75657,8246,4001,4245,1831,1563,2425,2427
75661,2807,1418,1389,606,525,934,742
75662,24536,12062,12474,7158,6477,6381,4520
75667,1021,525,496,245,199,294,283
75668,1993,939,1054,569,443,502,479
75669,606,299,307,133,116,179,178
75670,17290,8262,9028,5445,4941,4055,2849
75672,17097,8381,8716,4387,3943,4745,4022
75681,2562,1273,1289,608,553,737,664
75682,473,221,252,120,114,128,111
75683,3914,1980,1934,1076,838,1168,832
75684,7548,3960,3588,2087,1970,2081,1410
75686,12985,6367,6618,3777,2888,3396,2924
75691,4219,2103,2116,1247,1027,1146,799
75692,5098,2544,2554,1354,1244,1433,1067
75693,6869,3373,3496,2146,1693,1903,1127
75701,34373,15800,18573,9850,9854,7482,7187
75702,27069,13317,13752,9566,8100,6071,3332
75703,37166,17611,19555,9242,10980,9114,7830
75704,8684,4253,4431,2511,2158,2308,1707
75705,2168,1036,1132,636,496,590,446
75706,8771,4432,4339,2894,2374,2226,1277
75707,13711,6633,7078,3578,3186,3686,3261
75708,7156,3601,3555,2434,1945,1737,1040
75709,5062,2499,2563,1260,1400,1427,975
75750,3937,1987,1950,1101,827,1180,829
75751,17253,8350,8903,5039,4384,4162,3668
75752,6986,3471,3515,1654,1437,2000,1895
75754,5783,2865,2918,1558,1213,1668,1344
75755,5719,2870,2849,1609,1359,1594,1157
75756,4002,1992,2010,1171,902,1120,809
75757,10022,4900,5122,2697,1997,2807,2521
75758,9072,4346,4726,2240,1813,2537,2482
75759,141,63,78,45,22,46,28
75760,2614,1252,1362,657,538,741,678
75762,12466,6200,6266,3530,3174,3327,2435
75763,6005,2939,3066,1507,1240,1644,1614
75764,233,118,115,77,61,50,45
75765,7607,3650,3957,1553,1318,1835,2901
75766,26388,13014,13374,8348,6383,6298,5359
75770,2776,1364,1412,683,591,789,713
75771,18361,8881,9480,5161,3930,4670,4600
75773,12791,6212,6579,3169,2573,3310,3739
75778,3254,1641,1613,751,626,863,1014
75779,122,67,55,33,28,44,17
75780,312,188,124,114,100,78,20
75783,7219,3470,3749,1614,1274,1976,2355
75784,658,335,323,173,123,189,173
75785,11263,6266,4997,2827,2935,3306,2195
75788,126,62,64,27,31,42,26
75789,7593,3794,3799,2122,1669,2137,1665
75790,4203,2005,2198,1337,973,1045,848
75791,13125,6393,6732,4209,3222,3671,2023
75792,3518,1792,1726,945,712,1106,755
75801,16799,8186,8613,4807,4283,4372,3337
75803,22397,14100,8297,4645,7221,6694,3837
75831,5386,2683,2703,1414,1166,1501,1305
75832,66,33,33,20,11,19,16
75833,3324,1656,1668,753,608,937,1026
75835,12012,5767,6245,3238,2463,3090,3221
75838,666,335,331,166,136,191,173
75839,5069,2502,2567,1459,1072,1373,1165
75840,7076,3467,3609,2029,1617,1846,1584
75844,5718,2805,2913,1332,1053,1576,1757
75845,3259,1610,1649,856,690,888,825
75846,2718,1335,1383,737,588,729,664
75847,1859,938,921,449,375,507,528
75848,92,45,47,22,22,28,20
75849,75,38,37,21,15,11,28
75850,671,337,334,142,114,203,212
75851,5050,3715,1335,693,1558,2015,784
75852,3762,3093,669,402,2210,749,401
75853,963,497,466,225,173,286,279
75855,2369,1210,1159,523,397,711,738
75856,196,99,97,43,42,60,51
75858,43,24,19,7,14,9,13
75859,1923,957,966,355,298,567,703
75860,6644,3954,2690,1565,1782,2065,1232
75861,9017,8164,853,465,3855,4054,643
75862,10091,4857,5234,2242,1759,2836,3254
75901,29036,14220,14816,8763,7711,7347,5215
75904,34004,16030,17974,10325,8627,8498,6554
75925,4179,2065,2114,1185,919,1072,1003
75926,1070,547,523,229,214,342,285
75928,1411,712,699,432,284,399,296
75929,1599,795,804,287,225,445,642
75930,2023,1001,1022,510,407,570,536
75931,2631,1320,1311,597,420,784,830
75932,1437,735,702,285,230,397,525
75933,1599,765,834,442,353,440,364
75934,99,46,53,12,21,34,32
75935,13685,6755,6930,4052,3460,3452,2721
75936,889,431,458,233,180,232,244
75937,994,499,495,275,213,286,220
75938,2608,1268,1340,655,441,771,741
75939,3992,1983,2009,1225,886,1089,792
75941,9105,4979,4126,2729,2338,2617,1421
75942,115,56,59,37,26,30,22
75943,1262,644,618,350,287,378,247
75944,1301,657,644,300,236,393,372
75946,3578,1735,1843,940,779,991,868
75948,6281,3049,3232,1177,828,1695,2581
75949,7976,3947,4029,2280,1822,2205,1669
75951,16134,7921,8213,4487,3710,4307,3630
75954,3280,1627,1653,956,744,880,700
75956,7623,3704,3919,2032,1584,2149,1858
75959,923,480,443,155,124,248,396
75960,913,446,467,269,218,242,184
75961,14910,7078,7832,4189,4798,3463,2460
75962,3029,1076,1953,1888,1141,0,0
75964,20097,9919,10178,6641,5737,4756,2963
75965,17591,8380,9211,4259,6396,3780,3156
75966,5371,2932,2439,1377,1434,1459,1101
75968,1766,858,908,527,382,493,364
75969,4116,2078,2038,1041,970,1328,777
75972,6620,3244,3376,1620,1287,1792,1921
75973,2599,1263,1336,621,472,756,750
75974,3126,1561,1565,996,750,800,580
75975,3699,1855,1844,1068,822,943,866
75976,827,381,446,261,177,208,181
75977,750,362,388,217,145,206,182
75978,144,63,81,55,32,38,19
75979,11423,6671,4752,2244,3507,2825,2847
75980,2836,1419,1417,649,447,842,898
76001,30460,14862,15598,10501,7760,9131,3068
76002,30269,14661,15608,11289,9254,7951,1775
76006,22639,11195,11444,5013,9724,5764,2138
76008,13602,6806,6796,4345,2533,4704,2020
76009,19759,9967,9792,5981,4908,5807,3063
76010,55706,28640,27066,20781,19476,11038,4411
76011,21594,10877,10717,6405,7937,4937,2315
76012,25689,12376,13313,6633,6260,7056,5740
76013,30680,14760,15920,7455,9335,7524,6366
76014,34072,16416,17656,12008,10633,7883,3548
76015,16658,8147,8511,4398,5290,4224,2746
76016,30852,15015,15837,7994,6376,10211,6271
76017,44724,21628,23096,12933,12183,13465,6143
76018,26938,13041,13897,9151,7880,7912,1995
76020,27270,13505,13765,7211,5984,8608,5467
76021,33673,15926,17747,7179,9011,10540,6943
76022,13212,6344,6868,3125,3964,3548,2575
76023,5832,2893,2939,1510,1291,1819,1212
76028,59744,29346,30398,18030,15017,16739,9958
76031,17759,9092,8667,5283,4622,4974,2880
76033,24819,11912,12907,7250,6203,6207,5159
76034,22748,11270,11478,6557,2806,9306,4079
76035,1622,844,778,431,337,564,290
76036,22352,10790,11562,7038,5783,6217,3314
76039,32925,15968,16957,8280,11365,9582,3698
76040,27524,13854,13670,7830,8850,7646,3198
76041,434,228,206,125,118,111,80
76043,7071,3447,3624,2107,1505,1981,1478
76044,3866,1986,1880,1190,873,1143,660
76048,21989,10701,11288,5194,4698,6062,6035
76049,25130,12419,12711,5669,4490,7034,7937
76050,5875,2975,2900,1692,1166,1804,1213
76051,46320,22911,23409,12754,12155,15567,5844
76052,15995,8038,7957,5589,4509,4629,1268
76053,28421,13764,14657,8021,8249,7388,4763
76054,11764,5672,6092,2661,2198,3800,3105
76055,3084,1525,1559,991,674,820,599
76058,17123,8617,8506,5508,4167,4979,2469
76059,4881,2284,2597,1564,1455,998,864
76060,6764,3373,3391,1925,1606,2114,1119
76061,152,73,79,35,30,48,39
76063,61361,30243,31118,20947,15596,18056,6762
76064,1883,928,955,676,438,517,252
76065,28986,14367,14619,9526,6978,8724,3758
76066,3142,1565,1577,803,644,1009,686
76067,22117,11738,10379,5993,6173,5793,4158
76070,752,386,366,178,132,279,163
76071,3320,1703,1617,980,740,1010,590
76073,5327,2705,2622,1527,1108,1714,978
76077,590,304,286,163,107,166,154
76078,8572,4288,4284,2793,2171,2538,1070
76082,17748,8873,8875,5309,4182,5308,2949
76084,8327,4749,3578,2349,2542,2511,925
76085,8787,4459,4328,2440,1988,2813,1546
76086,20196,9655,10541,5736,5721,4721,4018
76087,24746,12461,12285,6830,4958,7957,5001
76088,11499,5718,5781,3192,2498,3546,2263
76092,26669,13358,13311,9785,3127,10837,2920
76093,2095,1041,1054,623,527,587,358
76102,8111,4649,3462,1418,3439,2141,1113
76103,14572,7348,7224,4476,4108,3841,2147
76104,17446,8744,8702,5702,4586,4455,2703
76105,22194,11017,11177,8619,6273,4938,2364
76106,35389,17881,17508,13610,10729,7316,3734
76107,25917,12737,13180,5535,8221,7268,4893
76108,38227,18877,19350,11403,10899,10389,5536
76109,21710,10447,11263,4472,7752,5202,4284
76110,30434,15592,14842,10104,9580,7362,3388
76111,21685,11142,10543,7557,6514,5124,2490
76112,38993,18494,20499,11410,10923,10632,6028
76114,24741,12190,12551,7486,6954,6188,4113
76115,20696,10570,10126,8101,6690,4155,1750
76116,46746,22791,23955,12388,14539,11551,8268
76117,30645,15447,15198,9389,8898,7453,4905
76118,13866,6850,7016,3952,3746,3977,2191
76119,42761,21596,21165,14608,12017,9640,6496
76120,15283,7069,8214,4379,5730,3787,1387
76123,29722,14203,15519,10852,8112,8199,2559
76126,19395,9384,10011,4586,4503,6152,4154
76127,2003,305,1698,114,1047,754,88
76129,2833,915,1918,1796,1036,0,1
76131,28374,13991,14383,10546,9592,6442,1794
76132,24709,11435,13274,5490,8361,6143,4715
76133,48394,22871,25523,14184,12726,12191,9293
76134,23704,11263,12441,7907,6445,5707,3645
76135,20684,10033,10651,5892,5618,5825,3349
76137,54911,27044,27867,17656,17427,15279,4549
76140,26340,12895,13445,9176,7336,6495,3333
76148,23331,11446,11885,6954,6597,6789,2991
76155,3115,1632,1483,423,1724,821,147
76164,16748,8807,7941,5899,4960,3976,1913
76177,4891,2440,2451,1486,2045,1068,292
76179,48058,23724,24334,15684,14558,12546,5270
76180,33444,16185,17259,8496,9684,8649,6615
76182,28209,13689,14520,7861,6278,9472,4598
76201,27107,12823,14284,6431,15373,2888,2415
76205,18510,9669,8841,4097,8279,3668,2466
76207,10579,5090,5489,2460,3242,2265,2612
76208,19782,9709,10073,6186,6150,5091,2355
76209,24018,11560,12458,6718,8419,5567,3314
76210,39556,19396,20160,12565,11807,10635,4549
76225,3156,1591,1565,922,709,917,608
76226,18419,9214,9205,6180,3907,5955,2377
76227,22141,10819,11322,7588,7007,5301,2245
76228,1119,572,547,256,205,344,314
76230,9711,4691,5020,2415,2092,2595,2609
76233,3235,1620,1615,911,728,888,708
76234,15587,7711,7876,4480,3676,4439,2992
76238,431,206,225,142,98,106,85
76239,1087,543,544,247,212,315,313
76240,26120,12868,13252,7504,6034,6675,5907
76244,60388,29696,30692,22814,20088,13905,3581
76245,1780,906,874,280,247,568,685
76247,13098,6527,6571,4535,3585,3595,1383
76248,34647,16834,17813,11492,6168,12431,4556
76249,7194,3535,3659,2240,1963,2030,961
76250,937,443,494,303,186,292,156
76251,731,387,344,163,152,214,202
76252,2863,1444,1419,859,593,776,635
76253,230,107,123,68,53,61,48
76255,5411,2635,2776,1379,1048,1443,1541
76258,6659,3370,3289,1981,1607,1867,1204
76259,4618,2316,2302,1422,1173,1414,609
76261,233,121,112,67,44,74,48
76262,27648,13780,13868,8557,7109,8499,3483
76263,44,24,20,10,8,17,9
76264,1412,717,695,343,262,475,332
76265,1893,948,945,498,382,513,500
76266,13495,6676,6819,4063,3368,4044,2020
76268,250,125,125,72,59,81,38
76270,1853,958,895,410,338,640,465
76271,1352,690,662,335,282,467,268
76272,4745,2387,2358,1253,986,1523,983
76273,9135,4561,4574,2466,1953,2609,2107
76301,16540,8144,8396,4698,4514,4480,2848
76302,13206,6240,6966,3797,3830,3031,2548
76305,4746,2382,2364,1100,938,1632,1076
76306,15991,7770,8221,4633,4441,3965,2952
76308,19677,9417,10260,4844,6404,4650,3779
76309,13862,6760,7102,3813,3459,3766,2824
76310,17989,8713,9276,5020,4568,5045,3356
76311,7535,5468,2067,2969,4348,209,9
76351,2035,991,1044,530,404,613,488
76354,11270,5505,5765,3261,2648,3127,2234
76357,712,331,381,199,136,203,174
76360,3502,1766,1736,939,731,1000,832
76363,256,141,115,72,59,71,54
76364,193,101,92,41,32,59,61
76365,4831,2359,2472,1198,911,1475,1247
76366,2317,1149,1168,616,449,743,509
76367,13045,8256,4789,2483,4106,4308,2148
76370,299,150,149,71,61,103,64
76371,1606,766,840,461,318,389,438
76372,974,513,461,259,181,277,257
76373,162,86,76,40,47,45,30
76374,4162,2049,2113,1092,862,1163,1045
76377,802,377,425,238,161,216,187
76379,591,295,296,208,137,156,90
76380,3820,1845,1975,876,701,1053,1190
76384,12991,6447,6544,3733,3088,3438,2732
76388,203,110,93,39,28,67,69
76389,1329,689,640,436,289,349,255
76401,25702,12496,13206,6643,9125,5663,4271
76402,847,392,455,692,154,1,0
76424,8992,4659,4333,2411,2165,2327,2089
76426,11302,5869,5433,3227,3034,3107,1934
76427,804,392,412,233,176,216,179
76429,258,133,125,58,58,64,78
76430,2532,1201,1331,727,483,727,595
76431,3384,1717,1667,931,740,1040,673
76432,1370,714,656,349,238,406,377
76433,1416,713,703,328,264,435,389
76435,612,310,302,141,98,171,202
76436,212,104,108,40,29,70,73
76437,5721,2813,2908,1616,1162,1409,1534
76442,7545,3718,3827,2021,1475,1934,2115
76443,1897,938,959,430,354,519,594
76444,3635,1723,1912,964,701,988,982
76445,407,199,208,83,74,118,132
76446,9000,4540,4460,2753,2180,2330,1737
76448,5628,2750,2878,1450,1250,1495,1433
76449,2434,1213,1221,528,404,741,761
76450,13258,6502,6756,3468,2910,3655,3225
76452,75,41,34,36,15,15,9
76453,1125,548,577,226,159,339,401
76454,1688,788,900,410,327,441,510
76455,1014,513,501,285,211,258,260
76457,3960,1988,1972,1011,803,1079,1067
76458,6261,3605,2656,1483,1833,1728,1217
76459,146,81,65,37,31,43,35
76460,421,213,208,98,75,138,110
76462,2982,1527,1455,757,617,941,667
76463,481,252,229,115,103,132,131
76464,506,251,255,114,82,137,173
76466,332,163,169,85,63,88,96
76469,96,51,45,16,17,37,26
76470,3238,1577,1661,922,660,857,799
76471,1906,945,961,461,329,513,603
76472,1499,758,741,381,299,469,350
76474,281,145,136,56,43,81,101
76475,977,496,481,234,209,282,252
76476,2637,1309,1328,760,533,769,575
76481,208,109,99,40,28,59,81
76483,1063,518,545,263,199,274,327
76484,1147,623,524,255,259,311,322
76486,1375,717,658,374,275,418,308
76487,2507,1308,1199,690,525,795,497
76490,91,50,41,33,22,22,14
76491,459,225,234,111,81,126,141
76501,16897,8140,8757,5199,3875,4600,3223
76502,31545,14911,16634,8615,8522,7864,6544
76504,24268,11875,12393,6748,7209,5924,4387
76508,0,0,0,0,0,0,0
76511,3317,2032,1285,659,1121,966,571
76513,34172,16961,17211,10225,9120,9032,5795
76518,1581,813,768,446,332,430,373
76519,626,319,307,164,127,181,154
76520,8413,4141,4272,2465,1711,2138,2099
76522,35534,17267,18267,11216,11613,8384,4321
76523,18,10,8,3,4,6,5
76524,2867,1399,1468,844,610,865,548
76525,1062,543,519,245,204,312,301
76527,4058,2112,1946,1229,941,1181,707
76528,16974,7610,9364,4353,4440,4880,3301
76530,2540,1303,1237,603,587,770,580
76531,4978,2436,2542,1123,937,1250,1668
76534,2615,1313,1302,754,574,713,574
76537,3870,1949,1921,1284,1167,956,463
76538,761,367,394,193,145,207,216
76539,7841,3919,3922,2098,1719,2628,1396
76541,19206,9703,9503,5533,7209,4039,2425
76542,40025,19571,20454,13357,14023,9325,3320
76543,30430,14790,15640,9471,11786,6221,2952
76544,29943,17293,12650,12393,16017,1463,70
76548,26344,13002,13342,8744,7867,6847,2886
76549,44490,21859,22631,15789,18160,8082,2459
76550,11586,5663,5923,3151,2449,3161,2825
76554,2104,1034,1070,661,536,569,338
76556,1461,745,716,405,267,418,371
76557,5178,2578,2600,1395,1173,1571,1039
76559,5051,2485,2566,1752,1667,1185,447
76561,962,476,486,250,213,279,220
76565,74,40,34,5,5,25,39
76566,258,129,129,61,56,67,74
76567,8984,4355,4629,2702,1850,2433,1999
76569,2498,1262,1236,769,532,747,450
76570,2572,1287,1285,631,497,740,704
76571,6790,3373,3417,1684,1245,2074,1787
76573,26,12,14,6,3,8,9
76574,17661,8461,9200,5162,4595,4794,3110
76577,3046,1515,1531,819,617,911,699
76578,1766,877,889,543,383,516,324
76579,4258,2124,2134,1269,1015,1192,782
76596,1274,2,1272,8,676,553,37
76597,2882,2874,8,3,1498,1312,69
76598,523,0,523,24,278,205,16
76599,1956,6,1950,18,1076,822,40
76621,1037,538,499,281,240,311,205
76622,1015,500,515,251,209,312,243
76623,242,127,115,84,65,55,38
76624,2231,1118,1113,572,470,677,512
76626,1563,764,799,475,343,439,306
76627,1601,799,802,462,349,438,352
76628,111,60,51,30,24,32,25
76629,1989,979,1010,506,400,539,544
76630,1840,934,906,578,410,540,312
76631,522,261,261,156,126,133,107
76632,1778,911,867,589,381,463,345
76633,4973,2495,2478,1454,1052,1510,957
76634,7093,3462,3631,1668,1226,1889,2310
76635,1341,688,653,431,385,300,225
76636,1497,769,728,365,316,463,353
76637,536,270,266,123,95,159,159
76638,2837,1402,1435,840,512,898,587
76639,1584,775,809,408,304,447,425
76640,3005,1538,1467,738,708,893,666
76641,1674,851,823,471,353,479,371
76642,7057,3890,3167,1659,1981,1876,1541
76643,13554,6514,7040,3949,3613,3781,2211
76645,11039,5409,5630,3275,2839,2532,2393
76648,2302,1061,1241,578,408,666,650
76649,790,401,389,172,137,231,250
76650,104,52,52,23,26,28,27
76651,3300,1653,1647,960,727,1004,609
76652,1087,542,545,245,210,339,293
76653,1082,551,531,248,240,294,300
76654,151,72,79,45,47,40,19
76655,7831,3883,3948,2299,1490,2560,1482
76656,2276,1137,1139,606,493,647,530
76657,9307,4538,4769,2857,2017,2601,1832
76660,506,260,246,128,108,130,140
76661,8708,3887,4821,1958,2777,2383,1590
76664,3514,1861,1653,1181,714,898,721
76665,2526,1257,1269,697,489,683,657
76666,244,124,120,52,44,58,90
76667,11313,5661,5652,3242,2748,2998,2325
76670,1377,699,678,416,315,378,268
76671,1777,891,886,378,248,519,632
76673,1187,576,611,330,252,335,270
76676,413,211,202,116,99,106,92
76678,263,131,132,60,58,72,73
76679,1432,722,710,367,306,396,363
76680,190,101,89,30,36,68,56
76681,873,459,414,232,173,278,190
76682,2660,1340,1320,686,564,797,613
76685,108,57,51,26,22,28,32
76686,285,151,134,57,65,88,75
76687,1466,753,713,310,248,417,491
76689,3996,1959,2037,1074,850,1157,915
76690,1197,629,568,351,273,328,245
76691,6454,3222,3232,1772,1408,1845,1429
76692,10115,4903,5212,2295,1816,2780,3224
76693,1651,793,858,473,380,408,390
76701,1826,1033,793,340,1004,366,116
76704,8007,3542,4465,2584,2096,1808,1519
76705,29155,14898,14257,8986,8320,7310,4539
76706,35015,17228,17787,10401,14779,5995,3840
76707,16697,8157,8540,5971,5110,3697,1919
76708,24476,11851,12625,7996,6827,5856,3797
76710,22686,10567,12119,5137,6410,5442,5697
76711,9042,4626,4416,2896,2715,2110,1321
76712,23506,11016,12490,5940,5463,6349,5754
76798,1862,286,1576,1508,354,0,0
76801,25552,12606,12946,6998,6419,6488,5647
76802,5075,2482,2593,1402,1059,1361,1253
76820,125,57,68,21,15,27,62
76821,4869,2367,2502,1364,923,1359,1223
76823,2945,1441,1504,800,547,825,773
76824,35,20,15,13,6,5,11
76825,7091,3454,3637,1954,1466,1881,1790
76827,433,225,208,94,86,139,114
76828,199,104,95,33,28,66,72
76831,63,30,33,13,11,18,21
76832,559,293,266,149,85,181,144
76834,5908,2882,3026,1495,1123,1591,1699
76836,41,21,20,11,7,12,11
76837,3188,2317,871,468,1171,1066,483
76841,61,35,26,11,7,18,25
76842,191,96,95,48,24,56,63
76844,3550,1733,1817,909,606,958,1077
76845,178,87,91,41,33,52,52
76848,78,44,34,3,9,22,44
76849,3944,1940,2004,920,727,1104,1193
76852,212,112,100,28,25,67,92
76853,1622,810,812,464,274,423,461
76854,401,200,201,61,41,121,178
76856,3582,1759,1823,844,570,1014,1154
76857,1791,904,887,345,285,482,679
76858,254,117,137,58,34,64,98
76859,1982,996,986,441,331,547,663
76861,1995,1019,976,590,433,550,422
76862,198,107,91,22,14,58,104
76864,890,480,410,271,122,210,287
76865,160,87,73,33,32,42,53
76866,623,329,294,149,89,199,186
76869,125,71,54,18,15,27,65
76870,251,120,131,77,59,62,53
76871,784,403,381,194,113,226,251
76872,717,373,344,157,88,207,265
76873,55,28,27,3,5,13,34
76874,68,33,35,9,18,22,19
76875,668,332,336,172,135,180,181
76877,4558,2548,2010,1040,1367,1028,1123
76878,1685,848,837,430,333,459,463
76882,252,138,114,43,35,86,88
76884,172,94,78,41,31,50,50
76885,154,83,71,25,17,55,57
76887,126,61,65,19,17,34,56
76888,110,55,55,17,13,26,54
76890,940,468,472,230,156,291,263
76901,27969,13348,14621,7846,7600,7294,5229
76903,31905,15536,16369,9059,8694,7948,6204
76904,32718,15683,17035,8321,9709,7790,6898
76905,11335,5652,5683,3633,3098,2861,1743
76908,1951,1511,440,641,1301,9,0
76930,156,76,80,40,26,57,33
76932,3390,1757,1633,1109,847,936,498
76933,1365,664,701,363,239,354,409
76934,1296,693,603,305,311,400,280
76935,1606,798,808,394,299,535,378
76936,3377,1678,1699,1168,778,808,623
76937,37,20,17,12,7,14,4
76939,51,27,24,11,9,17,14
76940,176,94,82,38,33,63,42
76941,1348,686,662,353,240,416,339
76943,3693,1818,1875,1064,807,1056,766
76945,1665,808,857,355,280,469,561
76949,7,4,3,0,0,3,4
76950,4180,2058,2122,1254,894,1202,830
76951,1143,576,567,302,244,331,266
76953,74,40,34,20,11,20,23
76955,133,69,64,44,21,43,25
76957,59,32,27,24,9,25,1
76958,310,154,156,74,78,78,80
77002,16793,13839,2954,1186,9537,5264,806
77003,10508,5709,4799,2563,4132,2708,1105
77004,32692,16368,16324,7659,13234,7418,4381
77005,25528,12528,13000,6801,6487,7828,4412
77006,19664,11111,8553,1961,9456,5675,2572
77007,30853,16556,14297,4147,15530,7955,3221
77008,30482,15523,14959,5340,11753,8785,4604
77009,38094,19669,18425,10542,11720,10383,5449
77010,366,206,160,13,149,156,48
77011,19547,10220,9327,6351,5732,4782,2682
77012,20719,11000,9719,7153,6611,4723,2232
77013,17602,9250,8352,5933,5737,3830,2102
77014,28684,13735,14949,10070,9339,7201,2074
77015,53621,27088,26533,19168,16151,12843,5459
77016,26989,13029,13960,7727,6458,6902,5902
77017,32561,16542,16019,11453,9677,7762,3669
77018,25563,12698,12865,5916,7131,7822,4694
77019,18944,9546,9398,2959,7371,5431,3183
77020,25464,12815,12649,8665,7182,6090,3527
77021,26042,12056,13986,7424,7474,6199,4945
77022,29557,14948,14609,9540,8529,7253,4235
77023,28998,14964,14034,9120,9446,7021,3411
77024,34775,16491,18284,9214,5667,11228,8666
77025,26137,12534,13603,5762,9269,6783,4323
77026,23940,11863,12077,7326,6120,6532,3962
77027,14331,7002,7329,1717,6070,3643,2901
77028,16808,8118,8690,5139,4107,4384,3178
77029,17814,8819,8995,5623,4789,4407,2995
77030,10258,5178,5080,1914,4364,2498,1482
77031,15762,7989,7773,4763,5001,3984,2014
77032,12757,6150,6607,4797,4116,2554,1290
77033,27965,13239,14726,8797,6774,6964,5430
77034,33678,16861,16817,11638,11623,7354,3063
77035,35896,17428,18468,11250,10937,9147,4562
77036,71969,38001,33968,22688,26820,15301,7160
77037,19819,10427,9392,7433,6186,4294,1906
77038,26713,13473,13240,10314,8757,5748,1894
77039,27562,14081,13481,10398,8209,6066,2889
77040,45081,22572,22509,13573,13905,12190,5413
77041,37146,18607,18539,11960,10228,10943,4015
77042,36385,17769,18616,8184,14922,8699,4580
77043,23358,11760,11598,6615,6832,6215,3696
77044,30949,15183,15766,11441,9715,7377,2416
77045,31255,14970,16285,10959,8830,7275,4191
77046,1196,580,616,56,617,236,287
77047,21077,9792,11285,6444,7187,4765,2681
77048,15294,7047,8247,4982,3969,3848,2495
77049,28521,14056,14465,10300,9244,6651,2326
77050,4611,2321,2290,1568,1354,979,710
77051,15085,6647,8438,4873,3796,3629,2787
77053,28954,14029,14925,10371,8376,7188,3019
77054,22290,10707,11583,2963,14139,3804,1384
77055,41989,21904,20085,13030,13187,10622,5150
77056,18673,9323,9350,2425,6577,5025,4646
77057,39208,20586,18622,7377,17121,9049,5661
77058,16406,8150,8256,3030,6089,4421,2866
77059,16949,8488,8461,5246,2291,6605,2807
77060,40830,21072,19758,15223,15155,7812,2640
77061,24457,12539,11918,8056,8050,5780,2571
77062,25152,12495,12657,6758,5635,8108,4651
77063,34299,17226,17073,6655,15143,7470,5031
77064,45847,22813,23034,14152,14171,12980,4544
77065,35326,17009,18317,10328,11009,9599,4390
77066,31366,15486,15880,10088,9005,8519,3754
77067,30559,14942,15617,11691,10045,6959,1864
77068,10064,4979,5085,2521,2572,2964,2007
77069,16541,7874,8667,3301,4033,4791,4416
77070,46017,22355,23662,12585,14390,12623,6419
77071,25671,12097,13574,7458,6698,7431,4084
77072,56526,27720,28806,19357,17112,14136,5921
77073,34790,17139,17651,13252,12179,7220,2139
77074,37267,18719,18548,11872,12238,8490,4667
77075,37388,18328,19060,13727,12533,8232,2896
77076,33803,17246,16557,12533,10898,7316,3056
77077,52151,25072,27079,11873,17928,14120,8230
77078,14777,7045,7732,5436,4028,3419,1894
77079,31280,14995,16285,8932,6935,9422,5991
77080,45275,23780,21495,14446,14949,10022,5858
77081,47860,26165,21695,15487,20698,9383,2292
77082,49900,23719,26181,13270,17854,12807,5969
77083,70837,34341,36496,24227,19484,19955,7171
77084,95137,46947,48190,31336,29862,25491,8448
77085,16074,7879,8195,5859,4895,3835,1485
77086,28009,13864,14145,10560,8733,6525,2191
77087,36399,18496,17903,12610,10941,8316,4532
77088,49660,24066,25594,16418,13457,13289,6496
77089,48685,23897,24788,15336,14847,12083,6419
77090,32930,15713,17217,10061,12437,7142,3290
77091,23472,11180,12292,7545,6600,5842,3485
77092,33745,17174,16571,9852,11160,8326,4407
77093,46929,24198,22731,17711,13963,10307,4948
77094,8498,4218,4280,2492,1314,3591,1101
77095,66502,32492,34010,21273,18648,20438,6143
77096,32628,15417,17211,8259,8736,8839,6794
77098,13076,6643,6433,1533,6373,3262,1908
77099,47091,23107,23984,15649,14520,11945,4977
77201,0,0,0,0,0,0,0
77301,30769,16205,14564,10098,10631,6577,3463
77302,18118,9117,9001,5513,4470,5069,3066
77303,16710,8293,8417,5131,4752,4413,2414
77304,21314,10259,11055,5131,6033,5473,4677
77306,11931,6072,5859,4260,3196,3076,1399
77316,16036,8017,8019,4754,3674,4928,2680
77318,14281,7017,7264,3497,3007,4183,3594
77320,33678,22233,11445,6222,11013,11332,5111
77326,69,38,31,16,16,18,19
77327,20160,10159,10001,6093,5188,5354,3525
77328,13993,7028,6965,4382,3465,3812,2334
77331,6824,3419,3405,1548,1159,2047,2070
77334,141,59,82,28,21,44,48
77335,2350,1165,1185,611,498,666,575
77336,12471,6248,6223,3840,2969,3826,1836
77338,33971,16417,17554,11289,11126,7913,3643
77339,37512,18139,19373,9794,9961,10545,7212
77340,29809,15561,14248,7159,12210,6117,4323
77342,23,14,9,7,8,8,0
77345,26122,12843,13279,8206,4374,9303,4239
77346,53578,26403,27175,17870,14934,15004,5770
77350,66,41,25,16,13,18,19
77351,32517,17926,14591,7380,7833,9098,8206
77354,30215,15044,15171,9659,7144,9262,4150
77355,24010,12002,12008,7597,5199,7653,3561
77356,24498,12071,12427,5863,4408,7209,7018
77357,19987,9942,10045,6325,5017,5620,3025
77358,4993,2502,2491,1432,1021,1487,1053
77359,721,362,359,162,154,193,212
77360,5280,2583,2697,1137,899,1410,1834
77362,4600,2285,2315,1439,1123,1306,732
77363,3269,1640,1629,796,705,1081,687
77364,2223,1092,1131,379,294,654,896
77365,25769,12944,12825,8253,7185,6865,3466
77367,143,70,73,31,26,33,53
77368,152,73,79,33,23,46,50
77369,1018,487,531,241,207,317,253
77371,7665,3806,3859,2379,1727,2166,1393
77372,12164,6015,6149,3855,3154,3305,1850
77373,54609,26539,28070,18218,16411,14280,5700
77374,510,257,253,151,114,128,117
77375,39351,18969,20382,12791,12036,9522,5002
77376,617,306,311,168,146,171,132
77377,28708,14236,14472,9147,7067,8862,3632
77378,14685,7403,7282,4874,3968,3798,2045
77379,70544,34910,35634,22006,16710,21863,9965
77380,23136,11388,11748,5474,7053,6622,3987
77381,34961,16713,18248,9516,6088,12733,6624
77382,35369,17316,18053,12902,6681,12249,3537
77384,11857,5739,6118,2606,2839,3469,2943
77385,19534,9719,9815,6319,5455,5255,2505
77386,36407,17951,18456,12056,11991,9179,3181
77388,40384,19800,20584,12344,10274,12058,5708
77389,21255,10474,10781,6825,5208,6349,2873
77396,43317,22154,21163,14654,15486,9924,3253
77401,17491,8511,8980,5337,3133,6241,2780
77406,33682,17791,15891,9481,8170,11421,4610
77407,28595,13791,14804,9643,10069,6934,1949
77412,106,50,56,23,26,38,19
77414,23047,11401,11646,6621,5388,6414,4624
77415,46,20,26,15,7,16,8
77417,2457,1194,1263,762,594,659,442
77418,9585,4692,4893,2514,1960,2781,2330
77419,1512,796,716,485,382,375,270
77420,2205,1060,1145,640,541,602,422
77422,13933,7476,6457,3701,3570,3999,2663
77423,9483,4814,4669,3053,2374,2654,1402
77426,2100,1046,1054,471,341,698,590
77428,61,36,25,13,12,15,21
77429,72264,35600,36664,24308,18043,22146,7767
77430,2283,1175,1108,613,445,791,434
77432,173,92,81,51,40,56,26
77433,50539,24939,25600,18994,15285,12757,3503
77434,4816,2390,2426,1498,1107,1261,950
77435,4539,2310,2229,1356,949,1362,872
77436,73,37,36,16,6,26,25
77437,17054,8368,8686,5309,4121,4441,3183
77440,37,21,16,7,9,11,10
77441,4809,2387,2422,1207,784,1739,1079
77442,1137,576,561,289,208,338,302
77443,84,38,46,13,19,27,25
77444,784,409,375,234,178,242,130
77445,11977,5954,6023,3512,3076,3267,2122
77446,5217,2318,2899,2234,2410,306,267
77447,11872,5895,5977,3831,2867,3509,1665
77448,341,164,177,79,63,115,84
77449,94382,45980,48402,35230,29335,23119,6698
77450,71889,35350,36539,23467,16312,23781,8329
77451,77,35,42,25,15,16,21
77453,301,165,136,94,106,58,43
77454,217,113,104,58,54,61,44
77455,2045,1027,1018,572,462,602,409
77456,1303,657,646,357,308,382,256
77457,651,359,292,91,94,215,251
77458,468,255,213,166,134,110,58
77459,56274,27170,29104,17362,12824,17910,8178
77460,73,37,36,16,13,28,16
77461,10679,5371,5308,3288,2576,3134,1681
77464,221,111,110,62,40,76,43
77465,7161,3631,3530,2132,1495,2003,1531
77466,690,346,344,208,174,186,122
77467,57,38,19,9,20,12,16
77468,131,64,67,29,24,47,31
77469,35321,17795,17526,11079,10691,9385,4166
77470,338,177,161,86,71,92,89
77471,35241,17272,17969,11687,10293,8494,4767
77473,97,49,48,26,25,30,16
77474,12782,6371,6411,3790,2993,3648,2351
77475,773,377,396,193,151,223,206
77476,313,166,147,63,49,120,81
77477,35897,17369,18528,10563,11793,9286,4255
77478,24739,12139,12600,5847,5237,8256,5399
77479,74514,36489,38025,23407,15164,26285,9658
77480,8097,4010,4087,2337,1761,2397,1602
77481,35,15,20,6,9,13,7
77482,2307,1146,1161,687,452,737,431
77483,311,167,144,81,76,91,63
77484,11068,5619,5449,3228,2650,3292,1898
77485,4054,2029,2025,1047,880,1290,837
77486,6851,3326,3525,1853,1575,1946,1477
77488,14148,6885,7263,3985,3392,3735,3036
77489,35554,16567,18987,11190,9049,10840,4475
77493,23104,11549,11555,7746,5992,6612,2754
77494,61600,30150,31450,22861,15411,18066,5262
77498,49906,25002,24904,15816,13453,15127,5510
77502,37995,18884,19111,13650,10965,8603,4777
77503,24251,11946,12305,8343,7198,5677,3033
77504,24529,11869,12660,7757,7596,5681,3495
77505,23223,11429,11794,6859,6277,7177,2910
77506,35977,18459,17518,13789,11190,7925,3073
77507,0,0,0,0,0,0,0
77510,13731,6866,6865,3789,3048,4271,2623
77511,46627,23344,23283,14295,12420,12676,7236
77514,4942,2542,2400,1401,1197,1410,934
77515,30309,15677,14632,8652,7828,8976,4853
77517,5315,2668,2647,1511,1150,1744,910
77518,8673,4439,4234,2698,2484,2387,1104
77519,1191,577,614,337,299,306,249
77520,36489,18064,18425,12078,10028,8910,5473
77521,49507,23944,25563,16044,14301,12278,6884
77523,17031,8641,8390,5850,4454,4924,1803
77530,31086,15710,15376,11620,9171,7423,2872
77531,15639,7716,7923,5203,4800,3704,1932
77532,26236,13031,13205,7961,6764,7526,3985
77533,1022,506,516,310,261,281,170
77534,2863,1444,1419,922,694,789,458
77535,31295,15015,16280,8481,8918,9499,4397
77536,30690,15084,15606,9158,7892,8755,4885
77538,934,473,461,266,202,268,198
77539,38806,19309,19497,11289,10992,10766,5759
77541,17412,8820,8592,5834,4340,4672,2566
77545,19431,9325,10106,7413,6008,4759,1251
77546,47636,23177,24459,14541,10442,15397,7256
77547,9735,4906,4829,3599,2778,2214,1144
77550,23043,11696,11347,5298,6707,6705,4333
77551,17753,9052,8701,4258,4998,5098,3399
77554,8863,4620,4243,1679,2007,2886,2291
77560,1005,513,492,261,220,323,201
77561,53,22,31,8,10,22,13
77562,10459,5205,5254,3041,2614,3090,1714
77563,9103,4460,4643,2408,2071,2691,1933
77564,1988,971,1017,512,424,593,459
77565,5790,2910,2880,1236,1311,1993,1250
77566,28739,14109,14630,8330,6810,8578,5021
77568,14308,6887,7421,3975,3387,4083,2863
77571,35666,17729,17937,10713,9754,10308,4891
77573,71580,35229,36351,22302,19763,21231,8284
77575,15949,7953,7996,4530,3970,4315,3134
77577,1368,670,698,376,295,435,262
77578,12672,6281,6391,3956,3442,3670,1604
77580,312,145,167,90,52,110,60
77581,42383,20640,21743,12468,11013,12138,6764
77583,28531,17417,11114,8039,8774,8934,2784
77584,70228,34146,36082,22976,21071,18804,7377
77585,1014,495,519,267,250,295,202
77586,20970,10628,10342,5670,4798,7121,3381
77587,16568,8370,8198,6105,4965,3704,1794
77590,30374,14790,15584,9141,7810,8050,5373
77591,13131,6091,7040,3616,3674,3225,2616
77597,777,385,392,186,142,278,171
77598,23059,11550,11509,5669,9934,5158,2298
77611,8219,4119,4100,2313,2162,2271,1473
77612,8901,4411,4490,2433,2022,2551,1895
77613,1218,595,623,297,304,350,267
77614,603,302,301,156,130,183,134
77615,1012,512,500,308,234,264,206
77616,1136,568,568,309,236,383,208
77617,73,42,31,7,5,26,35
77619,16147,8042,8105,4193,4139,4456,3359
77622,1390,674,716,358,342,420,270
77623,448,230,218,94,84,143,127
77624,856,444,412,186,177,262,231
77625,8489,4255,4234,2315,1889,2500,1785
77627,21454,10665,10789,5524,5588,6183,4159
77629,877,435,442,229,193,293,162
77630,26796,13246,13550,7156,6463,7514,5663
77632,22776,11322,11454,6446,5032,6935,4363
77640,16875,8242,8633,4503,3718,4793,3861
77642,37111,18260,18851,11686,10269,9204,5952
77650,1896,1002,894,332,275,734,555
77651,13043,6463,6580,3374,3131,3815,2723
77655,356,178,178,74,66,134,82
77656,17110,8169,8941,4792,3978,4775,3565
77657,20003,9984,10019,5987,5277,5612,3127
77659,4910,2492,2418,1357,1081,1519,953
77660,1437,686,751,372,318,434,313
77661,962,504,458,319,234,266,143
77662,27035,13482,13553,7659,6758,7518,5100
77663,1353,649,704,242,186,385,540
77664,2681,1327,1354,705,504,806,666
77665,6446,3192,3254,1898,1551,1739,1258
77701,14674,7299,7375,4450,3900,3797,2527
77702,2893,1479,1414,740,966,758,429
77703,15006,7140,7866,5040,3966,3788,2212
77705,40475,25638,14837,9096,15050,11447,4882
77706,28258,13399,14859,6628,7553,7885,6192
77707,17080,8026,9054,4806,4421,4510,3343
77708,11518,5457,6061,3585,3244,2947,1742
77713,12788,6368,6420,3220,3533,3798,2237
77801,15449,8398,7051,4678,7821,2162,788
77802,23288,11007,12281,5594,7493,5161,5040
77803,30252,14809,15443,10658,9561,6933,3100
77807,9699,5389,4310,2564,3573,2408,1154
77808,10634,5312,5322,3062,2481,3295,1796
77830,2534,1249,1285,582,525,796,631
77831,3426,1769,1657,922,700,1020,784
77833,27492,13465,14027,7536,6171,7283,6502
77835,2351,1142,1209,531,428,664,728
77836,11896,5861,6035,3238,2478,3434,2746
77837,1587,789,798,408,310,430,439
77840,56171,29030,27141,16783,33816,3388,2184
77845,48938,24454,24484,13758,17728,11422,6030
77853,953,465,488,222,198,265,268
77855,238,117,121,61,24,80,73
77856,5096,2585,2511,1364,1027,1388,1317
77857,757,369,388,206,166,217,168
77859,6981,3373,3608,2154,1656,1849,1322
77861,2506,1246,1260,686,536,739,545
77864,7647,3691,3956,2376,1799,1796,1676
77865,1798,929,869,449,346,520,483
77867,105,48,57,35,25,23,22
77868,15511,8934,6577,3888,4295,4570,2758
77871,3368,1646,1722,718,525,878,1247
77872,1716,838,878,469,384,459,404
77873,1292,645,647,319,239,372,362
77876,197,100,97,53,46,51,47
77878,475,230,245,150,116,131,78
77879,4670,2346,2324,1025,884,1443,1318
77880,1879,970,909,458,310,603,508
77901,41548,20131,21417,12796,11517,10105,7130
77904,25002,11950,13052,6883,5722,6957,5440
77905,13981,7098,6883,3737,3009,4300,2935
77950,197,96,101,28,35,56,78
77951,2616,1303,1313,945,645,621,405
77954,11506,6213,5293,2770,2659,3531,2546
77957,8187,3968,4219,2347,1842,2183,1815
77960,121,60,61,40,36,20,25
77961,183,84,99,50,38,44,51
77962,3286,1647,1639,906,786,889,705
77963,5459,2701,2758,1398,955,1626,1480
77964,7569,3716,3853,1802,1380,2148,2239
77968,2774,1403,1371,818,545,931,480
77969,154,72,82,38,32,50,34
77970,295,149,146,90,62,84,59
77971,911,471,440,285,214,256,156
77973,50,26,24,14,14,15,7
77974,455,233,222,112,116,145,82
77975,1860,910,950,411,343,505,601
77976,126,68,58,25,19,51,31
77977,718,369,349,236,159,223,100
77978,743,387,356,217,180,198,148
77979,17144,8620,8524,5234,3948,4651,3311
77982,1253,663,590,217,227,368,441
77983,2209,1154,1055,630,462,611,506
77984,4295,2079,2216,1053,740,1208,1294
77987,161,93,68,37,26,51,47
77988,326,173,153,82,84,91,69
77990,699,341,358,169,121,219,190
77991,357,187,170,126,97,99,35
77993,148,76,72,28,28,48,44
77994,321,165,156,58,50,102,111
77995,9567,4678,4889,2778,2027,2490,2272
78001,33,19,14,7,9,9,8
78002,8255,4162,4093,2669,2053,2209,1324
78003,8689,4252,4437,1803,1445,2751,2690
78004,1183,608,575,292,190,465,236
78005,817,400,417,201,136,258,222
78006,27558,13422,14136,7277,5093,8598,6590
78007,151,78,73,20,18,38,75
78008,345,171,174,64,58,93,130
78009,7255,3568,3687,2092,1507,2209,1447
78010,3386,1677,1709,925,653,965,843
78011,2082,1064,1018,733,463,554,332
78012,436,231,205,134,92,129,81
78013,5930,2932,2998,1598,1177,1624,1531
78014,4987,2741,2246,1358,1456,1155,1018
78015,9602,4750,4852,2639,1297,3194,2472
78016,9630,4747,4883,2923,2152,2579,1976
78017,4787,3024,1763,1234,1854,1024,675
78019,1855,1327,528,327,997,362,169
78021,126,65,61,31,14,25,56
78022,4627,2259,2368,1246,871,1333,1177
78023,24334,11941,12393,7773,5593,7780,3188
78024,1436,713,723,244,236,434,522
78025,4956,2409,2547,1194,880,1408,1474
78026,5861,2813,3048,1740,1391,1508,1222
78027,459,238,221,97,74,136,152
78028,37620,18117,19503,8339,7146,9398,12737
78029,0,0,0,0,0,0,0
78039,1657,830,827,454,353,492,358
78040,42083,20089,21994,15661,10720,8489,7213
78041,44153,21310,22843,14739,12620,10237,6557
78043,42713,20533,22180,16510,12341,8818,5044
78044,648,356,292,255,153,155,85
78045,54713,26570,28143,20907,16138,13338,4330
78046,64548,31917,32631,28551,19285,12230,4482
78050,767,404,363,273,196,184,114
78052,6388,3156,3232,2074,1459,1757,1098
78055,1774,869,905,420,230,500,624
78056,1917,958,959,452,342,761,362
78057,871,445,426,218,163,275,215
78058,1256,651,605,272,188,391,405
78059,5387,2653,2734,1649,1180,1604,954
78060,37,17,20,12,6,11,8
78061,11031,6308,4723,3260,3508,2530,1733
78063,9227,4661,4566,2049,1523,3363,2292
78064,14102,6863,7239,4277,3241,3698,2886
78065,10831,5341,5490,3535,2590,2886,1820
78066,591,300,291,129,122,226,114
78067,916,465,451,305,217,225,169
78069,5137,2578,2559,1812,1189,1378,758
78070,14618,7311,7307,3979,2521,5057,3061
78071,4248,2582,1666,894,1407,1153,794
78072,505,261,244,107,98,164,136
78073,8171,4130,4041,2686,2029,2225,1231
78075,123,68,55,21,13,43,46
78076,12612,6336,6276,4833,3443,2531,1805
78101,7898,3908,3990,2231,1641,2567,1459
78102,27593,16945,10648,6728,9331,7618,3916
78104,175,88,87,48,30,45,52
78107,360,184,176,107,62,105,86
78108,27770,13561,14209,9531,7279,7921,3039
78109,34603,16565,18038,11926,10065,9200,3412
78112,7941,4037,3904,2745,1880,2275,1041
78113,2435,1225,1210,629,472,786,548
78114,20103,10021,10082,5759,4207,6139,3998
78116,390,210,180,69,57,130,134
78117,545,283,262,132,93,198,122
78118,3976,2087,1889,1079,982,1034,881
78119,7680,5153,2527,1394,3043,2018,1225
78121,11381,5610,5771,3406,2373,3683,1919
78122,418,212,206,96,65,123,134
78123,2397,1179,1218,605,546,716,530
78124,5609,2813,2796,1504,1259,1672,1174
78125,96,48,48,11,8,31,46
78130,59546,28813,30733,17380,16200,14981,10985
78132,19139,9480,9659,5292,3408,6316,4123
78133,16269,8205,8064,3284,2684,5440,4861
78140,3380,1704,1676,1106,827,873,574
78141,596,308,288,132,112,172,180
78142,119,66,53,25,20,46,28
78143,85,42,43,27,19,20,19
78144,45,20,25,14,8,15,8
78145,103,52,51,30,17,31,25
78146,771,367,404,279,132,198,162
78147,1919,937,982,602,489,526,302
78148,20139,9752,10387,5666,5741,5226,3506
78150,11,11,0,4,7,0,0
78151,1347,668,679,408,274,347,318
78152,2294,1143,1151,538,407,825,524
78154,30347,14731,15616,8815,7576,9173,4783
78155,45341,22387,22954,12888,10633,12219,9601
78159,1023,525,498,299,197,264,263
78160,4273,2145,2128,1162,946,1219,946
78161,864,448,416,249,198,253,164
78162,375,183,192,103,80,108,84
78163,9838,4886,4952,2574,1486,3620,2158
78164,3796,1877,1919,873,705,1028,1190
78201,45307,22498,22809,12913,12417,11811,8166
78202,11691,5888,5803,3998,2990,2983,1720
78203,6099,3014,3085,2163,1681,1439,816
78204,11125,5535,5590,3082,3062,2989,1992
78205,1453,928,525,80,365,469,539
78207,55514,28963,26551,18255,16431,12659,8169
78208,3736,1987,1749,1004,1078,1033,621
78209,39197,18397,20800,9252,9683,11210,9052
78210,36865,18063,18802,11679,9593,9563,6030
78211,31944,15663,16281,10879,8509,7528,5028
78212,28415,14161,14254,6596,8696,7440,5683
78213,40396,19345,21051,11204,12193,10146,6853
78214,23341,11544,11797,7616,6049,5822,3854
78215,1150,689,461,127,438,413,172
78216,40267,19833,20434,9496,13774,10255,6742
78217,32165,15560,16605,8447,9974,8297,5447
78218,31917,15198,16719,9466,8800,7973,5678
78219,15225,7166,8059,5065,3888,3696,2576
78220,15965,7380,8585,4809,3535,3971,3650
78221,35990,17599,18391,11692,9501,8802,5995
78222,19408,9260,10148,6256,5043,4971,3138
78223,50637,24656,25981,16343,14195,12703,7396
78224,17601,8587,9014,6263,4964,3846,2528
78225,13025,6431,6594,3819,3278,3349,2579
78226,6648,3114,3534,2095,1776,1592,1185
78227,46077,22351,23726,16237,13282,10022,6536
78228,58811,28311,30500,18816,15834,13698,10463
78229,28804,14055,14749,6514,12842,5699,3749
78230,39089,18920,20169,8554,12681,9733,8121
78231,7906,3777,4129,1862,1796,2410,1838
78232,35120,16959,18161,7723,9317,10316,7764
78233,43710,21163,22547,12567,12687,11541,6915
78234,7126,4325,2801,2466,3953,652,55
78235,357,186,171,121,185,39,12
78236,10392,8045,2347,3009,7189,190,4
78237,36929,18125,18804,12668,9495,8646,6120
78238,23514,11228,12286,6579,7727,5333,3875
78239,28736,13665,15071,8213,6901,7072,6550
78240,51111,24314,26797,11938,19953,11533,7687
78242,31395,15414,15981,12233,9089,6630,3443
78243,235,172,63,40,189,5,1
78244,30757,14680,16077,10962,8961,7899,2935
78245,56511,27256,29255,20642,18380,12047,5442
78247,49176,23629,25547,14580,13511,14694,6391
78248,13638,6620,7018,3502,2688,4804,2644
78249,49951,24405,25546,15051,17843,11578,5479
78250,54903,26536,28367,17311,16206,15287,6099
78251,49435,24078,25357,16111,16961,12250,4113
78252,7372,4727,2645,1920,3357,1633,462
78253,29007,14223,14784,9883,8536,7556,3032
78254,44817,21817,23000,15178,14806,10705,4128
78255,10826,5350,5476,3229,2727,3249,1621
78256,6855,3552,3303,1908,2690,1677,580
78257,3950,1980,1970,876,1001,1114,959
78258,40586,19721,20865,13133,10429,12279,4745
78259,22660,11176,11484,7125,5686,6951,2898
78260,24844,12283,12561,8335,5948,7648,2913
78261,13513,6632,6881,4552,4223,3605,1133
78263,4673,2328,2345,1214,882,1617,960
78264,12339,6284,6055,4223,3022,3389,1705
78266,5591,2754,2837,1332,958,1940,1361
78330,878,424,454,299,204,218,157
78332,28710,14082,14628,9182,7306,7051,5171
78335,4,2,2,0,0,3,1
78336,11949,5961,5988,3231,2551,3356,2811
78338,37,19,18,8,8,12,9
78339,632,295,337,202,137,186,107
78340,379,195,184,79,41,140,119
78341,1760,889,871,448,327,482,503
78342,386,185,201,142,93,103,48
78343,4525,2239,2286,1337,1040,1209,939
78344,474,236,238,144,97,141,92
78349,505,262,243,114,72,156,163
78351,621,305,316,216,154,147,104
78352,179,93,86,34,47,62,36
78353,433,235,198,87,74,133,139
78355,7081,3492,3589,2220,1521,1738,1602
78357,3161,1570,1591,1031,724,792,614
78358,709,333,376,127,112,178,292
78359,1944,969,975,600,453,525,366
78361,5350,2648,2702,1664,1270,1271,1145
78362,9447,4724,4723,3053,2455,2540,1399
78363,30463,15499,14964,9412,9943,6379,4729
78368,9227,4543,4684,2703,1958,2445,2121
78369,444,215,229,157,97,115,75
78370,4877,2426,2451,1591,1118,1283,885
78371,404,196,208,136,91,101,76
78372,5452,2713,2739,1754,1200,1482,1016
78373,3585,1833,1752,642,637,1247,1059
78374,16620,8254,8366,5186,4151,4613,2670
78375,3352,1684,1668,1013,722,859,758
78376,554,281,273,140,100,150,164
78377,3821,1893,1928,1068,792,997,964
78379,1585,831,754,399,258,516,412
78380,23141,11463,11678,7363,5287,6366,4125
78382,19364,9543,9821,4116,3362,5324,6562
78383,3539,1798,1741,851,553,1201,934
78384,6640,3458,3182,2010,1830,1567,1233
78385,277,136,141,73,56,74,74
78387,9574,4807,4767,2961,2229,2587,1797
78389,1541,772,769,452,336,451,302
78390,5616,2795,2821,1863,1232,1418,1103
78391,325,161,164,108,65,85,67
78393,2379,1195,1184,653,452,651,623
78401,5391,3155,2236,1031,1699,1611,1050
78402,536,273,263,75,78,203,180
78404,17236,8474,8762,4521,4599,4750,3366
78405,16867,8259,8608,5264,4261,4216,3126
78406,1413,853,560,366,526,351,170
78407,2955,1486,1469,922,708,787,538
78408,12061,5910,6151,3655,3213,3014,2179
78409,2939,1496,1443,917,743,804,475
78410,26387,12824,13563,8419,6872,7189,3907
78411,28024,13419,14605,7524,7103,7600,5797
78412,36003,17363,18640,9711,11742,8335,6215
78413,36953,18021,18932,10042,10927,10227,5757
78414,30165,14701,15464,8973,9372,7837,3983
78415,39271,19061,20210,12643,10503,9854,6271
78416,15508,7438,8070,4707,3500,4024,3277
78417,4176,2068,2108,1431,1181,1081,483
78418,29854,15066,14788,7625,7450,9307,5472
78419,694,387,307,287,353,52,2
78501,61219,29029,32190,19514,16918,13645,11142
78503,21706,10347,11359,7411,6310,4580,3405
78504,48703,23511,25192,16527,14121,12611,5444
78516,33722,16510,17212,13270,8827,6445,5180
78520,59408,28057,31351,21301,15856,12802,9449
78521,93818,44403,49415,36349,25512,19585,12372
78526,42460,20261,22199,16438,11512,9733,4777
78535,581,275,306,196,149,138,98
78536,451,229,222,138,98,116,99
78537,39454,19217,20237,15827,10455,7433,5739
78538,10657,5191,5466,4399,2844,2134,1280
78539,30783,14565,16218,10020,9076,7332,4355
78541,42431,20783,21648,16275,14673,7869,3614
78542,63293,32506,30787,26671,19398,12307,4917
78543,8447,4100,4347,3131,2129,1914,1273
78545,555,274,281,163,158,130,104
78548,675,315,360,250,156,156,113
78549,990,512,478,355,221,230,184
78550,53152,25435,27717,18010,14188,12094,8860
78552,34111,16592,17519,10946,7713,8239,7213
78557,12547,5919,6628,5206,3373,2701,1267
78558,882,429,453,362,225,184,111
78559,12751,6082,6669,4481,3053,2918,2299
78560,4368,2063,2305,1688,1133,907,640
78561,779,377,402,291,191,155,142
78562,2868,1751,1117,804,1122,637,305
78563,376,169,207,114,76,92,94
78564,270,132,138,99,62,65,44
78565,402,175,227,109,95,103,95
78566,16230,8278,7952,6061,4567,3772,1830
78567,533,263,270,189,119,107,118
78569,4039,1967,2072,1363,964,1026,686
78570,32525,15706,16819,13174,8410,6598,4343
78572,75221,36329,38892,26772,19282,15773,13394
78573,34890,17213,17677,14155,10083,7373,3279
78574,57071,28076,28995,25029,16238,11279,4525
78575,8056,3926,4130,2810,2350,1812,1084
78576,8775,4325,4450,4087,2610,1490,588
78577,70840,33982,36858,27397,20331,13493,9619
78578,12516,6182,6334,3697,3023,3015,2781
78579,4580,2243,2337,1937,1244,910,489
78580,14963,8525,6438,4268,5176,3247,2272
78582,40455,19925,20530,15400,11157,8643,5255
78583,6623,3314,3309,2134,1394,1654,1441
78584,18128,8331,9797,6699,4595,3825,3009
78585,396,193,203,132,103,70,91
78586,55878,27324,28554,21730,13964,12204,7980
78588,238,124,114,54,31,84,69
78589,38004,18415,19589,14881,11102,7737,4284
78590,289,142,147,100,70,78,41
78591,265,144,121,68,45,77,75
78592,836,378,458,328,200,159,149
78593,6324,3120,3204,2316,1578,1549,881
78594,1990,975,1015,698,442,499,351
78595,6082,3040,3042,2455,1736,1247,644
78596,63844,30791,33053,23497,16730,13420,10197
78597,2885,1475,1410,434,460,992,999
78598,226,126,100,32,26,57,111
78602,25160,13344,11816,6574,6329,7642,4615
78605,4952,2474,2478,1433,1063,1436,1020
78606,5205,2594,2611,1263,960,1578,1404
78607,166,84,82,11,5,38,112
78608,434,223,211,100,62,148,124
78609,2012,1009,1003,275,241,603,893
78610,23502,11704,11798,7484,6457,6793,2768
78611,12977,6214,6763,3151,2851,3470,3505
78612,11457,5813,5644,3507,2653,3610,1687
78613,65099,31834,33265,21838,18218,18625,6418
78614,456,240,216,110,96,157,93
78615,1290,634,656,344,242,424,280
78616,7092,3667,3425,2393,1686,2049,964
78617,22210,11985,10225,8085,7506,5050,1569
78618,324,173,151,64,39,98,123
78619,3026,1520,1506,799,525,1140,562
78620,14367,7241,7126,4155,2496,5323,2393
78621,21659,10779,10880,6974,5431,6049,3205
78622,296,149,147,76,63,91,66
78623,813,411,402,129,118,268,298
78624,21513,10315,11198,4808,3648,5775,7282
78626,25996,13122,12874,8095,7863,6433,3605
78628,23727,11463,12264,6434,4585,7134,5574
78629,11887,5923,5964,3553,2819,3031,2484
78631,2395,1176,1219,591,373,730,701
78632,910,482,428,199,176,287,248
78633,19349,9158,10191,2855,1724,3946,10824
78634,22791,11152,11639,8401,7676,5138,1576
78635,149,73,76,23,31,52,43
78636,3749,1911,1838,899,671,1153,1026
78638,2005,1017,988,466,402,666,471
78639,7334,3511,3823,1528,1266,1988,2552
78640,42954,21666,21288,15548,13727,10269,3410
78641,44295,22045,22250,15087,12634,12118,4456
78642,9467,4763,4704,3018,1896,3055,1498
78643,6139,2923,3216,1264,964,1734,2177
78644,17081,8511,8570,4888,4551,4685,2957
78645,9773,5010,4763,2072,1684,3482,2535
78648,7683,3669,4014,2259,1806,1958,1660
78650,1599,821,778,457,334,489,319
78652,4466,2288,2178,903,1197,1437,929
78653,16375,8141,8234,5690,5215,3938,1532
78654,17553,8646,8907,4678,3636,4659,4580
78655,2739,1373,1366,776,690,809,464
78656,2271,1159,1112,744,616,617,294
78657,5509,2696,2813,848,777,1426,2458
78659,2903,1431,1472,704,560,1024,615
78660,68789,33565,35224,23207,20960,18746,5876
78661,335,161,174,102,89,74,70
78662,2268,1140,1128,579,447,767,475
78663,746,376,370,158,116,255,217
78664,52932,25980,26952,17416,17121,13701,4694
78665,35985,17620,18365,12593,11621,9132,2639
78666,63836,32138,31698,17443,28527,10682,7184
78669,8731,4484,4247,1885,1445,3379,2022
78670,168,79,89,33,35,49,51
78671,654,331,323,147,120,188,199
78672,931,474,457,108,105,257,461
78675,188,95,93,26,30,53,79
78676,12602,6094,6508,2669,1953,4065,3915
78677,92,48,44,27,26,25,14
78681,50606,25057,25549,17043,13226,14938,5399
78701,6841,4260,2581,352,3794,1896,799
78702,21334,10887,10447,5431,8090,4752,3061
78703,19690,9744,9946,4024,7385,5285,2996
78704,42117,21261,20856,7758,20250,9731,4378
78705,31340,15990,15350,9269,20215,1270,586
78712,860,432,428,674,186,0,0
78717,22538,11015,11523,7236,7100,6497,1705
78719,1764,908,856,590,491,455,228
78721,11425,5572,5853,3721,3619,2451,1634
78722,5901,2986,2915,805,3061,1254,781
78723,28330,14569,13761,7675,10492,6553,3610
78724,21696,11181,10515,8405,7577,4312,1402
78725,6083,2988,3095,2237,1933,1457,456
78726,13122,6492,6630,3721,4681,3675,1045
78727,26689,13304,13385,5571,10966,7298,2854
78728,20299,10015,10284,4907,8731,4898,1763
78729,27108,13427,13681,6151,10891,7498,2568
78730,7955,3985,3970,2110,2069,2705,1071
78731,24614,12014,12600,4681,7933,6789,5211
78732,14060,6978,7082,5410,3401,4133,1116
78733,8762,4397,4365,3022,1404,3399,937
78734,17655,8943,8712,4276,3570,6169,3640
78735,16131,7797,8334,3835,4979,4362,2955
78736,6946,3419,3527,1662,1582,2466,1236
78737,12081,5965,6116,3605,2195,4254,2027
78738,12134,5990,6144,3873,2221,4097,1943
78739,16792,8283,8509,5902,3618,5376,1896
78741,44935,23969,20966,12166,23014,7433,2322
78742,820,410,410,274,233,181,132
78744,42820,21661,21159,15674,15434,9039,2673
78745,55614,27813,27801,12073,22314,13827,7400
78746,26928,13319,13609,7495,5490,9249,4694
78747,14808,7345,7463,4470,5195,3213,1930
78748,40651,19670,20981,10617,15288,10618,4128
78749,34449,16863,17586,8786,11433,10377,3853
78750,26814,13248,13566,6838,6964,8548,4464
78751,14385,7766,6619,1656,9134,2648,947
78752,18064,9778,8286,5201,7692,3672,1499
78753,49301,25647,23654,15490,18538,11079,4194
78754,15036,7464,7572,4156,6195,3465,1220
78756,7194,3606,3588,1107,3066,2086,935
78757,21310,10453,10857,4195,7709,5798,3608
78758,44072,23014,21058,11976,18826,9346,3924
78759,38891,19048,19843,7421,13671,11227,6572
78801,21780,10616,11164,7284,5168,5158,4170
78802,242,116,126,91,69,43,39
78827,1219,568,651,353,253,296,317
78828,258,126,132,37,33,91,97
78829,1207,603,604,424,256,336,191
78830,786,370,416,246,132,198,210
78832,3598,1955,1643,805,772,894,1127
78833,1299,668,631,290,205,328,476
78834,7829,3816,4013,2637,1766,1962,1464
78836,128,64,64,25,25,31,47
78837,281,140,141,76,40,96,69
78838,275,136,139,59,62,72,82
78839,8578,4252,4326,2954,2249,1889,1486
78840,48149,24022,24127,15890,12872,11110,8277
78843,336,286,50,32,301,3,0
78850,1145,577,568,330,197,347,271
78851,23,9,14,5,3,8,7
78852,53040,25820,27220,19786,13433,12080,7741
78860,229,110,119,77,50,57,45
78861,13701,7687,6014,3754,3854,3487,2606
78870,984,509,475,289,209,254,232
78871,45,29,16,2,2,22,19
78872,1905,910,995,699,457,420,329
78873,1788,872,916,409,250,516,613
78877,989,521,468,306,217,241,225
78879,264,119,145,47,35,78,104
78880,1682,864,818,420,309,481,472
78881,2335,1137,1198,686,458,599,592
78883,353,179,174,70,46,111,126
78884,1158,574,584,216,155,321,466
78885,120,67,53,13,3,45,59
78886,647,314,333,156,109,204,178
78931,323,148,175,67,51,101,104
78932,757,378,379,128,140,220,269
78933,1433,736,697,300,219,492,422
78934,6712,3285,3427,1763,1302,1821,1826
78935,978,489,489,272,188,295,223
78938,471,242,229,112,112,131,116
78940,2098,1063,1035,417,321,633,727
78941,2962,1494,1468,799,542,854,767
78942,8989,4638,4351,2885,2054,2309,1741
78943,352,177,175,117,92,97,46
78944,562,275,287,142,101,184,135
78945,10494,5137,5357,2602,2085,3056,2751
78946,960,467,493,212,176,286,286
78947,4475,2218,2257,1159,872,1400,1044
78948,850,427,423,196,153,253,248
78949,517,265,252,105,84,148,180
78950,2038,1049,989,417,309,648,664
78951,26,14,12,5,3,12,6
78953,934,481,453,200,173,299,262
78954,1071,526,545,204,130,299,438
78956,5381,2566,2815,1330,965,1506,1580
78957,9067,4497,4570,2330,1709,2838,2190
78959,1837,950,887,498,427,531,381
78962,4733,2319,2414,1115,861,1368,1389
78963,909,449,460,254,206,239,210
79001,249,124,125,52,43,74,80
79003,162,80,82,43,34,43,42
79005,1735,882,853,582,489,407,257
79007,14542,7173,7369,4377,3619,3789,2757
79009,2166,1096,1070,810,551,499,306
79010,802,451,351,373,130,197,102
79011,236,122,114,52,34,74,76
79012,976,488,488,355,192,315,114
79013,3423,1907,1516,1392,1085,739,207
79014,3771,1909,1862,1183,929,982,677
79015,19277,9469,9808,5864,6101,4548,2764
79016,94,0,94,63,30,1,0
79018,548,274,274,159,129,151,109
79019,1707,833,874,423,321,485,478
79021,138,79,59,44,30,44,20
79022,10741,6120,4621,2942,3057,3097,1645
79024,405,204,201,121,73,124,87
79025,69,33,36,15,15,19,20
79027,5223,2604,2619,1792,1252,1259,920
79029,16177,8220,7957,5497,4356,3964,2360
79031,1425,706,719,494,290,360,281
79032,157,78,79,48,40,43,26
79033,109,63,46,30,27,30,22
79034,637,331,306,177,123,180,157
79035,5309,2729,2580,1793,1371,1296,849
79036,5128,2610,2518,1304,1060,1567,1197
79039,779,390,389,176,137,236,230
79040,1839,925,914,616,404,511,308
79041,3194,1590,1604,1024,719,801,650
79042,1169,584,585,337,229,317,286
79043,1487,771,716,489,361,379,258
79044,766,418,348,305,208,170,83
79045,19473,9714,9759,6924,4992,4542,3015
79046,489,227,262,106,100,146,137
79051,29,12,17,3,7,9,10
79052,1259,644,615,345,264,339,311
79053,137,69,68,50,28,38,21
79054,594,300,294,148,107,165,174
79056,63,35,28,8,6,21,28
79057,1206,577,629,303,234,304,365
79058,10,6,4,3,4,3,0
79059,837,422,415,228,183,232,194
79061,316,157,159,82,60,70,104
79062,218,118,100,67,31,73,47
79063,686,352,334,221,119,208,138
79064,2739,1366,1373,912,595,643,589
79065,20840,10872,9968,5648,5226,5667,4299
79068,3197,1561,1636,952,658,909,678
79070,9919,5068,4851,3435,2681,2406,1397
79072,28849,15071,13778,9288,8240,6852,4469
79078,377,205,172,81,69,141,86
79079,2646,1285,1361,697,532,742,675
79080,605,312,293,133,112,192,168
79081,3912,1945,1967,1278,920,965,749
79082,315,161,154,86,55,87,87
79083,2661,1371,1290,753,636,750,522
79084,2366,1207,1159,790,514,621,441
79085,53,28,25,20,9,11,13
79086,2105,1085,1020,712,488,561,344
79087,751,391,360,250,183,174,144
79088,5945,3182,2763,1718,1509,1457,1261
79091,147,65,82,50,26,47,24
79092,1106,519,587,333,232,293,248
79093,69,36,33,15,14,17,23
79094,75,34,41,17,12,25,21
79095,2686,1306,1380,827,575,656,628
79096,2229,1120,1109,684,567,510,468
79097,1150,564,586,311,220,342,277
79098,517,267,250,154,104,139,120
79101,2817,1327,1490,535,727,694,861
79102,9963,4923,5040,3072,3021,2407,1463
79103,10594,5099,5495,3632,2895,2487,1580
79104,7869,3946,3923,2942,2225,1674,1028
79105,6,5,1,2,2,2,0
79106,27967,13304,14663,7589,7935,6852,5591
79107,33844,16609,17235,12887,9280,7673,4004
79108,17726,11438,6288,3591,5386,6183,2566
79109,43516,20859,22657,11203,11805,11594,8914
79110,18811,9187,9624,5696,5787,4661,2667
79111,1808,992,816,637,719,349,103
79118,19726,9906,9820,5977,5553,5508,2688
79119,11539,5630,5909,3313,2994,3386,1846
79121,6575,3174,3401,1417,1447,1979,1732
79124,7819,3839,3980,2055,1558,2517,1689
79201,7040,4119,2921,1678,2384,1598,1380
79220,197,95,102,42,26,57,72
79225,976,501,475,269,204,260,243
79226,3153,1562,1591,852,646,754,901
79227,1406,676,730,324,249,397,436
79229,424,219,205,91,83,118,132
79230,158,74,84,41,32,51,34
79231,45,22,23,11,10,13,11
79233,180,88,92,62,28,51,39
79234,110,55,55,25,18,26,41
79235,3833,1885,1948,1210,806,978,839
79236,262,130,132,71,42,102,47
79237,513,262,251,139,103,146,125
79239,211,116,95,62,35,49,65
79240,60,28,32,12,13,21,14
79241,2480,1220,1260,784,505,620,571
79243,90,50,40,21,19,23,27
79244,720,362,358,180,137,159,244
79245,2476,1213,1263,723,469,602,682
79247,64,33,31,15,12,21,16
79248,1493,706,787,391,243,404,455
79250,1508,754,754,447,331,426,304
79251,45,23,22,2,5,25,13
79252,3202,1570,1632,849,630,874,849
79255,571,274,297,141,106,149,175
79256,319,169,150,65,46,92,116
79257,1067,536,531,255,212,278,322
79258,67,38,29,12,14,18,23
79259,48,28,20,8,11,13,16
79261,527,264,263,131,83,129,184
79311,3445,1678,1767,1100,714,899,732
79312,971,498,473,286,206,266,213
79313,1571,776,795,458,346,456,311
79314,56,26,30,9,8,16,23
79316,11451,6115,5336,3275,3105,2865,2206
79322,2049,977,1072,591,416,519,523
79323,6559,3267,3292,2303,1620,1632,1004
79324,61,35,26,18,13,16,14
79325,2319,1186,1133,752,536,595,436
79326,40,19,21,9,4,20,7
79329,3300,1669,1631,986,674,961,679
79330,114,61,53,17,12,35,50
79331,13258,7534,5724,3564,4187,3071,2436
79336,16972,8285,8687,5410,4436,4127,2999
79339,7230,3582,3648,2281,1660,1879,1410
79342,352,185,167,109,75,94,74
79343,1571,788,783,526,350,405,290
79344,56,32,24,18,7,20,11
79345,920,465,455,286,205,258,171
79346,2427,1212,1215,784,542,584,517
79347,7462,3783,3679,2515,1853,1744,1350
79350,392,188,204,133,84,89,86
79351,1326,654,672,430,240,354,302
79353,10,4,6,2,4,3,1
79355,1942,965,977,654,426,538,324
79356,6363,4045,2318,1498,2196,1730,939
79357,2303,1093,1210,754,498,541,510
79358,1116,576,540,329,217,327,243
79359,2899,1432,1467,989,681,729,500
79360,13574,6810,6764,5289,3671,3069,1545
79363,5369,2656,2713,1756,1232,1543,838
79364,8172,3958,4214,2493,1766,2185,1728
79366,1096,544,552,217,152,411,316
79367,645,329,316,205,148,185,107
79369,88,46,42,23,14,32,19
79370,1889,1099,790,422,509,501,457
79371,1317,651,666,444,242,337,294
79372,1434,703,731,508,306,411,209
79373,3307,1631,1676,984,692,935,696
79376,95,53,42,35,17,29,14
79377,277,139,138,93,52,71,61
79378,236,112,124,58,58,84,36
79379,666,308,358,230,128,211,97
79380,197,94,103,53,49,66,29
79381,1263,650,613,386,278,374,225
79382,6291,3159,3132,2032,1478,1915,866
79401,8408,4664,3744,1378,5301,1268,461
79403,16869,8274,8595,5616,3996,4346,2911
79404,11289,6010,5279,3649,3095,3075,1470
79406,6025,3179,2846,4570,1452,3,0
79407,19068,9410,9658,5488,6428,4333,2819
79410,9429,4908,4521,1867,4246,1929,1387
79411,7951,4069,3882,2365,3016,1750,820
79412,15650,7527,8123,5306,4411,3698,2235
79413,21187,10216,10971,5483,6342,4789,4573
79414,17121,8183,8938,4719,6337,3459,2606
79415,17689,8988,8701,5125,6720,3610,2234
79416,32296,15834,16462,8320,13486,6098,4392
79423,32277,15610,16667,9003,9557,8551,5166
79424,39023,18795,20228,10395,10643,10957,7028
79501,3528,1723,1805,1005,765,952,806
79502,1350,645,705,337,254,357,402
79503,175,92,83,39,32,64,40
79504,2787,1354,1433,643,525,811,808
79505,296,144,152,88,58,79,71
79506,730,378,352,150,100,232,248
79508,1242,610,632,308,246,398,290
79510,7982,3896,4086,2222,1705,2258,1797
79511,1338,671,667,360,268,397,313
79512,8197,5168,3029,1712,2990,2075,1420
79517,200,103,97,52,36,51,61
79518,124,63,61,30,14,37,43
79519,74,40,34,18,13,19,24
79520,2449,1217,1232,683,505,646,615
79521,3980,2127,1853,929,941,1072,1038
79525,2842,1415,1427,797,603,818,624
79526,979,505,474,247,189,283,260
79527,251,130,121,70,43,74,64
79528,619,292,327,156,99,158,206
79529,1383,686,697,375,291,349,368
79530,480,247,233,114,80,173,113
79532,940,452,488,272,182,247,239
79533,472,235,237,109,104,137,122
79534,181,95,86,46,32,45,58
79535,183,96,87,48,28,59,48
79536,4988,2437,2551,1327,1133,1475,1053
79537,111,57,54,27,14,38,32
79538,271,144,127,52,44,81,94
79539,178,100,78,33,34,50,61
79540,89,44,45,20,17,23,29
79541,791,391,400,201,121,289,180
79543,1186,588,598,338,225,303,320
79544,512,260,252,121,100,137,154
79545,1788,900,888,533,358,484,413
79546,2006,965,1041,498,385,535,588
79547,758,368,390,168,129,206,255
79548,174,93,81,42,31,48,53
79549,15652,8380,7272,4434,4141,4181,2896
79553,3469,1669,1800,910,628,973,958
79556,12995,6437,6558,3747,2968,3350,2930
79560,137,70,67,18,19,48,52
79561,662,331,331,167,142,178,175
79562,3669,1822,1847,1078,700,1187,704
79563,1161,587,574,337,267,343,214
79565,295,142,153,91,76,75,53
79566,333,170,163,58,38,101,136
79567,3373,1689,1684,924,688,891,870
79601,25085,14443,10642,5541,10167,5710,3667
79602,21519,10534,10985,6152,5974,5909,3484
79603,24288,11810,12478,7518,6483,5779,4508
79605,30098,14459,15639,8351,8729,7268,5750
79606,22885,11190,11695,5929,6831,5818,4307
79607,2865,1661,1204,1174,1535,149,7
79699,321,173,148,93,225,3,0
79701,27728,13563,14165,9472,7524,6988,3744
79703,20592,10127,10465,6758,6357,4874,2603
79705,33536,16190,17346,9541,8838,8712,6445
79706,19571,9890,9681,6400,5080,5512,2579
79707,32854,16173,16681,8951,9240,9388,5275
79713,592,308,284,208,123,152,109
79714,14786,7368,7418,4726,3828,3912,2320
79718,721,367,354,209,145,191,176
79719,397,204,193,97,69,107,124
79720,33640,19041,14599,8651,8795,10257,5937
79730,250,125,125,65,50,77,58
79731,4193,2045,2148,1377,965,1171,680
79733,210,102,108,69,52,52,37
79734,2137,1082,1055,466,274,676,721
79735,13315,7613,5702,3549,3874,3691,2201
79738,275,141,134,80,49,89,57
79739,963,514,449,302,206,279,176
79741,288,159,129,65,64,94,65
79742,490,252,238,140,104,156,90
79743,339,171,168,90,70,103,76
79744,1362,705,657,423,298,456,185
79745,6125,3076,3049,1970,1486,1610,1059
79748,173,86,87,50,30,58,35
79749,255,138,117,93,60,59,43
79752,2245,1104,1141,683,529,579,454
79754,80,45,35,10,15,35,20
79755,230,126,104,67,67,65,31
79756,9066,4329,4737,2720,2185,2352,1809
79758,2197,1113,1084,580,568,613,436
79759,23,14,9,5,6,9,3
79761,30488,15013,15475,9648,8544,7489,4807
79762,39056,19045,20011,11699,11811,9541,6005
79763,34079,16749,17330,11919,9355,8193,4612
79764,20725,10298,10427,6943,5610,5278,2894
79765,6927,3465,3462,1979,1904,1950,1094
79766,6115,3226,2889,2043,1804,1617,651
79770,33,19,14,8,10,6,9
79772,12747,7748,4999,3222,4232,3325,1968
79777,170,94,76,57,30,52,31
79778,878,444,434,254,196,239,189
79780,224,115,109,55,42,55,72
79781,303,161,142,90,66,82,65
79782,3976,1977,1999,1293,944,1050,689
79783,201,104,97,66,48,51,36
79785,91,46,45,17,13,32,29
79788,506,260,246,156,131,119,100
79789,974,468,506,321,220,295,138
79821,7142,4471,2671,1922,2512,1977,731
79830,7682,3844,3838,1759,2097,2013,1813
79831,29,17,12,0,5,9,15
79834,200,106,94,36,52,86,26
79835,12690,6243,6447,4666,3346,3120,1558
79836,5772,2859,2913,2138,1430,1464,740
79837,519,266,253,124,70,170,155
79838,8699,4116,4583,3358,2109,2072,1160
79839,1938,932,1006,759,411,458,310
79842,498,235,263,100,75,151,172
79843,2503,1231,1272,594,540,663,706
79845,5138,2494,2644,1850,1002,1174,1112
79846,104,54,50,30,17,22,35
79847,167,85,82,31,18,66,52
79848,927,483,444,223,183,238,283
79849,13208,6484,6724,5485,3571,2987,1165
79851,641,340,301,191,168,176,106
79852,799,423,376,178,150,263,208
79853,3729,1796,1933,1672,914,794,349
79854,213,108,105,39,32,83,59
79855,2336,1142,1194,712,518,620,486
79901,11328,5389,5939,3720,2363,2657,2588
79902,21236,10306,10930,5292,6274,5210,4460
79903,18451,8693,9758,5014,4362,4672,4403
79904,35060,16629,18431,12885,9850,7188,5137
79905,26036,12184,13852,8671,5798,6019,5548
79906,4374,2398,1976,1938,2102,320,14
79907,55132,25713,29419,18131,13925,13236,9840
79908,3673,2535,1138,1164,1890,591,28
79911,1565,742,823,506,543,379,137
79912,77161,36963,40198,22895,21272,21139,11855
79915,40057,18769,21288,12483,9417,9228,8929
79916,2995,2631,364,428,2480,83,4
79920,153,144,9,14,132,5,2
79922,8935,4384,4551,2650,1726,2783,1776
79924,59058,27771,31287,19187,15118,14161,10592
79925,40641,19690,20951,10695,11698,10037,8211
79927,39016,18850,20166,14129,10493,9403,4991
79928,49544,24354,25190,20677,15168,10567,3132
79930,28410,13560,14850,8454,7745,6842,5369
79932,24986,11886,13100,8663,6588,6388,3347
79934,19174,9308,9866,6988,6405,4603,1178
79935,18042,8388,9654,5140,4714,4445,3743
79936,111086,53241,57845,38648,30626,30423,11389
79938,53520,27506,26014,20488,18135,11570,3327
79942,2,1,1,0,0,0,2
88063,27,14,13,11,8,7,1
88220,4,2,2,0,0,3,1
88430,9,5,4,2,4,3,0
81324,47,26,21,9,6,16,16
82930,35,17,18,10,7,12,6
83312,25,13,12,8,10,3,4
83342,73,44,29,32,17,10,14
84001,725,361,364,271,203,140,111
84002,302,151,151,117,85,47,53
84003,42384,21334,21050,18285,10479,9022,4598
84004,9818,4925,4893,4210,1782,2614,1212
84005,21410,10809,10601,10667,7657,2364,722
84006,826,413,413,263,258,198,107
84007,740,364,376,290,177,161,112
84010,44821,21938,22883,14185,11451,10108,9077
84013,1011,520,491,421,260,216,114
84014,15268,7500,7768,5113,3601,3920,2634
84015,62494,31700,30794,23969,20270,12449,5806
84017,3556,1819,1737,1143,838,1032,543
84018,179,91,88,80,39,38,22
84020,39765,20492,19273,14923,11373,9977,3492
84021,3323,1766,1557,1122,783,822,596
84022,896,488,408,331,262,235,68
84023,266,142,124,80,71,65,50
84024,63,36,27,13,20,20,10
84025,18255,9271,8984,6850,5368,4012,2025
84026,1668,788,880,623,481,366,198
84027,452,231,221,105,61,133,153
84028,824,435,389,259,187,174,204
84029,9473,4787,4686,3611,2411,2253,1198
84031,259,134,125,70,50,67,72
84032,17249,8785,8464,6510,4761,4013,1965
84033,1032,534,498,403,248,231,150
84034,188,93,95,63,44,55,26
84035,748,409,339,231,188,223,106
84036,6045,3143,2902,2086,1620,1595,744
84037,33369,16783,16586,13692,7860,7985,3832
84038,347,177,170,105,64,80,98
84039,1102,568,534,403,265,255,179
84040,23026,11531,11495,7794,5213,6884,3135
84041,44625,22387,22238,16842,14481,9047,4255
84042,10094,5082,5012,4224,2325,2428,1117
84043,49030,24580,24450,22185,16306,7245,3294
84044,26524,13404,13120,9874,8638,5735,2277
84045,16875,8545,8330,8186,5699,2138,852
84046,793,455,338,170,177,214,232
84047,28936,14283,14653,7844,10894,6186,4012
84049,4372,2177,2195,1439,1014,1110,809
84050,9290,4680,4610,3543,2050,2317,1380
84051,402,217,185,145,105,96,56
84052,1403,736,667,469,383,367,184
84053,1115,555,560,411,307,223,174
84054,16196,8160,8036,5605,5655,3311,1625
84055,1406,719,687,469,341,402,194
84056,3310,1806,1504,1280,1806,216,8
84057,36666,18308,18358,13275,12877,6702,3812
84058,30540,15362,15178,10218,12391,4803,3128
84060,7596,4013,3583,1745,2310,2358,1183
84061,391,196,195,98,77,138,78
84062,43269,21587,21682,18431,13040,7940,3858
84063,334,160,174,118,91,86,39
84064,692,342,350,229,159,188,116
84065,38168,20097,18071,14127,10573,9983,3485
84066,11283,5641,5642,4286,3280,2303,1414
84067,37444,18631,18813,12849,11363,8312,4920
84069,505,248,257,149,99,155,102
84070,24861,12183,12678,7281,8114,5620,3846
84071,1175,624,551,440,291,304,140
84072,372,184,188,141,78,82,71
84073,191,99,92,63,32,43,53
84074,44310,22224,22086,17294,12684,9543,4789
84075,24506,12416,12090,10889,6860,4999,1758
84076,390,203,187,167,87,83,53
84078,25851,13206,12645,9335,7731,5477,3308
84080,304,148,156,109,73,72,50
84081,40732,20380,20352,17769,13573,7658,1732
84082,743,393,350,235,150,210,148
84083,1516,795,721,569,413,362,172
84084,37247,18366,18881,12278,11860,8925,4184
84085,531,249,282,189,136,125,81
84086,401,216,185,156,105,88,52
84087,13983,7017,6966,5225,4325,3031,1402
84088,35603,17793,17810,12924,10810,8550,3319
84092,29525,14968,14557,9389,6287,9355,4494
84093,23130,11577,11553,6818,5040,6763,4509
84094,28069,14039,14030,9057,8137,7072,3803
84095,50566,25318,25248,19080,13580,12378,5528
84096,33396,16790,16606,15132,11319,5464,1481
84097,21322,10496,10826,7492,5924,4453,3453
84098,17282,8819,8463,5218,3761,6407,1896
84101,5277,3227,2050,774,2305,1577,621
84102,17421,9379,8042,2417,9897,3077,2030
84103,21084,10588,10496,3742,8301,5052,3989
84104,24869,12977,11892,9066,8326,5110,2367
84105,22140,10905,11235,5053,8635,5724,2728
84106,33384,16211,17173,8131,12078,7622,5553
84107,30863,14958,15905,7727,10922,6995,5219
84108,20738,10219,10519,5457,6509,4854,3918
84109,23858,11594,12264,6563,6571,6006,4718
84111,10744,5629,5115,1913,4683,2437,1711
84112,1942,1028,914,889,1022,29,2
84113,245,121,124,151,91,3,0
84115,24668,12794,11874,6428,9625,5697,2918
84116,33297,17222,16075,11864,10811,7198,3424
84117,24305,11520,12785,5944,6659,5903,5799
84118,68295,34461,33834,24398,21531,15555,6811
84119,53077,27684,25393,16940,18594,11512,6031
84120,48956,24587,24369,17593,14748,10899,5716
84121,41702,20618,21084,10489,11204,10955,9054
84123,37900,18502,19398,11073,12246,9132,5449
84124,21295,10341,10954,5587,5568,5440,4700
84128,27983,14120,13863,10914,8946,6082,2041
84144,0,0,0,0,0,0,0
84180,0,0,0,0,0,0,0
84301,883,461,422,305,204,227,147
84302,23703,11911,11792,8391,6199,5277,3836
84304,40,20,20,12,10,7,11
84305,751,399,352,279,190,159,123
84306,318,162,156,110,61,96,51
84307,1375,691,684,482,349,356,188
84308,325,174,151,134,86,69,36
84309,535,260,275,176,115,141,103
84310,4111,2100,2011,1364,744,1333,670
84311,714,359,355,239,179,175,121
84312,4028,2039,1989,1572,1013,866,577
84313,68,34,34,21,15,18,14
84314,1031,521,510,410,246,216,159
84315,7581,3842,3739,2837,2039,1824,881
84316,254,135,119,88,56,66,44
84317,2304,1188,1116,665,387,774,478
84318,3918,1981,1937,1582,933,952,451
84319,7905,3965,3940,3323,2258,1567,757
84320,2237,1109,1128,852,530,528,327
84321,44074,21678,22396,15130,18860,6325,3759
84324,701,369,332,209,127,220,145
84325,2078,1042,1036,911,417,494,256
84326,1763,879,884,739,432,428,164
84327,951,471,480,391,213,212,135
84328,1666,844,822,613,319,468,266
84329,202,104,98,84,37,46,35
84330,502,264,238,204,117,108,73
84331,272,142,130,86,50,84,52
84332,7218,3518,3700,2717,1921,1446,1134
84333,2722,1371,1351,1036,683,647,356
84334,230,119,111,75,72,55,28
84335,11372,5683,5689,4450,3050,2400,1472
84336,281,143,138,105,70,63,43
84337,11393,5705,5688,4496,3008,2488,1401
84338,481,242,239,176,108,128,69
84339,5046,2559,2487,2034,1292,1084,636
84340,3369,1694,1675,1197,868,855,449
84341,20109,10064,10045,6517,8092,3323,2177
84401,35622,18410,17212,11865,11426,8384,3947
84403,36582,18177,18405,11139,11245,8118,6080
84404,56363,28278,28085,18774,17527,12549,7513
84405,31348,15602,15746,10101,9327,6774,5146
84414,26507,13229,13278,9221,6444,6585,4257
84501,13612,6757,6855,4309,3631,3236,2436
84511,4672,2307,2365,1810,1179,951,732
84512,1093,549,544,370,289,261,173
84513,1710,891,819,603,407,415,285
84515,15,7,8,2,1,9,3
84516,227,116,111,69,42,57,59
84518,702,346,356,230,158,176,138
84520,1302,627,675,326,289,331,356
84521,840,426,414,285,199,209,147
84522,321,171,150,98,61,83,79
84523,1797,881,916,570,419,446,362
84525,1183,596,587,400,270,285,228
84526,4134,2061,2073,1143,1012,1092,887
84528,2742,1411,1331,1013,669,616,444
84529,180,94,86,24,41,67,48
84530,460,232,228,130,111,143,76
84531,622,304,318,257,146,141,78
84532,9772,4917,4855,2489,2476,2853,1954
84533,267,148,119,61,88,80,38
84534,2654,1338,1316,1089,665,592,308
84535,2601,1349,1252,904,586,595,516
84536,1174,580,594,470,295,268,141
84537,1505,778,727,538,351,384,232
84539,379,189,190,113,93,101,72
84540,46,25,21,3,6,21,16
84542,1806,892,914,596,479,413,318
84601,31486,15772,15714,11134,12855,5055,2442
84604,49145,24587,24558,17848,20390,5467,5440
84606,32291,15594,16697,7597,21148,2362,1184
84620,1151,561,590,380,261,293,217
84621,240,116,124,83,50,48,59
84622,1517,739,778,560,352,324,281
84623,405,207,198,170,121,85,29
84624,5668,2870,2798,2048,1288,1303,1029
84626,410,237,173,158,118,84,50
84627,6310,2961,3349,2886,2076,752,596
84628,721,369,352,207,169,177,168
84629,2531,1293,1238,891,491,623,526
84630,294,145,149,104,67,79,44
84631,3067,1565,1502,1068,703,719,577
84632,1148,576,572,452,249,261,186
84633,1048,536,512,403,255,259,131
84634,3395,2465,930,726,1343,939,387
84635,863,433,430,288,172,234,169
84636,474,241,233,154,97,111,112
84637,729,391,338,242,127,172,188
84638,294,153,141,105,60,84,45
84639,963,501,462,308,228,206,221
84640,121,56,65,30,23,32,36
84642,3548,1773,1775,1406,760,700,682
84643,605,294,311,176,122,153,154
84645,2620,1325,1295,1349,605,448,218
84646,1657,806,851,651,416,313,277
84647,4019,2036,1983,1546,873,822,778
84648,5776,2945,2831,2174,1453,1288,861
84649,760,403,357,278,136,218,128
84651,23457,11808,11649,9948,6270,4573,2666
84652,872,447,425,320,197,217,138
84653,7947,4004,3943,3288,1800,1829,1030
84654,2689,1368,1321,909,747,595,438
84655,10547,5453,5094,4742,3112,1807,886
84656,345,162,183,110,82,62,91
84657,505,253,252,183,124,105,93
84660,37995,19304,18691,16237,11761,6717,3280
84662,1371,686,685,475,257,338,301
84663,29975,14942,15033,12062,9014,5621,3278
84664,8033,4014,4019,3407,1628,1910,1088
84665,528,322,206,162,159,123,84
84667,405,225,180,162,88,81,74
84701,8692,4365,4327,3007,2223,1831,1631
84710,131,60,71,48,22,28,33
84711,735,372,363,276,162,152,145
84712,201,103,98,49,31,57,64
84713,3792,1960,1832,1356,822,893,721
84714,835,437,398,303,192,201,139
84715,459,231,228,146,102,117,94
84716,297,155,142,62,57,115,63
84718,189,98,91,63,35,46,45
84719,90,50,40,22,18,35,15
84720,19705,9561,10144,6603,6833,3467,2802
84721,20961,10611,10350,8024,6502,4125,2310
84722,615,311,304,138,105,160,212
84723,687,339,348,228,132,148,179
84724,1214,594,620,410,303,270,231
84725,1964,1005,959,835,473,388,268
84726,961,494,467,249,188,280,244
84728,158,80,78,44,41,41,32
84729,396,201,195,151,81,100,64
84730,268,149,119,93,47,73,55
84731,194,96,98,73,38,46,37
84732,77,44,33,21,14,19,23
84733,202,107,95,97,40,28,37
84734,261,136,125,94,47,67,53
84735,258,129,129,53,43,70,92
84736,246,124,122,90,41,60,55
84737,14838,7504,7334,4887,3574,3020,3357
84738,6878,3368,3510,2069,1421,1545,1843
84739,507,279,228,183,119,115,90
84740,191,91,100,70,37,47,37
84741,5556,2718,2838,1428,1063,1467,1598
84742,260,133,127,70,50,71,69
84743,34,16,18,6,5,10,13
84744,411,230,181,199,43,73,96
84745,4066,2050,2016,1491,1054,826,695
84746,1149,571,578,330,176,290,353
84747,1097,541,556,434,270,208,185
84749,218,119,99,80,48,52,38
84750,469,242,227,131,67,112,159
84751,1680,863,817,606,439,379,256
84752,994,507,487,404,238,211,141
84753,26,16,10,4,4,8,10
84754,3652,1836,1816,1177,770,827,878
84755,112,64,48,22,21,29,40
84756,366,183,183,143,94,80,49
84757,1167,599,568,296,174,340,357
84758,533,265,268,169,94,151,119
84759,2112,1093,1019,690,471,475,476
84760,559,284,275,163,113,142,141
84761,3131,1563,1568,966,591,794,780
84762,248,137,111,37,30,88,93
84763,245,119,126,40,45,87,73
84764,331,167,164,79,147,72,33
84765,6143,3074,3069,2432,1273,1475,963
84766,147,74,73,35,34,43,35
84767,679,348,331,109,194,197,179
84770,39131,19252,19879,12482,11073,7009,8567
84772,171,81,90,37,31,42,61
84773,321,167,154,67,67,99,88
84774,1399,708,691,454,282,337,326
84775,431,216,215,77,55,149,150
84776,538,284,254,188,108,122,120
84779,641,344,297,213,130,151,147
84780,18756,9330,9426,6452,5111,3372,3821
84781,188,94,94,14,14,68,92
84782,794,405,389,226,143,231,194
84783,805,386,419,199,101,244,261
84784,2745,1325,1420,1891,524,248,82
84790,35770,17427,18343,11304,8466,6781,9219
86044,426,212,214,173,91,95,67
86514,306,154,152,109,66,80,51
5001,9123,4325,4798,2041,2115,2834,2133
5031,218,111,107,40,38,56,84
5032,2664,1332,1332,615,611,847,591
5033,2744,1312,1432,752,615,815,562
5034,310,158,152,75,55,110,70
5035,638,325,313,112,114,237,175
5036,1037,542,495,237,178,373,249
5037,560,272,288,115,84,194,167
5038,1230,607,623,259,248,395,328
5039,1110,558,552,253,224,375,258
5040,471,236,235,115,106,127,123
5041,354,188,166,112,80,103,59
5042,605,290,315,136,123,181,165
5043,937,445,492,244,172,350,171
5045,1758,880,878,373,351,607,427
5046,1139,562,577,304,231,349,255
5048,2429,1234,1195,572,469,887,501
5050,146,65,81,32,21,56,37
5051,1549,759,790,345,253,557,394
5052,348,175,173,70,89,113,76
5053,332,163,169,66,55,117,94
5055,3363,1594,1769,873,588,1149,753
5056,567,293,274,103,86,191,187
5058,346,176,170,86,79,116,65
5059,874,428,446,215,178,268,213
5060,4415,2126,2289,964,947,1381,1123
5061,1679,967,712,495,483,419,282
5062,702,340,362,147,124,248,183
5065,1064,534,530,254,220,391,199
5067,258,124,134,54,28,101,75
5068,3125,1543,1582,615,1006,953,551
5069,555,284,271,136,125,163,131
5070,484,220,264,115,92,149,128
5071,324,165,159,49,41,124,110
5072,526,271,255,128,92,185,121
5075,1113,527,586,241,189,426,257
5076,412,222,190,105,104,115,88
5077,1215,597,618,267,263,406,279
5079,730,372,358,165,180,258,127
5081,550,269,281,128,140,152,130
5083,151,70,81,37,42,51,21
5084,140,70,70,38,29,53,20
5086,793,390,403,195,180,266,152
5089,4979,2400,2579,1039,1073,1556,1311
5091,3288,1557,1731,653,482,1043,1110
5101,4643,2249,2394,1108,1091,1419,1025
5141,112,51,61,13,13,35,51
5142,680,336,344,147,130,236,167
5143,4343,2128,2215,973,819,1431,1120
5146,750,393,357,156,120,246,228
5148,1140,565,575,228,219,409,284
5149,2092,1020,1072,382,412,630,668
5150,831,385,446,157,162,253,259
5151,1553,792,761,299,279,541,434
5152,448,226,222,104,63,147,134
5153,687,345,342,147,106,223,211
5154,661,309,352,185,141,199,136
5155,828,417,411,180,166,249,233
5156,9226,4642,4584,2109,2091,2786,2240
5158,1049,514,535,221,208,383,237
5161,552,285,267,86,69,160,237
5201,14851,7073,7778,3629,3364,4182,3676
5250,3408,1673,1735,730,630,1112,936
5251,1350,655,695,277,154,434,485
5252,274,122,152,66,52,94,62
5253,685,343,342,150,118,249,168
5254,273,124,149,53,31,80,109
5255,4121,1942,2179,898,599,1381,1243
5257,2718,1220,1498,748,755,674,541
5260,459,232,227,120,111,126,102
5261,2738,1418,1320,678,574,867,619
5262,2547,1244,1303,545,447,903,652
5301,16820,7949,8871,3682,3864,5369,3905
5340,763,388,375,160,116,243,244
5341,407,211,196,83,84,148,92
5342,581,297,284,135,111,188,147
5343,917,501,416,217,181,288,231
5345,2119,1030,1089,465,371,749,534
5346,5184,2662,2522,1228,1136,1737,1083
5350,763,401,362,161,126,267,209
5352,824,423,401,187,120,330,187
5353,1072,527,545,239,187,352,294
5354,2210,1096,1114,546,383,715,566
5355,813,421,392,193,156,298,166
5356,717,374,343,120,114,269,214
5358,148,82,66,25,26,49,48
5359,594,306,288,113,106,200,175
5360,251,131,120,54,44,93,60
5361,947,486,461,222,190,322,213
5362,127,63,64,26,26,52,23
5363,2021,1033,988,417,435,660,509
5401,28185,14174,14011,5333,14212,5315,3325
5403,17593,8289,9304,3610,5023,5184,3776
5404,7240,3546,3694,1524,3028,1635,1053
5405,4406,1838,2568,2922,1481,3,0
5408,10114,4755,5359,2371,2398,3010,2335
5439,1734,852,882,622,1100,2,10
5440,1998,996,1002,459,481,654,404
5441,958,493,465,287,224,297,150
5442,339,163,176,80,75,123,61
5443,6656,3323,3333,1680,1416,2267,1293
5444,1714,877,837,465,412,621,216
5445,3754,1832,1922,1044,566,1409,735
5446,15373,7642,7731,3623,4129,4998,2623
5447,79,44,35,19,19,24,17
5448,1134,574,560,294,244,401,195
5450,4977,2531,2446,1381,1162,1492,942
5452,19710,9604,10106,5166,4720,6578,3246
5454,4447,2206,2241,1239,1064,1515,629
5455,1080,562,518,324,231,350,175
5456,1277,645,632,335,254,443,245
5457,1617,804,813,455,383,488,291
5458,2044,1034,1010,476,383,751,434
5459,2156,1080,1076,610,548,661,337
5461,4542,2300,2242,1162,1006,1690,684
5462,1938,973,965,512,425,749,252
5463,471,233,238,107,90,173,101
5464,3008,1495,1513,796,821,959,432
5465,5355,2683,2672,1495,961,1998,901
5468,12942,6441,6501,3574,3145,4376,1847
5471,896,437,459,214,184,310,188
5472,1643,834,809,380,332,614,317
5473,1413,737,676,326,309,514,264
5474,803,403,400,158,136,286,223
5476,3183,1561,1622,856,710,971,646
5477,4397,2177,2220,1176,956,1619,646
5478,14449,7049,7400,3773,3613,4274,2789
5481,0,0,0,0,0,0,0
5482,7198,3393,3805,1825,1079,2346,1948
5483,1303,678,625,337,306,435,225
5485,93,45,48,25,29,23,16
5486,1654,812,842,350,291,619,394
5487,1498,772,726,400,361,529,208
5488,7690,3764,3926,1975,1767,2485,1463
5489,3174,1561,1613,816,569,1223,566
5491,5909,2987,2922,1515,1282,1835,1277
5492,682,350,332,171,141,240,130
5494,1767,883,884,460,370,686,251
5495,9341,4481,4860,2457,1672,3210,2002
5602,11916,5607,6309,2512,2704,3827,2873
5640,161,75,86,25,18,53,65
5641,17169,8256,8913,4070,3886,5351,3862
5647,1141,573,568,308,214,369,250
5648,423,209,214,95,64,169,95
5649,574,277,297,156,145,167,106
5650,1123,550,573,268,246,415,194
5651,1546,780,766,385,289,537,335
5652,776,407,369,216,209,235,116
5653,547,282,265,163,137,173,74
5654,970,480,490,253,233,281,203
5655,2868,1390,1478,733,653,818,664
5656,3508,1814,1694,982,1237,821,468
5657,56,29,27,4,3,25,24
5658,1402,701,701,356,286,449,311
5660,1660,848,812,385,294,650,331
5661,5620,2698,2922,1381,1257,1702,1280
5663,6773,3739,3034,1911,2144,1563,1155
5664,80,35,45,22,30,15,13
5667,2166,1082,1084,527,474,745,420
5669,634,326,308,141,130,220,143
5672,4314,2196,2118,969,906,1381,1058
5673,2574,1263,1311,564,485,936,589
5674,1705,877,828,401,335,584,385
5675,1064,548,516,221,230,400,213
5676,4984,2490,2494,1140,1260,1677,907
5677,2232,1119,1113,554,477,779,422
5678,163,79,84,35,42,45,41
5679,3296,1638,1658,792,727,1096,681
5680,2168,1109,1059,609,494,709,356
5681,458,234,224,84,91,168,115
5682,1251,618,633,309,240,438,264
5701,20802,9982,10820,4443,4659,6434,5266
5730,302,144,158,62,48,113,79
5732,708,356,352,135,177,231,165
5733,5895,2924,2971,1310,1149,1971,1465
5734,1306,655,651,298,266,407,335
5735,4402,2235,2167,1193,1276,1159,774
5736,684,345,339,139,121,224,200
5737,875,453,422,222,160,319,174
5738,1072,546,526,198,189,375,310
5739,1407,712,695,328,314,437,328
5740,25,11,14,6,7,4,8
5742,597,311,286,121,119,206,151
5743,4330,2146,2184,1042,925,1367,996
5744,533,264,269,107,130,197,99
5747,280,146,134,55,72,107,46
5748,323,174,149,67,50,117,89
5751,811,439,372,127,182,288,214
5753,10491,5062,5429,2787,3039,2499,2166
5757,832,416,416,171,138,290,233
5758,784,390,394,157,144,276,207
5759,1827,926,901,365,357,645,460
5760,1123,551,572,276,210,369,268
5761,1000,501,499,227,179,348,246
5762,542,274,268,108,108,188,138
5763,2747,1367,1380,623,515,969,640
5764,3452,1689,1763,892,975,911,674
5765,1803,861,942,458,355,596,394
5766,572,289,283,128,94,217,133
5767,1143,576,567,216,185,422,320
5769,1216,620,596,277,236,442,261
5770,1136,580,556,268,216,413,239
5772,713,359,354,149,144,231,189
5773,2136,1054,1082,447,398,730,561
5774,1129,588,541,196,201,373,359
5775,623,316,307,158,155,167,143
5776,714,369,345,145,116,217,236
5777,3420,1690,1730,830,741,1134,715
5778,733,358,375,173,154,255,151
5819,9444,4670,4774,2321,2121,2827,2175
5820,662,353,309,165,154,203,140
5821,1269,634,635,315,236,413,305
5822,1873,919,954,432,345,537,559
5824,1139,569,570,274,234,378,253
5825,191,101,90,43,42,67,39
5826,983,493,490,210,232,277,264
5827,309,142,167,54,81,83,91
5828,1928,931,997,454,346,622,506
5829,2003,964,1039,455,368,628,552
5830,1502,719,783,384,319,409,390
5832,982,501,481,225,236,308,213
5833,273,141,132,55,54,87,77
5836,1068,556,512,261,201,372,234
5837,353,174,179,74,84,118,77
5839,775,376,399,181,162,203,229
5841,425,197,228,64,53,123,185
5842,522,258,264,141,123,140,118
5843,2556,1235,1321,712,597,757,490
5845,1096,574,522,274,233,351,238
5846,1252,629,623,260,225,400,367
5847,879,455,424,250,189,279,161
5850,231,120,111,118,43,48,22
5851,6528,3285,3243,1707,1677,1758,1386
5853,711,349,362,145,115,224,227
5855,7170,3636,3534,1654,1746,2065,1705
5857,1540,771,769,353,347,476,364
5858,368,179,189,83,69,115,101
5859,1819,913,906,466,449,523,381
5860,2557,1277,1280,619,562,813,563
5862,356,172,184,78,54,127,97
5866,732,380,352,172,162,247,151
5867,899,479,420,225,199,283,192
5868,364,182,182,79,76,134,75
5871,1638,804,834,381,372,516,369
5872,789,402,387,179,148,253,209
5873,675,318,357,164,134,241,136
5874,505,247,258,109,94,157,145
5875,454,228,226,119,83,132,120
5901,20,13,7,0,1,4,15
5902,188,84,104,50,25,73,40
5903,868,439,429,189,114,307,258
5904,267,133,134,52,63,88,64
5905,827,423,404,151,133,305,238
5906,1178,604,574,253,250,357,318
5907,177,94,83,19,25,59,74
20105,11315,5576,5739,3836,3887,2849,743
20106,5142,2624,2518,1381,899,1757,1105
20109,37265,18848,18417,10976,14478,8598,3213
20110,43876,22352,21524,13434,13448,12070,4924
20111,30590,15562,15028,9424,9261,8616,3289
20112,25833,12941,12892,7872,4978,9619,3364
20115,5838,2914,2924,1424,1075,2069,1270
20117,2693,1281,1412,558,490,913,732
20118,7,2,5,0,2,2,3
20119,3946,1981,1965,1045,817,1297,787
20120,40695,20149,20546,11970,11473,13420,3832
20121,27988,13932,14056,7908,10277,7889,1914
20124,14857,7339,7518,4309,2493,5644,2411
20129,618,308,310,223,82,241,72
20130,281,142,139,57,46,106,72
20132,15900,7836,8064,5353,2952,5434,2161
20135,2694,1375,1319,617,489,1023,565
20136,28498,14163,14335,11088,7758,7937,1715
20137,1510,740,770,386,210,560,354
20139,217,105,112,26,34,71,86
20141,6131,3029,3102,2114,1142,2090,785
20143,1216,628,588,321,207,423,265
20144,1012,505,507,228,119,368,297
20147,54086,26261,27825,17547,14904,16265,5370
20148,28310,13994,14316,10605,9185,7346,1174
20151,21374,10708,10666,6458,5345,7068,2503
20152,24946,12251,12695,9193,7403,6821,1529
20155,29411,14437,14974,9026,7341,8199,4845
20158,4288,2115,2173,1257,701,1567,763
20164,37747,19354,18393,10507,12355,10656,4229
20165,32383,15824,16559,9891,8112,10704,3676
20166,9521,4759,4762,2706,3770,2432,613
20169,19801,9864,9937,6377,4139,6299,2986
20170,41236,21346,19890,11541,13239,12355,4101
20171,45887,22918,22969,13524,13549,14405,4409
20175,27169,13447,13722,8609,6771,8731,3058
20176,46506,22734,23772,15357,12006,13649,5494
20180,6549,3244,3305,2008,1157,2358,1026
20181,7877,3941,3936,2218,1415,2785,1459
20184,839,407,432,191,134,293,221
20186,14557,6929,7628,3835,3148,4484,3090
20187,15252,7595,7657,4588,2713,5264,2687
20190,17529,8409,9120,3286,6167,4634,3442
20191,29128,14210,14918,6984,8346,8491,5307
20194,13165,6298,6867,3200,3788,4385,1792
20197,1840,894,946,608,225,698,309
20198,2492,1225,1267,563,471,879,579
22003,55990,27597,28393,13892,14704,16838,10556
22015,43102,20941,22161,11677,10074,14139,7212
22025,17379,8434,8945,5036,3972,5477,2894
22026,14258,6909,7349,4994,4289,3978,997
22027,2362,1166,1196,647,437,824,454
22030,55066,27388,27678,14138,19254,14116,7558
22031,29795,14893,14902,6762,10359,8148,4526
22032,29377,14557,14820,7854,5927,9839,5757
22033,37691,18435,19256,8820,13764,10637,4470
22035,0,0,0,0,0,0,0
22039,18364,9150,9214,5129,2140,7145,3950
22041,27989,14314,13675,6608,9606,7391,4384
22042,33537,16828,16709,7821,11550,9251,4915
22043,24302,12060,12242,5571,8209,6773,3749
22044,14092,7262,6830,3231,4750,3889,2222
22046,16235,7941,8294,4334,3823,5318,2760
22060,8878,4362,4516,3633,3008,1505,732
22066,18099,9087,9012,5596,2232,6615,3656
22079,32059,15487,16572,9790,8822,10282,3165
22101,29887,14370,15517,8478,3956,9840,7613
22102,21985,10505,11480,4920,6453,6430,4182
22124,17558,8535,9023,4786,3390,6034,3348
22125,711,344,367,99,186,278,148
22134,6862,4538,2324,1895,4456,432,79
22150,27105,13486,13619,6624,7703,7449,5329
22151,17456,8800,8656,4566,4391,5381,3118
22152,28550,13712,14838,7671,6656,9203,5020
22153,31285,15430,15855,8863,7172,10404,4846
22172,8699,4267,4432,2802,2559,2516,822
22180,23491,11802,11689,6135,5886,7318,4152
22181,14879,7375,7504,4053,3243,4856,2727
22182,24863,12272,12591,7084,4552,8408,4819
22185,0,0,0,0,0,0,0
22191,57598,28751,28847,17924,19633,15028,5013
22192,53394,25700,27694,15401,15239,15935,6819
22193,73047,36113,36934,23527,21163,21295,7062
22201,33476,17000,16476,3511,20164,6863,2938
22202,22543,11166,11377,1886,11812,5348,3497
22203,21850,11163,10687,2833,11318,4539,3160
22204,47233,23676,23557,9812,19338,12688,5395
22205,17087,8534,8553,4403,4634,5219,2831
22206,19051,8816,10235,2837,9730,4550,1934
22207,30920,15020,15900,8231,7163,9509,6017
22209,12314,6334,5980,957,7684,2403,1270
22211,648,543,105,108,457,78,5
22213,2936,1445,1491,705,875,880,476
22214,0,0,0,0,0,0,0
22301,11162,5283,5879,2537,3684,3434,1507
22302,16485,7620,8865,3019,6037,4808,2621
22303,12601,6546,6055,1964,5237,3413,1987
22304,44300,20795,23505,8453,17713,11671,6463
22305,15440,8064,7376,3367,6706,3931,1436
22306,32326,15713,16613,9338,10036,8819,4133
22307,9581,4498,5083,1977,2196,3133,2275
22308,12737,6192,6545,3818,1560,4403,2956
22309,33220,16395,16825,9269,9302,9837,4812
22310,29609,14441,15168,7114,8493,9458,4544
22311,17560,8812,8748,3258,7753,4332,2217
22312,30614,15120,15494,7346,10643,8676,3949
22314,29653,14194,15459,4090,11458,8721,5384
22315,26202,12416,13786,6518,7645,8835,3204
22401,24286,11144,13142,6480,9158,5246,3402
22405,29152,14442,14710,8741,6684,8953,4774
22406,20757,10056,10701,6497,4853,6186,3221
22407,54962,26617,28345,16862,14141,15810,8149
22408,26851,13041,13810,8545,6977,7838,3491
22427,3286,1681,1605,699,780,973,834
22432,394,186,208,83,77,113,121
22433,232,110,122,71,48,68,45
22435,2439,1202,1237,597,517,651,674
22436,746,374,372,207,153,218,168
22437,725,343,382,153,155,207,210
22438,463,228,235,99,92,141,131
22443,8083,3931,4152,1814,1754,2305,2210
22448,599,378,221,202,334,61,2
22454,1796,895,901,412,383,554,447
22460,1876,880,996,405,339,538,594
22469,1921,914,1007,436,337,600,548
22473,5099,2452,2647,978,780,1436,1905
22476,369,190,179,71,78,127,93
22480,714,313,401,60,51,132,471
22482,2993,1330,1663,504,403,683,1403
22485,23004,11482,11522,6872,5527,7053,3552
22488,1398,709,689,284,248,441,425
22503,4334,2082,2252,842,656,1261,1575
22504,263,141,122,52,40,93,78
22508,12696,6189,6507,3223,2553,3355,3565
22509,31,19,12,4,1,12,14
22511,1240,600,640,233,147,308,552
22514,2603,1283,1320,667,543,770,623
22520,5402,2626,2776,1182,1027,1532,1661
22529,335,173,162,79,71,112,73
22530,126,67,59,15,15,31,65
22534,2796,1401,1395,847,663,892,394
22535,580,290,290,126,119,186,149
22538,307,155,152,72,62,94,79
22539,2063,1023,1040,288,235,570,970
22542,1950,978,972,538,420,628,364
22546,15850,7714,8136,4495,4428,4466,2461
22548,73,38,35,4,7,25,37
22551,19242,9584,9658,5514,4305,6168,3255
22553,13935,6875,7060,4390,3188,4473,1884
22554,51463,25778,25685,16790,13679,16545,4449
22556,25675,12802,12873,8575,6298,8333,2469
22560,6704,3074,3630,1704,1488,1899,1613
22567,3163,1578,1585,894,667,963,639
22572,7470,4397,3073,1418,2056,2381,1615
22576,1785,859,926,344,253,503,685
22578,2510,1234,1276,405,358,726,1021
22579,155,78,77,14,9,22,110
22580,5160,2548,2612,1350,1163,1527,1120
22601,27813,13669,14144,7336,8297,7035,5145
22602,28443,14154,14289,8190,6961,8403,4889
22603,13910,6990,6920,3203,2967,4392,3348
22610,1842,917,925,397,323,686,436
22611,8757,4262,4495,2353,1464,2822,2118
22620,2348,1183,1165,526,407,861,554
22623,670,349,321,187,149,218,116
22624,2565,1308,1257,654,521,870,520
22625,3641,1878,1763,1105,792,1106,638
22627,637,309,328,133,115,193,196
22630,30292,14944,15348,8227,7164,9080,5821
22637,1970,991,979,471,410,662,427
22639,560,284,276,113,88,196,163
22640,532,260,272,113,67,186,166
22641,361,182,179,76,56,136,93
22642,4414,2281,2133,1198,1093,1540,583
22643,197,101,96,42,39,65,51
22644,2177,1118,1059,489,423,729,536
22645,3880,1968,1912,1039,808,1264,769
22646,205,98,107,43,43,58,61
22650,978,492,486,221,194,301,262
22652,1399,719,680,328,239,466,366
22654,640,341,299,135,116,236,153
22655,19328,9381,9947,5784,5010,5533,3001
22656,2381,1200,1181,592,480,808,501
22657,10956,5267,5689,2935,2619,3094,2308
22660,1689,826,863,410,348,528,403
22663,1536,842,694,424,341,500,271
22664,8753,4159,4594,2132,1991,2240,2390
22701,31444,15348,16096,9244,7990,8575,5635
22709,874,433,441,210,183,260,221
22711,92,54,38,15,22,30,25
22712,8415,4107,4308,2723,2289,2433,970
22713,1406,702,704,385,265,471,285
22714,1129,585,544,328,246,356,199
22715,1082,530,552,261,214,335,272
22716,853,437,416,198,155,299,201
22718,534,273,261,127,96,187,124
22719,395,189,206,84,63,151,97
22720,1059,536,523,216,170,421,252
22722,273,140,133,57,63,92,61
22723,128,66,62,23,17,46,42
22724,2282,1145,1137,667,418,757,440
22726,776,410,366,256,170,228,122
22727,5547,2637,2910,1390,1101,1622,1434
22728,3310,1684,1626,877,651,1175,607
22729,1338,1263,75,41,625,596,76
22730,115,55,60,22,23,31,39
22731,139,65,74,46,32,35,26
22732,191,92,99,52,41,52,46
22733,1469,797,672,432,331,400,306
22734,3187,1574,1613,1030,865,954,338
22735,2277,1118,1159,599,483,700,495
22736,732,367,365,214,159,247,112
22737,2936,1452,1484,803,570,1045,518
22738,1149,559,590,291,232,351,275
22740,1313,646,667,264,218,401,430
22741,182,96,86,41,35,60,46
22742,1926,1001,925,527,425,724,250
22743,204,114,90,31,33,81,59
22747,1132,564,568,203,203,361,365
22749,349,169,180,67,53,112,117
22801,37989,18200,19789,9757,16652,6499,5081
22802,26293,12783,13510,6837,8690,6219,4547
22807,3311,1055,2256,2535,766,4,6
22810,863,430,433,124,108,255,376
22811,500,258,242,106,99,141,154
22812,8927,4121,4806,2500,2242,2174,2011
22815,8355,4092,4263,2196,2030,2404,1725
22820,214,119,95,43,41,64,66
22821,5753,2879,2874,1676,1329,1561,1187
22824,6018,2980,3038,1466,1286,1807,1459
22827,10388,5073,5315,2632,2217,3261,2278
22830,1773,911,862,437,453,534,349
22831,813,424,389,174,190,243,206
22832,1091,547,544,256,245,370,220
22834,1250,620,630,335,246,404,265
22835,11634,5734,5900,2546,2397,3519,3172
22840,4354,2161,2193,1174,953,1379,848
22841,2791,1388,1403,720,588,893,590
22842,5063,2547,2516,1241,1094,1561,1167
22843,2458,1260,1198,616,574,717,551
22844,4528,2212,2316,983,828,1337,1380
22845,33,14,19,2,1,11,19
22846,1855,927,928,523,425,561,346
22847,1066,525,541,256,209,342,259
22849,5044,2407,2637,1301,1226,1458,1059
22850,899,462,437,234,203,284,178
22851,5956,2982,2974,1512,1451,1708,1285
22853,4367,2167,2200,1094,1002,1279,992
22901,32532,15177,17355,7789,8609,8722,7412
22902,21223,10452,10771,4548,7645,5786,3244
22903,38229,18476,19753,6903,19727,6838,4761
22904,4633,2072,2561,3515,1102,14,2
22911,15971,7518,8453,4388,3482,4927,3174
22920,4186,2069,2117,935,802,1365,1084
22922,1993,952,1041,465,393,635,500
22923,5035,2514,2521,1383,1086,1675,891
22931,382,192,190,80,57,137,108
22932,7488,3621,3867,2121,1535,2409,1423
22935,926,479,447,254,212,274,186
22936,4853,2401,2452,1203,653,1758,1239
22937,1486,729,757,397,315,462,312
22938,1444,698,746,321,276,479,368
22939,5398,2652,2746,1395,1169,1532,1302
22940,1119,535,584,271,221,339,288
22942,8113,3909,4204,1967,1787,2623,1736
22943,444,230,214,105,92,155,92
22946,244,126,118,64,50,99,31
22947,4198,2015,2183,972,559,1338,1329
22948,305,157,148,77,85,92,51
22949,1300,630,670,255,259,382,404
22952,2029,1012,1017,489,391,636,513
22958,1637,798,839,190,175,439,833
22959,1578,763,815,369,286,546,377
22960,10722,5328,5394,2572,2443,3201,2506
22963,15401,7377,8024,4154,3329,4387,3531
22964,261,127,134,74,55,73,59
22967,1956,985,971,420,379,624,533
22968,9815,4849,4966,2831,2407,2910,1667
22969,1437,709,728,333,328,452,324
22971,1735,866,869,409,359,532,435
22972,439,231,208,107,74,141,117
22973,6191,2997,3194,1425,1344,1877,1545
22974,5385,2051,3334,1004,1619,1884,878
22976,339,165,174,94,85,95,65
22980,31451,15142,16309,7810,7513,8688,7440
22989,112,58,54,43,28,36,5
23002,10439,5105,5334,2561,2229,3261,2388
23004,851,413,438,180,181,284,206
23005,15227,7331,7896,3820,3595,4583,3229
23009,6279,3055,3224,1756,1540,2033,950
23011,1429,894,535,215,480,514,220
23015,4249,2117,2132,1145,845,1449,810
23021,345,172,173,86,52,113,94
23022,930,456,474,206,190,316,218
23023,323,163,160,66,63,115,79
23024,8120,4035,4085,1978,1720,2695,1727
23025,233,112,121,52,30,54,97
23027,1413,688,725,361,338,394,320
23030,5128,2527,2601,1011,979,1846,1292
23032,283,143,140,74,43,94,72
23035,1473,708,765,319,272,421,461
23038,1775,865,910,408,374,599,394
23039,1056,515,541,234,152,371,299
23040,4661,2279,2382,1230,1049,1342,1040
23043,1692,844,848,214,201,541,736
23045,96,51,45,21,19,26,30
23047,1952,960,992,426,353,656,517
23050,598,311,287,139,133,170,156
23055,915,468,447,246,187,239,243
23056,458,244,214,85,77,144,152
23059,31919,15385,16534,10173,7442,10079,4225
23060,33417,15973,17444,9137,9038,10178,5064
23061,21208,10432,10776,5358,4455,6952,4443
23062,2340,1137,1203,489,578,698,575
23063,5278,2259,3019,1154,1260,1827,1037
23064,131,64,67,19,12,44,56
23065,1909,961,948,466,410,665,368
23066,471,216,255,86,54,123,208
23068,257,122,135,52,55,51,99
23069,3197,1880,1317,689,838,1056,614
23070,431,212,219,64,49,131,187
23071,1563,769,794,279,224,465,595
23072,11541,5775,5766,2774,2661,3594,2512
23075,9819,4440,5379,2680,2652,2782,1705
23076,606,304,302,128,97,156,225
23079,437,229,208,104,77,138,118
23083,1732,861,871,444,379,558,351
23084,1799,891,908,441,367,578,413
23085,364,181,183,56,65,133,110
23086,3247,1627,1620,829,804,1032,582
23089,4914,2494,2420,1122,909,1741,1142
23091,309,143,166,84,60,96,69
23092,584,287,297,105,105,168,206
23093,12694,6195,6499,3174,2874,3919,2727
23102,2659,1308,1351,581,461,1015,602
23103,4634,2273,2361,952,612,1724,1346
23106,976,484,492,253,236,295,192
23108,161,78,83,37,27,57,40
23109,1821,829,992,371,320,523,607
23110,794,400,394,180,141,258,215
23111,36490,17569,18921,10206,8253,11055,6976
23112,46982,22608,24374,13995,12269,13953,6765
23113,23848,11524,12324,6737,3754,8098,5259
23114,17449,8217,9232,5349,4067,5432,2601
23115,146,65,81,49,29,45,23
23116,27228,13458,13770,8311,4765,9507,4645
23117,9141,4571,4570,2020,1825,2943,2353
23119,295,146,149,40,38,111,106
23120,5971,2989,2982,2097,1077,2117,680
23123,1860,926,934,434,370,593,463
23124,3185,1606,1579,919,692,1037,537
23125,223,108,115,37,29,69,88
23126,534,253,281,142,118,171,103
23128,1045,521,524,228,168,356,293
23129,374,184,190,99,70,124,81
23130,268,128,140,45,48,82,93
23138,953,489,464,194,133,307,319
23139,24425,12316,12109,6934,4761,8080,4650
23140,5175,2565,2610,1202,1017,1775,1181
23141,6471,3174,3297,1597,1340,2282,1252
23146,3093,1557,1536,813,483,1100,697
23148,1827,913,914,465,360,609,393
23149,3190,1679,1511,668,740,1037,745
23150,12045,5764,6281,2939,2925,3689,2492
23153,1334,693,641,365,252,481,236
23156,1555,770,785,354,347,473,381
23160,2708,2704,4,31,1453,1107,117
23161,173,95,78,37,32,60,44
23163,220,101,119,38,17,81,84
23168,6115,2961,3154,1656,1286,1989,1184
23169,1325,632,693,283,214,434,394
23173,2820,1243,1577,1170,1601,20,29
23175,1907,896,1011,323,294,564,726
23176,656,327,329,162,119,202,173
23177,616,313,303,120,131,199,166
23180,441,220,221,102,104,138,97
23181,5426,2600,2826,1477,1225,1548,1176
23185,46370,22260,24110,11180,11956,11592,11642
23187,267,134,133,244,23,0,0
23188,38733,18528,20205,8987,8461,10760,10525
23192,7067,3531,3536,1921,1222,2536,1388
23219,3781,2078,1703,734,1838,815,394
23220,35545,17266,18279,8087,18682,5260,3516
23221,13680,6665,7015,1823,6452,3240,2165
23222,24563,11325,13238,6723,5911,7127,4802
23223,47677,22238,25439,12874,14917,12739,7147
23224,33461,16147,17314,9883,10823,8508,4247
23225,39169,18234,20935,8628,13070,10485,6986
23226,15805,7505,8300,3381,5200,3883,3341
23227,24440,10889,13551,5076,6174,6979,6211
23228,34198,16396,17802,7657,11681,8803,6057
23229,32283,15397,16886,8496,7170,9288,7329
23230,5852,2824,3028,1008,1973,1479,1392
23231,34685,16087,18598,9789,8974,10609,5313
23233,28908,13845,15063,8166,7074,9559,4109
23234,42989,20816,22173,12701,12770,11266,6252
23235,30165,14233,15932,7189,6781,8961,7234
23236,25822,12433,13389,6464,6052,7990,5316
23237,21192,10321,10871,5997,5842,6138,3215
23238,25134,11381,13753,5807,5689,7169,6469
23250,0,0,0,0,0,0,0
23294,17558,8548,9010,3938,7570,3688,2362
23301,1831,989,842,495,533,447,356
23302,155,73,82,37,35,50,33
23303,741,369,372,159,140,238,204
23304,71,38,33,13,7,29,22
23306,1088,524,564,270,180,341,297
23307,769,361,408,225,167,218,159
23308,2106,1066,1040,582,480,617,427
23310,4736,2243,2493,1095,953,1366,1322
23313,78,37,41,17,10,21,30
23314,6991,3460,3531,1747,1561,2348,1335
23315,1525,749,776,371,327,513,314
23316,342,151,191,94,56,97,95
23320,51797,24573,27224,13266,15592,14956,7983
23321,33653,15947,17706,9964,7634,10261,5794
23322,60473,31048,29425,17799,12905,21211,8558
23323,35906,17529,18377,10892,8972,11031,5011
23324,22851,10458,12393,7102,6510,5562,3677
23325,17592,8522,9070,4668,5045,4671,3208
23336,2941,1453,1488,509,500,845,1087
23337,377,185,192,86,86,112,93
23347,671,398,273,114,212,196,149
23350,3403,1620,1783,739,673,954,1037
23354,207,97,110,41,37,54,75
23356,1246,602,644,209,272,348,417
23357,776,398,378,241,248,181,106
23358,152,71,81,28,16,37,71
23359,776,386,390,212,171,239,154
23389,137,59,78,22,19,29,67
23395,645,308,337,112,90,199,244
23398,153,72,81,16,15,44,78
23401,212,100,112,49,35,74,54
23405,973,478,495,171,130,295,377
23407,411,200,211,133,110,108,60
23408,77,36,41,14,14,22,27
23409,84,43,41,19,17,23,25
23410,2015,949,1066,516,422,574,503
23413,840,362,478,148,111,221,360
23414,100,47,53,16,21,39,24
23415,1893,928,965,505,455,590,343
23416,356,174,182,86,82,111,77
23417,4047,1900,2147,790,700,1219,1338
23418,863,420,443,182,174,282,225
23420,2376,1125,1251,613,535,755,473
23421,4255,2045,2210,1081,1005,1172,997
23422,278,137,141,78,45,76,79
23423,344,158,186,54,55,82,153
23426,225,100,125,54,40,61,70
23427,243,117,126,37,29,80,97
23430,17281,8347,8934,4380,3142,5891,3868
23432,1538,753,785,344,262,524,408
23433,1218,606,612,230,174,408,406
23434,47670,22800,24870,13657,11940,13843,8230
23435,27053,12932,14121,8271,7026,8139,3617
23436,942,464,478,222,186,315,219
23437,4283,2107,2176,1009,872,1477,925
23438,1818,900,918,461,384,610,363
23440,727,372,355,148,132,228,219
23441,171,78,93,45,39,43,44
23442,1059,520,539,245,261,337,216
23451,41544,20577,20967,8756,13005,11370,8413
23452,59321,28738,30583,15604,17592,16165,9960
23453,35960,17597,18363,11587,11207,9804,3362
23454,60283,29258,31025,16443,17612,17121,9107
23455,47938,24125,23813,11024,15220,12396,9298
23456,51748,25929,25819,15532,12301,17203,6712
23457,4289,2140,2149,1030,824,1599,836
23459,1091,563,528,508,504,67,12
23460,1201,1001,200,269,882,50,0
23461,287,231,56,67,207,13,0
23462,61973,29433,32540,16630,22043,14714,8586
23464,72359,34849,37510,19613,20380,20495,11871
23480,328,162,166,42,40,104,142
23486,140,74,66,31,34,36,39
23487,6298,3088,3210,1605,1327,2056,1310
23488,201,93,108,52,47,63,39
23502,20678,9844,10834,5093,5996,5635,3954
23503,30856,15425,15431,7651,11024,8166,4015
23504,23483,10346,13137,8546,6673,5262,3002
23505,28503,13982,14521,7580,10778,6303,3842
23507,25818,19604,6214,2176,20073,2441,1128
23508,20263,10212,10051,6256,8209,3755,2043
23509,12817,6190,6627,3284,3389,3747,2397
23510,7031,3852,3179,1250,2925,1675,1181
23511,2457,1832,625,483,1837,134,3
23513,29595,14189,15406,8206,9081,8087,4221
23517,4484,2298,2186,846,1930,1043,665
23518,28095,13876,14219,6878,8554,7707,4956
23523,7793,3398,4395,3012,1935,1781,1065
23551,930,749,181,93,835,2,0
23601,25127,12063,13064,6162,7185,7086,4694
23602,39676,18871,20805,10486,11960,10625,6605
23603,3899,2043,1856,1313,1545,758,283
23604,5720,3757,1963,2168,3216,320,16
23605,13854,6641,7213,3356,4424,3865,2209
23606,29283,14152,15131,7429,10239,6832,4783
23607,24519,11564,12955,7827,6441,6403,3848
23608,42917,20315,22602,12892,13735,11053,5237
23651,696,360,336,222,250,170,54
23661,14113,6830,7283,3540,3397,4139,3037
23662,12150,5997,6153,3294,2214,3919,2723
23663,14495,6972,7523,4337,4028,3901,2229
23664,10194,4987,5207,2381,2397,3310,2106
23665,5120,2799,2321,2134,2458,509,19
23666,49825,23720,26105,12307,14994,13825,8699
23669,43148,20280,22868,12159,12035,11529,7425
23690,3032,1497,1535,892,978,720,442
23691,127,65,62,62,42,21,2
23692,18846,9099,9747,4757,3484,6031,4574
23693,23292,11463,11829,6992,4679,8462,3159
23696,3669,1783,1886,969,588,1241,871
23701,25161,12326,12835,5599,6805,6919,5838
23702,11424,5478,5946,3374,3616,2996,1438
23703,25739,12272,13467,6948,7468,6845,4478
23704,18716,8956,9760,5283,5180,4901,3352
23707,14236,6688,7548,4002,4072,3743,2419
23708,181,148,33,34,145,2,0
23709,78,65,13,4,72,2,0
23801,3393,1672,1721,1676,1425,267,25
23803,40542,19266,21276,10440,10767,11951,7384
23805,19490,9099,10391,4524,4910,5729,4327
23806,2251,837,1414,1482,769,0,0
23821,1597,752,845,370,360,487,380
23824,7214,3451,3763,1806,1601,2035,1772
23827,1443,711,732,354,276,465,348
23828,395,183,212,97,74,132,92
23829,2622,1854,768,327,507,1295,493
23830,1491,723,768,354,313,487,337
23831,33079,15962,17117,9590,8210,10043,5236
23832,33739,16294,17445,10181,8596,10504,4458
23833,2297,1134,1163,559,499,731,508
23834,25612,12026,13586,6874,5938,7111,5689
23836,11444,5662,5782,3238,2586,3832,1788
23837,4298,2098,2200,1075,897,1332,994
23838,15341,7646,7695,4233,2580,5873,2655
23839,741,355,386,181,162,230,168
23840,1858,897,961,488,419,583,368
23841,3479,1732,1747,834,763,1066,816
23842,6906,3447,3459,1750,1407,2449,1300
23843,654,324,330,147,101,213,193
23844,788,360,428,223,144,241,180
23845,356,179,177,75,54,89,138
23846,933,465,468,247,175,292,219
23847,16962,9844,7118,3616,4789,5156,3401
23850,1051,510,541,234,216,371,230
23851,13715,6303,7412,3618,3023,3984,3090
23856,1033,476,557,245,217,327,244
23857,525,260,265,88,94,164,179
23860,31970,17101,14869,7614,9636,8942,5778
23866,2237,1111,1126,555,470,698,514
23867,2189,1003,1186,580,451,651,507
23868,7367,4273,3094,1621,2515,1878,1353
23872,2376,1199,1177,579,485,768,544
23874,1004,511,493,224,222,328,230
23875,10878,5250,5628,2964,2538,3408,1968
23876,456,235,221,90,103,151,112
23878,1118,549,569,281,234,355,248
23879,679,332,347,130,139,261,149
23881,2176,1095,1081,495,436,734,511
23882,2516,1216,1300,566,518,777,655
23883,2551,1254,1297,615,516,901,519
23884,93,80,13,0,51,35,7
23885,2807,1400,1407,685,549,939,634
23887,574,295,279,89,79,188,218
23888,2275,1115,1160,554,482,703,536
23889,581,283,298,145,120,170,146
23890,4249,2055,2194,1027,843,1354,1025
23891,2358,2357,1,24,1659,618,57
23893,454,222,232,126,90,126,112
23894,673,336,337,160,131,210,172
23897,595,311,284,116,106,202,171
23898,2223,1101,1122,499,440,799,485
23899,351,173,178,62,55,137,97
23901,16399,8310,8089,3761,5437,3804,3397
23909,2027,781,1246,1130,897,0,0
23915,1220,848,372,185,452,399,184
23917,3684,2209,1475,590,1039,1125,930
23919,2666,1311,1355,433,382,792,1059
23920,3489,1708,1781,839,750,1067,833
23921,1991,990,1001,444,411,577,559
23922,3785,2657,1128,515,1379,1211,680
23923,2592,1337,1255,685,543,714,650
23924,6232,2891,3341,1492,1293,1774,1673
23927,4381,2076,2305,790,664,1253,1674
23930,5690,2668,3022,1497,1229,1616,1348
23934,681,325,356,173,134,206,168
23936,8212,5095,3117,1539,2426,2710,1537
23937,1970,967,1003,503,385,592,490
23938,407,201,206,79,72,133,123
23942,1112,557,555,265,222,357,268
23943,225,184,41,36,150,24,15
23944,4261,2085,2176,1043,922,1194,1102
23947,4293,2041,2252,1069,867,1248,1109
23950,3348,1628,1720,849,749,1007,743
23952,217,107,110,53,38,64,62
23954,2017,967,1050,535,439,584,459
23958,3170,1564,1606,778,639,973,780
23959,1264,610,654,329,224,368,343
23960,1990,935,1055,540,413,601,436
23962,670,321,349,165,130,204,171
23963,587,288,299,192,118,160,117
23964,1138,559,579,290,215,342,291
23966,2337,1176,1161,571,535,715,516
23967,1118,552,566,264,231,338,285
23968,837,407,430,192,154,247,244
23970,8254,3806,4448,2045,1791,2254,2164
23974,5012,2983,2029,924,1373,1683,1032
23976,230,117,113,40,47,77,66
24011,219,109,110,21,118,61,19
24012,29015,13830,15185,6909,7919,7938,6249
24013,8684,4430,4254,2369,2588,2524,1203
24014,16570,7816,8754,3564,3763,4901,4342
24015,15255,7304,7951,3394,4700,4441,2720
24016,9047,4642,4405,1996,3071,2707,1273
24017,23392,10874,12518,6629,5735,6253,4775
24018,36432,17181,19251,8804,7206,11234,9188
24019,26502,12631,13871,6500,5909,8062,6031
24020,455,41,414,209,211,27,8
24053,2715,1365,1350,630,550,813,722
24054,6797,3304,3493,1691,1524,2092,1490
24055,13674,6745,6929,3190,2843,4032,3609
24058,324,140,184,76,66,105,77
24059,872,438,434,176,167,310,219
24060,53311,28695,24616,13670,26619,7482,5540
24064,4963,2468,2495,1182,935,1699,1147
24065,6141,3039,3102,1459,1200,2024,1458
24066,4883,2434,2449,1104,932,1638,1209
24067,2230,1123,1107,547,450,725,508
24069,1879,917,962,445,421,575,438
24070,1363,676,687,289,252,471,351
24072,1298,647,651,350,316,385,247
24073,29793,14450,15343,7477,8911,8080,5325
24076,972,505,467,228,228,259,257
24077,932,452,480,216,250,287,179
24078,7115,3305,3810,1791,1667,1890,1767
24079,1766,887,879,429,380,541,416
24082,419,191,228,102,90,146,81
24083,2587,1191,1396,592,321,762,912
24084,11304,5723,5581,2271,2784,3383,2866
24085,2182,1113,1069,492,395,722,573
24086,210,106,104,43,24,82,61
24087,3914,1983,1931,955,916,1265,778
24088,5408,2735,2673,1607,1491,1375,935
24089,2640,1258,1382,580,542,764,754
24090,4781,2361,2420,1076,914,1592,1199
24091,7215,3603,3612,1657,1471,2151,1936
24092,3063,1493,1570,788,705,918,652
24093,192,94,98,48,38,60,46
24095,4677,2338,2339,1126,972,1592,987
24101,6132,3053,3079,1316,1185,2060,1571
24102,1697,839,858,447,347,471,432
24104,3469,1720,1749,667,555,1062,1185
24105,500,256,244,135,111,132,122
24112,32646,15333,17313,7360,6741,9881,8664
24120,1860,931,929,318,325,526,691
24121,10501,5336,5165,2005,1792,3183,3521
24122,1683,833,850,375,354,561,393
24124,4352,2123,2229,1054,940,1196,1162
24127,4261,2098,2163,1000,838,1359,1064
24128,1872,917,955,399,395,622,456
24130,8,6,2,0,1,6,1
24131,140,75,65,31,24,44,41
24132,460,225,235,94,91,163,112
24133,2626,1279,1347,569,562,808,687
24134,5741,2800,2941,1443,1254,1624,1420
24136,3393,1721,1672,771,738,1100,784
24137,2582,1301,1281,479,422,826,855
24138,1613,821,792,385,327,558,343
24139,575,305,270,88,101,196,190
24141,20668,10073,10595,4183,8316,4535,3634
24142,2470,1038,1432,1652,818,0,0
24147,1201,552,649,274,260,277,390
24148,8013,3949,4064,1715,1638,2545,2115
24149,3339,1656,1683,828,725,1040,746
24150,693,346,347,153,128,247,165
24151,20000,9663,10337,5040,4458,5853,4649
24153,37761,18303,19458,8883,8959,10874,9045
24161,471,228,243,98,101,125,147
24162,2421,1213,1208,601,585,721,514
24165,1613,780,833,355,305,532,421
24167,345,167,178,97,86,102,60
24168,187,89,98,39,22,63,63
24171,8250,3999,4251,1685,1546,2438,2581
24174,2539,1266,1273,594,522,847,576
24175,8818,4441,4377,2204,1629,2956,2029
24176,1360,679,681,230,171,397,562
24179,18616,8936,9680,4509,4077,5515,4515
24184,4705,2325,2380,1063,959,1437,1246
24185,854,424,430,173,137,257,287
24201,17116,8050,9066,4074,4243,4551,4248
24202,12905,6423,6482,3031,2688,3987,3199
24210,16840,8259,8581,3401,4328,4849,4262
24211,9922,4873,5049,2118,2019,3121,2664
24216,2939,1429,1510,787,724,795,633
24217,406,193,213,71,70,137,128
24219,11265,5987,5278,2559,3180,3187,2339
24220,895,443,452,239,221,250,185
24221,938,475,463,215,194,271,258
24224,6734,3352,3382,1550,1555,2062,1567
24225,1697,864,833,380,361,490,466
24226,1433,711,722,340,325,446,322
24228,7016,3476,3540,1550,1577,2086,1803
24230,9597,4916,4681,2479,2451,2731,1936
24236,3085,1486,1599,640,619,942,884
24237,1192,591,601,295,249,347,301
24239,113,52,61,16,18,33,46
24243,2222,1151,1071,548,533,680,461
24244,5723,3000,2723,1157,1450,1656,1460
24245,1129,560,569,261,254,370,244
24246,455,212,243,142,123,119,71
24248,2596,1234,1362,603,531,796,666
24250,1319,663,656,306,264,419,330
24251,8773,4278,4495,1939,1862,2559,2413
24256,3491,1777,1714,793,834,1083,781
24258,1624,804,820,346,326,551,401
24260,5734,2861,2873,1326,1371,1778,1259
24263,7950,4571,3379,1587,2550,2235,1578
24265,930,481,449,233,218,291,188
24266,9521,4542,4979,2140,2286,2873,2222
24269,324,169,155,92,80,88,64
24270,582,279,303,130,110,211,131
24271,2689,1334,1355,580,564,814,731
24272,527,269,258,125,116,162,124
24273,6262,2930,3332,1546,1538,1837,1341
24277,5849,2904,2945,1356,1346,1695,1452
24279,5541,3122,2419,1198,1632,1636,1075
24280,823,405,418,169,165,269,220
24281,2487,1204,1283,592,584,680,631
24282,727,360,367,183,168,213,163
24283,2171,1076,1095,491,472,705,503
24290,1874,847,1027,386,376,493,619
24292,535,271,264,106,102,172,155
24293,10791,5384,5407,2690,2990,2956,2155
24301,14366,6947,7419,3331,3105,4265,3665
24311,1977,973,1004,472,463,585,457
24312,2401,1206,1195,561,526,713,601
24313,884,490,394,211,218,272,183
24314,1560,793,767,328,308,483,441
24315,3774,2225,1549,708,1014,1211,841
24316,50,23,27,12,8,21,9
24317,3858,1899,1959,913,870,1154,921
24318,639,329,310,151,133,162,193
24319,6979,3416,3563,1675,1552,2049,1703
24322,174,86,88,36,35,50,53
24323,644,310,334,130,160,208,146
24324,2013,1008,1005,432,379,654,548
24325,1039,517,522,192,170,308,369
24326,1058,530,528,183,146,338,391
24328,1726,865,861,334,287,532,573
24330,3401,1665,1736,750,726,990,935
24333,17996,8660,9336,4277,3965,5231,4523
24340,5657,2832,2825,1318,1272,1702,1365
24343,9267,4510,4757,2112,1855,2785,2515
24347,1931,998,933,446,402,611,472
24348,3958,1946,2012,793,776,1169,1220
24350,1261,667,594,298,287,384,292
24351,668,325,343,166,143,202,157
24352,890,420,470,180,152,243,315
24354,15315,7343,7972,3511,3515,4396,3893
24360,6169,3131,3038,1522,1445,1888,1314
24361,5431,2682,2749,1399,1365,1545,1122
24363,1365,678,687,291,235,414,425
24366,781,390,391,183,151,244,203
24368,4953,2463,2490,1255,1152,1453,1093
24370,6572,3274,3298,1560,1380,1962,1670
24374,787,387,400,190,166,235,196
24375,1611,810,801,395,357,471,388
24377,348,173,175,62,68,113,105
24378,1229,607,622,215,200,390,424
24380,2639,1338,1301,648,615,731,645
24381,3816,1911,1905,888,817,1120,991
24382,14366,6786,7580,3090,3129,4230,3917
24401,35499,16431,19068,8040,8246,9923,9290
24411,112,50,62,26,26,31,29
24412,131,63,68,25,24,42,40
24413,178,87,91,25,36,62,55
24415,41,19,22,9,7,13,12
24416,8807,4184,4623,2271,2175,2340,2021
24421,3868,1936,1932,916,760,1239,953
24422,6315,3009,3306,1478,1199,1784,1854
24426,14329,7050,7279,3379,2929,4249,3772
24430,2643,1884,759,392,969,891,391
24431,2656,1336,1320,650,541,899,566
24432,336,172,164,70,63,116,87
24433,99,47,52,19,21,31,28
24435,1925,968,957,396,353,630,546
24437,904,447,457,229,129,347,199
24439,1253,639,614,274,225,401,353
24440,2916,1609,1307,687,735,934,560
24441,6140,3006,3134,1719,1462,1857,1102
24442,120,64,56,23,16,38,43
24445,2673,1325,1348,526,530,826,791
24448,376,187,189,90,73,110,103
24450,16741,8625,8116,3848,4815,3828,4250
24457,270,143,127,56,50,83,81
24458,442,221,221,65,61,167,149
24459,818,428,390,171,132,288,227
24460,1530,785,745,320,274,486,450
24464,213,104,109,35,27,64,87
24465,1382,695,687,230,207,430,515
24467,2212,1109,1103,528,413,739,532
24471,1355,668,687,320,261,462,312
24472,2271,1134,1137,523,429,680,639
24473,922,464,458,174,147,289,312
24474,544,261,283,133,112,113,186
24476,280,144,136,59,62,95,64
24477,10573,5130,5443,2663,2341,3256,2313
24479,1537,770,767,345,272,514,406
24482,4872,2712,2160,1018,1423,1509,922
24483,587,282,305,123,108,192,164
24484,741,375,366,116,127,235,263
24485,389,199,190,88,62,143,96
24486,3490,1728,1762,1058,881,963,588
24487,320,170,150,66,70,93,91
24501,26757,12366,14391,7461,8722,5951,4623
24502,43426,20634,22792,11644,15419,8620,7743
24503,19331,9073,10258,4833,4005,5569,4924
24504,9777,4949,4828,2382,2543,2845,2007
24517,5693,2632,3061,1362,1171,1585,1575
24520,2450,1237,1213,615,483,731,621
24521,10576,5129,5447,2571,2132,3203,2670
24522,9213,4410,4803,2245,2033,2632,2303
24523,18952,9095,9857,4407,3898,5633,5014
24526,1593,805,788,370,319,500,404
24527,3027,1436,1591,745,674,961,647
24528,3200,1519,1681,789,592,1006,813
24529,1724,838,886,393,314,480,537
24530,1088,533,555,248,235,347,258
24531,9203,4818,4385,1858,2039,2854,2452
24534,1740,840,900,393,324,515,508
24536,194,91,103,43,39,62,50
24538,4742,2382,2360,1195,1131,1435,981
24539,134,70,64,20,17,55,42
24540,32170,14929,17241,7947,7003,9163,8057
24541,28221,13193,15028,6831,6324,8090,6976
24549,4292,2150,2142,1117,993,1314,868
24550,7258,3565,3693,1884,1656,2261,1457
24551,20667,10160,10507,5807,4042,6731,4087
24553,1902,925,977,474,420,543,465
24554,3995,1917,2078,1006,837,1204,948
24555,2140,1037,1103,475,473,617,575
24556,3053,1521,1532,777,541,1065,670
24557,7977,3808,4169,1730,1462,2512,2273
24558,6347,3063,3284,1420,1246,1899,1782
24562,426,223,203,106,85,138,97
24563,5489,2630,2859,1281,1150,1634,1424
24565,1026,473,553,216,181,347,282
24566,1402,684,718,373,274,452,303
24569,1064,516,548,252,204,339,269
24570,20,9,11,5,1,6,8
24571,1979,980,999,437,356,655,531
24572,16395,7884,8511,4017,3759,4887,3732
24574,3977,1999,1978,1020,919,1174,864
24577,5239,2554,2685,1277,998,1588,1376
24578,1056,530,526,198,182,359,317
24579,1389,687,702,321,283,409,376
24580,613,309,304,147,125,194,147
24581,23,7,16,4,3,4,12
24586,5562,2686,2876,1380,1233,1742,1207
24588,9647,4823,4824,2489,2340,2954,1864
24589,2271,1119,1152,588,443,692,548
24590,8074,3938,4136,2075,1848,2532,1619
24592,13934,6373,7561,3561,2905,3727,3741
24593,1963,989,974,501,452,569,441
24594,1651,800,851,396,319,549,387
24595,679,57,622,212,394,50,23
24597,1257,599,658,312,227,402,316
24598,1984,1003,981,427,386,605,566
24599,606,302,304,143,116,200,147
24601,77,38,39,17,17,22,21
24602,962,460,502,236,216,260,250
24603,978,485,493,194,226,327,231
24604,262,124,138,63,59,71,69
24605,9301,4403,4898,2262,2070,2536,2433
24606,170,77,93,37,42,40,51
24607,462,231,231,131,89,133,109
24609,7630,3749,3881,1709,1652,2408,1861
24612,229,111,118,44,41,74,70
24613,911,451,460,220,225,268,198
24614,8061,3955,4106,1839,1900,2444,1878
24620,2774,1383,1391,627,626,925,596
24622,1028,493,535,210,236,337,245
24628,295,142,153,61,53,102,79
24630,6774,3330,3444,1605,1493,2057,1619
24631,2843,1842,1001,394,938,954,557
24634,574,277,297,135,124,191,124
24635,1650,1320,330,152,761,526,211
24637,3410,1668,1742,782,787,1097,744
24639,3533,1744,1789,843,794,1078,818
24641,5953,2810,3143,1375,1469,1716,1393
24646,750,375,375,154,170,257,169
24649,2760,1351,1409,625,587,893,655
24651,6314,3033,3281,1399,1288,1876,1751
24656,3404,1689,1715,685,748,1131,840
24657,321,164,157,54,65,107,95
98001,31911,16047,15864,9108,7838,10416,4549
98002,31647,15564,16083,8731,9196,8281,5439
98003,44151,21343,22808,12149,12933,11673,7396
98004,27946,13894,14052,5699,8441,7692,6114
98005,17714,8930,8784,3839,5491,4950,3434
98006,36364,17995,18369,9933,6833,12647,6951
98007,24889,12826,12063,5587,10353,5245,3704
98008,24411,12131,12280,5747,5996,7247,5421
98010,5025,2512,2513,1426,1027,1800,772
98011,29212,14181,15031,7191,8537,8541,4943
98012,51136,25196,25940,13997,15060,15063,7016
98014,6765,3447,3318,1864,1393,2625,883
98019,10725,5400,5325,3451,2507,3690,1077
98020,18304,8533,9771,3649,2968,5681,6006
98021,26722,13191,13531,7074,7114,8232,4302
98022,20987,10416,10571,5466,4462,6810,4249
98023,47510,23538,23972,13801,12708,14102,6899
98024,5650,2876,2774,1516,1019,2173,942
98026,35921,17417,18504,8398,8278,11975,7270
98027,26141,12785,13356,6372,6246,8783,4740
98028,20419,10120,10299,5096,5251,6436,3636
98029,24348,11691,12657,7119,7361,6531,3337
98030,33769,16832,16937,10277,10296,8915,4281
98031,36581,18133,18448,10945,9958,10704,4974
98032,33853,17190,16663,8939,11742,8779,4393
98033,34338,16777,17561,7526,10111,10720,5981
98034,40407,20017,20390,8980,13504,11613,6310
98036,36000,17839,18161,9333,10352,10696,5619
98037,26889,13148,13741,6825,7676,7765,4623
98038,31171,15574,15597,9933,7309,9983,3946
98039,2971,1468,1503,924,310,992,745
98040,22699,11046,11653,6007,3450,7338,5904
98042,43673,21802,21871,12709,10385,14236,6343
98043,19943,9742,10201,4787,6168,5918,3070
98045,13888,6993,6895,3946,3032,5132,1778
98047,6339,3172,3167,2012,1834,1810,683
98050,322,174,148,87,45,128,62
98051,3270,1683,1587,828,635,1318,489
98052,58442,29710,28732,14416,20807,15143,8076
98053,18784,9229,9555,5123,3814,6053,3794
98055,21904,10671,11233,5246,7246,5911,3501
98056,32489,16132,16357,7905,10546,9331,4707
98057,10613,5327,5286,2131,3574,2914,1994
98058,41938,20786,21152,11420,10916,12926,6676
98059,34463,17187,17276,9561,9204,10670,5028
98065,12699,6406,6293,4425,3635,3543,1096
98068,403,222,181,63,142,152,46
98070,10624,5150,5474,2229,1396,4041,2958
98072,22312,11115,11197,5992,4872,7729,3719
98074,25748,12958,12790,8602,5498,9076,2572
98075,20715,10320,10395,7301,3878,7433,2103
98077,13585,6928,6657,4093,1960,5538,1994
98087,29976,15050,14926,7732,10968,7859,3417
98092,39816,19756,20060,11967,10514,11797,5538
98101,10238,5681,4557,436,4358,2884,2560
98102,20756,11131,9625,1325,12141,4844,2446
98103,45911,22667,23244,6513,21877,11971,5550
98104,13095,8042,5053,1077,5291,3825,2902
98105,43924,22194,21730,10916,22691,6467,3850
98106,22873,11288,11585,5629,8123,6381,2740
98107,21147,10422,10725,2727,9849,5729,2842
98108,22374,11495,10879,5578,6810,6128,3858
98109,20715,10450,10265,1791,10896,4983,3045
98110,23025,11127,11898,5874,2902,8280,5969
98112,21077,10309,10768,3823,6939,6174,4141
98115,46206,22428,23778,9332,15745,13307,7822
98116,22241,10640,11601,3921,6357,7444,4519
98117,31365,15358,16007,6408,9477,10602,4878
98118,42731,20793,21938,10998,11801,12412,7520
98119,21039,10030,11009,3356,9458,5271,2954
98121,12628,7047,5581,631,6891,3429,1677
98122,31454,16432,15022,5193,15376,7333,3552
98125,37081,18184,18897,7000,12849,10337,6895
98126,20698,9827,10871,4620,6564,6132,3382
98133,44555,21613,22942,8468,14350,12411,9326
98134,644,431,213,34,241,279,90
98136,14770,7003,7767,2758,3812,5216,2984
98144,26881,13573,13308,5273,9043,7623,4942
98146,25922,13002,12920,6680,6995,7879,4368
98148,10010,5048,4962,2511,2932,2842,1725
98154,0,0,0,0,0,0,0
98155,32778,16206,16572,7267,8283,10795,6433
98158,0,0,0,0,0,0,0
98164,141,76,65,2,67,53,19
98166,20301,10101,10200,4717,4562,6490,4532
98168,33734,17470,16264,9337,10436,9247,4714
98174,0,0,0,0,0,0,0
98177,19030,9100,9930,4198,3249,6532,5051
98178,24092,11857,12235,6334,6434,7025,4299
98188,23111,11866,11245,5684,7417,6446,3564
98195,0,0,0,0,0,0,0
98198,34584,17232,17352,8586,9950,9709,6339
98199,19686,9607,10079,3851,5362,6353,4120
98201,29582,15590,13992,6509,9545,8673,4855
98203,34354,16970,17384,8833,9560,10228,5733
98204,39380,19759,19621,11032,14789,9160,4399
98205,12283,6203,6080,3774,3543,3573,1393
98207,758,627,131,64,675,19,0
98208,51802,25675,26127,14969,14507,15160,7166
98220,634,321,313,129,135,230,140
98221,20429,9923,10506,4111,3862,5818,6638
98222,33,19,14,3,0,10,20
98223,40815,20516,20299,11366,9540,12928,6981
98224,294,156,138,39,58,120,77
98225,46172,22700,23472,9815,19374,9634,7349
98226,41235,20303,20932,10256,11103,11249,8627
98229,30321,15060,15261,7053,8530,8580,6158
98230,15710,7844,7866,3796,3252,4681,3981
98232,3920,2039,1881,874,698,1325,1023
98233,14871,7316,7555,4448,3859,3653,2911
98235,103,49,54,23,29,35,16
98236,5635,2770,2865,1106,838,1897,1794
98237,4025,2084,1941,938,768,1331,988
98238,85,42,43,26,25,24,10
98239,6646,3135,3511,1178,1083,1874,2511
98240,3061,1536,1525,820,597,1006,638
98241,2129,1107,1022,538,449,673,469
98243,507,252,255,36,79,168,224
98244,3001,1584,1417,753,730,922,596
98245,3651,1731,1920,693,625,1253,1080
98247,9072,4537,4535,2816,2275,2553,1428
98248,22361,11140,11221,6626,5220,6486,4029
98249,4561,2160,2401,770,562,1430,1799
98250,7664,3733,3931,1433,1293,2437,2501
98251,4567,2403,2164,1204,1122,1593,648
98252,8777,4546,4231,2505,2164,2958,1150
98253,1837,912,925,211,184,620,822
98255,245,121,124,74,51,77,43
98256,420,213,207,70,73,175,102
98257,4134,1969,2165,777,636,1101,1620
98258,30524,15369,15155,9555,8119,9357,3493
98260,5278,2452,2826,907,646,1843,1882
98261,2383,1180,1203,339,314,722,1008
98262,964,482,482,144,119,334,367
98263,76,40,36,13,17,25,21
98264,18893,9142,9751,5602,4341,4854,4096
98266,3642,1897,1745,1138,940,1090,474
98267,534,284,250,95,102,219,118
98270,45899,22575,23324,14121,12645,12717,6416
98271,27184,13769,13415,7512,6907,8075,4690
98272,27942,15139,12803,7901,8002,8525,3514
98273,28717,14357,14360,8727,7977,7089,4924
98274,16613,8158,8455,4399,3761,4635,3818
98275,20256,10163,10093,5210,4346,7243,3457
98276,450,227,223,168,142,98,42
98277,37823,18777,19046,10442,11817,8791,6773
98278,1065,880,185,145,909,10,1
98279,608,287,321,76,98,192,242
98280,480,241,239,65,39,154,222
98281,1314,662,652,213,151,488,462
98282,15661,7771,7890,3254,2315,5134,4958
98283,434,218,216,69,95,161,109
98284,24331,12213,12118,6560,6124,7063,4584
98286,240,115,125,44,21,65,110
98288,333,191,142,49,75,115,94
98290,32714,16537,16177,8788,6925,11510,5491
98292,20987,10399,10588,5435,4337,6895,4320
98294,6595,3409,3186,2068,1763,1908,856
98295,2409,1220,1189,734,638,675,362
98296,27956,14092,13864,8628,6043,9831,3454
98297,106,56,50,14,18,29,45
98303,1037,512,525,161,109,333,434
98304,759,397,362,135,136,306,182
98305,358,187,171,67,68,122,101
98310,18703,9099,9604,4219,5235,4897,4352
98311,25880,12880,13000,7018,6614,7354,4894
98312,30203,15419,14784,7550,8920,8575,5158
98314,3329,2726,603,307,2801,211,10
98315,6054,4033,2021,1957,3895,190,12
98320,1250,640,610,153,144,395,558
98321,15152,7608,7544,4287,3442,5037,2386
98323,702,364,338,215,174,210,103
98325,1848,941,907,412,359,643,434
98326,1412,1167,245,131,736,387,158
98327,8267,3907,4360,2865,2642,1930,830
98328,10433,5284,5149,2807,2137,3465,2024
98329,10545,5305,5240,2804,2360,3443,1938
98330,149,76,73,27,22,60,40
98331,6261,3397,2864,1772,1748,1700,1041
98332,15855,7324,8531,3642,2965,5281,3967
98333,3633,1831,1802,939,508,1301,885
98335,24925,12000,12925,6436,4415,8062,6012
98336,970,510,460,190,182,316,282
98337,6697,3558,3139,1498,2509,1900,790
98338,24098,12167,11931,6693,5498,7894,4013
98339,3326,1661,1665,710,707,1005,904
98340,2537,1238,1299,461,337,838,901
98342,1370,649,721,299,222,502,347
98345,554,281,273,123,139,175,117
98346,9297,4678,4619,2456,1808,3053,1980
98349,4614,2258,2356,1120,953,1512,1029
98350,460,248,212,161,132,119,48
98351,1115,562,553,212,153,372,378
98353,4,2,2,0,0,0,4
98354,6976,3330,3646,1809,2004,1997,1166
98355,628,320,308,97,95,234,202
98356,2149,1063,1086,466,404,624,655
98357,1414,724,690,501,362,358,193
98358,897,477,420,90,89,274,444
98359,4887,2513,2374,1188,975,1726,998
98360,12221,6251,5970,3760,3165,3475,1821
98361,1158,614,544,137,112,423,486
98362,22230,10921,11309,4616,4650,6519,6445
98363,13343,6715,6628,3146,2926,4044,3227
98364,45,24,21,16,13,12,4
98365,4528,2237,2291,505,432,1104,2487
98366,34258,17126,17132,8850,9108,9359,6941
98367,27693,14066,13627,7216,5938,9289,5250
98368,14724,6984,7740,2473,2224,4518,5509
98370,29528,14261,15267,7512,5966,9326,6724
98371,20468,9998,10470,5036,4768,6276,4388
98372,22475,10998,11477,5651,5770,6884,4170
98373,22246,10899,11347,6327,6904,6138,2877
98374,37360,18237,19123,11422,9479,10798,5661
98375,26863,13441,13422,9365,8145,6872,2481
98376,1998,1044,954,373,302,695,628
98377,1922,981,941,336,307,662,617
98380,4173,2156,2017,988,706,1499,980
98381,371,194,177,69,46,141,115
98382,26856,12690,14166,4314,3765,6669,12108
98383,19727,9767,9960,4862,5415,5676,3774
98385,459,237,222,126,101,163,69
98387,43173,21432,21741,13922,11891,11943,5417
98388,7508,4335,3173,1402,2334,2223,1549
98390,10461,5066,5395,2795,2686,2869,2111
98391,44309,22499,21810,13425,11293,14429,5162
98392,2994,1463,1531,756,764,934,540
98394,1107,552,555,250,198,373,286
98396,662,340,322,210,156,201,95
98402,6356,3872,2484,567,3055,1800,934
98403,7713,3686,4027,1408,2634,2308,1363
98404,32086,15894,16192,10440,9273,8055,4318
98405,22851,11225,11626,5772,7588,6096,3395
98406,21610,10125,11485,4488,6125,6163,4834
98407,19885,9515,10370,4335,4809,6070,4671
98408,18830,9306,9524,4902,5486,5209,3233
98409,22989,11262,11727,6698,8073,5653,2565
98416,1014,418,596,680,327,3,4
98418,10069,5056,5013,2738,3108,2864,1359
98421,1308,1202,106,63,974,255,16
98422,20151,9910,10241,5553,4605,6705,3288
98424,10140,5103,5037,2881,3738,2519,1002
98430,13,7,6,2,2,2,7
98433,14584,7890,6694,6283,7356,887,58
98438,366,304,62,63,297,6,0
98439,4839,2446,2393,1875,1973,772,219
98443,5371,2666,2705,1177,1137,1787,1270
98444,33956,16627,17329,9884,11511,8033,4528
98445,29661,14428,15233,8488,8359,8063,4751
98446,10173,5031,5142,2648,2582,3043,1900
98447,842,398,444,430,411,1,0
98465,6340,3117,3223,1267,1690,1837,1546
98466,26944,12569,14375,7007,6942,7434,5561
98467,14728,6958,7770,3958,3815,4255,2700
98498,27546,13487,14059,6301,6867,7954,6424
98499,29750,14506,15244,7948,9123,7555,5124
98501,38133,18389,19744,9662,9567,11633,7271
98502,30491,14869,15622,6958,8953,8562,6018
98503,36611,17433,19178,9492,10544,8869,7706
98506,18199,8630,9569,3797,4634,5500,4268
98512,28130,14038,14092,6661,7179,8890,5400
98513,31975,15754,16221,9017,8860,8844,5254
98516,20166,9782,10384,5174,5104,5595,4293
98520,23814,12889,10925,5857,6688,6643,4626
98524,3232,1618,1614,602,507,919,1204
98526,398,216,182,108,105,118,67
98527,324,161,163,70,50,93,111
98528,9983,4976,5007,2525,2253,3106,2099
98530,565,289,276,128,150,184,103
98531,24121,11944,12177,6761,6188,5930,5242
98532,23596,11839,11757,6532,5461,6440,5163
98533,609,294,315,134,88,204,183
98535,445,233,212,83,75,145,142
98536,211,106,105,38,40,63,70
98537,2129,1064,1065,545,441,629,514
98538,304,165,139,73,64,89,78
98541,10101,5118,4983,2699,2346,2998,2058
98542,656,328,328,163,130,200,163
98544,73,35,38,26,19,17,11
98546,2909,1497,1412,552,473,895,989
98547,1436,725,711,200,186,491,559
98548,2193,1130,1063,273,249,635,1036
98550,11382,5632,5750,2990,2697,3159,2536
98552,508,273,235,141,112,153,102
98555,599,303,296,49,52,188,310
98557,3225,1598,1627,825,751,927,722
98558,192,89,103,37,39,46,70
98559,93,53,40,37,16,26,14
98560,142,73,69,38,29,46,29
98562,195,109,86,23,22,90,60
98563,8001,3996,4005,1927,1660,2446,1968
98564,2459,1269,1190,605,454,713,687
98565,618,301,317,194,195,135,94
98568,2519,1257,1262,651,544,753,571
98569,5784,2800,2984,824,773,1662,2525
98570,3889,1974,1915,978,775,1169,967
98571,483,249,234,109,88,154,132
98572,797,394,403,219,177,207,194
98575,228,123,105,44,46,82,56
98576,4667,2307,2360,1187,1018,1570,892
98577,6338,3198,3140,1560,1272,1832,1674
98579,12870,6477,6393,3551,2980,3889,2450
98580,11099,5633,5466,2897,2386,3836,1980
98581,424,192,232,14,13,43,354
98582,611,306,305,149,121,189,152
98583,124,64,60,37,34,37,16
98584,36630,19202,17428,8879,9032,10267,8452
98585,655,346,309,123,115,197,220
98586,1944,981,963,468,379,530,567
98587,942,499,443,344,267,201,130
98588,1829,975,854,334,345,650,500
98589,7320,3647,3673,1817,1593,2472,1438
98590,356,179,177,59,55,102,140
98591,3952,1964,1988,975,764,1178,1035
98592,1764,876,888,265,238,531,730
98593,1113,584,529,285,212,340,276
98595,2917,1477,1440,624,570,859,864
98596,6524,3307,3217,1715,1291,1881,1637
98597,21557,10436,11121,6668,5661,5912,3316
98601,2982,1512,1470,952,579,929,522
98602,200,108,92,40,24,77,59
98603,1017,543,474,263,182,353,219
98604,34232,17007,17225,11588,7921,9417,5306
98605,1225,651,574,323,315,392,195
98606,9027,4524,4503,2813,1464,3023,1727
98607,27899,13907,13992,9070,5851,8923,4055
98610,2871,1412,1459,729,633,930,579
98611,9133,4608,4525,2217,1827,2814,2275
98612,2704,1352,1352,517,393,772,1022
98613,400,210,190,90,74,137,99
98614,353,189,164,62,53,107,131
98616,150,81,69,20,24,56,50
98617,1042,527,515,258,194,333,257
98619,457,234,223,96,79,148,134
98620,7123,3541,3582,1663,1250,2086,2124
98621,276,139,137,55,41,78,102
98624,1532,790,742,264,296,480,492
98625,6133,3107,3026,1529,1187,1995,1422
98626,24523,12156,12367,7039,5898,6954,4632
98628,385,198,187,100,86,113,86
98629,8364,4213,4151,2489,1630,2802,1443
98631,3243,1539,1704,508,542,972,1221
98632,49205,23878,25327,12878,11617,13269,11441
98635,1735,886,849,312,281,597,545
98638,1525,833,692,431,268,422,404
98639,847,417,430,220,172,259,196
98640,4380,2155,2225,574,530,1184,2092
98641,5,2,3,0,0,2,3
98642,15696,7759,7937,4377,3166,4895,3258
98643,362,186,176,63,55,116,128
98644,473,229,244,89,81,151,152
98645,1429,721,708,372,263,451,343
98647,404,195,209,114,65,126,99
98648,3100,1544,1556,736,617,1025,722
98649,895,461,434,234,177,293,191
98650,959,499,460,235,200,275,249
98651,939,472,467,221,187,307,224
98660,11858,6083,5775,2623,4112,3217,1906
98661,41740,20595,21145,11308,12960,10635,6837
98662,31644,15311,16333,9086,8724,8150,5684
98663,14115,7012,7103,3325,4144,3983,2663
98664,21771,10506,11265,5147,5941,5921,4762
98665,24057,11834,12223,6478,6424,6459,4696
98670,113,61,52,19,21,45,28
98671,21220,10677,10543,5917,5028,6596,3679
98672,6146,3065,3081,1548,1363,1839,1396
98673,404,208,196,102,72,123,107
98674,12029,6109,5920,3589,2785,3372,2283
98675,6713,3561,3152,2592,1543,1694,884
98682,52893,26308,26585,17319,14955,14212,6407
98683,30832,14768,16064,7856,7741,8286,6949
98684,26968,13141,13827,8069,7503,7342,4054
98685,26217,12783,13434,7735,5300,8397,4785
98686,17385,8591,8794,4699,4035,5325,3326
98801,40977,20198,20779,11798,10189,10705,8285
98802,28719,14113,14606,8338,7010,7589,5782
98811,71,39,32,22,14,20,15
98812,4899,2523,2376,1729,1215,1152,803
98813,3176,1648,1528,1258,859,660,399
98814,466,225,241,52,56,178,180
98815,7233,3606,3627,2059,1620,2059,1495
98816,6394,3297,3097,1650,1321,1875,1548
98817,366,192,174,125,97,90,54
98819,258,132,126,30,32,89,107
98821,519,268,251,145,132,157,85
98822,1953,1002,951,496,399,625,433
98823,11055,5569,5486,3460,2614,2892,2089
98824,181,97,84,69,56,42,14
98826,6504,3254,3250,1338,1191,2013,1962
98827,312,172,140,65,58,87,102
98828,2146,1101,1045,634,448,663,401
98829,564,299,265,134,121,173,136
98830,494,248,246,112,84,150,148
98831,3708,1857,1851,1091,777,1031,809
98832,320,169,151,51,108,96,65
98833,150,82,68,27,17,66,40
98834,239,120,119,32,34,95,78
98836,584,304,280,167,145,186,86
98837,39722,19924,19798,12980,10315,9689,6738
98840,4851,2464,2387,1272,1115,1361,1103
98841,9197,4478,4719,2568,2090,2366,2173
98843,1817,1000,817,607,441,529,240
98844,4740,2428,2312,1130,866,1446,1298
98845,128,65,63,29,20,40,39
98846,1173,610,563,336,265,340,232
98847,1920,976,944,505,404,614,397
98848,11518,5951,5567,4193,3070,2525,1730
98849,1078,556,522,218,200,342,318
98850,1543,807,736,516,351,384,292
98851,4014,2022,1992,952,717,1108,1237
98852,104,51,53,31,18,33,22
98853,23,11,12,3,3,5,12
98855,5863,2983,2880,1418,1053,1699,1693
98856,2464,1220,1244,466,472,787,739
98857,4082,2011,2071,1555,1008,955,564
98858,1521,774,747,369,294,459,399
98859,238,124,114,42,53,77,66
98860,259,121,138,61,42,68,88
98862,2218,1123,1095,395,347,795,681
98901,30169,15731,14438,9995,8269,7434,4471
98902,46322,22405,23917,14992,13350,10356,7624
98903,14517,7304,7213,4045,3350,3920,3202
98908,35240,17021,18219,9318,7789,9665,8468
98921,516,267,249,258,182,66,10
98922,5468,2854,2614,1116,940,1813,1599
98923,1434,735,699,497,344,380,213
98925,689,362,327,135,124,269,161
98926,30239,15249,14990,7766,11462,6256,4755
98929,0,0,0,0,0,0,0
98930,15252,7665,7587,5954,4139,3283,1876
98932,5032,2586,2446,2177,1343,1031,481
98933,1267,626,641,458,325,311,173
98934,1117,554,563,347,321,253,196
98935,4190,2119,2071,1714,1107,868,501
98936,5872,2963,2909,2042,1643,1382,805
98937,4112,2079,2033,1000,797,1350,965
98938,2177,1107,1070,901,551,463,262
98939,167,85,82,55,41,44,27
98940,760,411,349,147,132,260,221
98941,919,483,436,180,232,306,201
98942,16973,8408,8565,5039,3956,4943,3035
98943,660,321,339,158,154,199,149
98944,22014,11169,10845,8795,6118,4388,2713
98946,495,255,240,116,99,145,135
98947,2902,1457,1445,1007,715,763,417
98948,13225,6767,6458,5219,3625,2830,1551
98950,177,92,85,69,30,53,25
98951,13739,7023,6716,5303,3758,3017,1661
98952,2330,1208,1122,940,588,548,254
98953,6681,3418,3263,2283,1610,1694,1094
99001,6151,4161,1990,1187,2524,1886,554
99003,4848,2498,2350,1195,803,1727,1123
99004,18376,9076,9300,5101,6753,3876,2646
99005,8574,4201,4373,2727,1454,2955,1438
99006,11946,5999,5947,3381,2223,3640,2702
99008,641,346,295,170,123,235,113
99009,3947,2039,1908,1044,764,1349,790
99011,2776,1549,1227,1093,1518,162,3
99012,1064,555,509,296,242,259,267
99013,1785,920,865,618,415,478,274
99016,12480,6053,6427,3561,3021,3504,2394
99017,161,88,73,40,24,55,42
99018,282,128,154,72,60,87,63
99019,9502,4614,4888,2941,2115,2724,1722
99020,82,41,41,17,21,28,16
99021,9174,4518,4656,2611,1610,3121,1832
99022,8820,4457,4363,2280,2103,2858,1579
99023,529,267,262,170,69,207,83
99025,5232,2671,2561,1500,962,1961,809
99026,9042,4551,4491,2525,1483,3183,1851
99027,6101,3048,3053,1475,1161,2041,1424
99029,1289,640,649,342,245,429,273
99030,1032,521,511,217,191,347,277
99031,1137,590,547,278,178,393,288
99032,691,359,332,167,112,215,197
99033,895,424,471,237,156,228,274
99034,209,94,115,50,32,73,54
99036,1448,734,714,391,188,588,281
99037,12973,6391,6582,3705,2887,3947,2434
99039,87,48,39,18,14,35,20
99040,734,377,357,236,185,204,109
99101,1453,769,684,394,275,437,347
99102,500,250,250,131,134,151,84
99103,497,258,239,131,64,148,154
99105,61,26,35,11,2,25,23
99109,5109,2496,2613,1271,869,1455,1514
99110,1667,843,824,558,365,418,326
99111,4047,2037,2010,1002,834,1160,1051
99113,761,388,373,202,124,263,172
99114,12018,5787,6231,2919,2160,3683,3256
99115,1143,584,559,232,178,341,392
99116,1439,730,709,360,301,379,399
99117,485,245,240,92,69,149,175
99118,931,534,397,249,199,268,215
99119,1204,649,555,270,177,382,375
99121,145,84,61,30,24,55,36
99122,3773,1879,1894,1022,658,1058,1035
99123,1058,528,530,213,163,336,346
99124,240,117,123,50,46,65,79
99125,527,265,262,102,76,188,161
99126,877,448,429,250,124,290,213
99128,278,144,134,61,49,89,79
99129,793,397,396,235,160,217,181
99130,828,395,433,186,163,268,211
99131,170,93,77,30,28,48,64
99133,1493,741,752,295,270,467,461
99134,643,302,341,164,109,191,179
99135,255,136,119,60,47,87,61
99136,29,12,17,5,3,2,19
99137,343,174,169,85,46,115,97
99138,1209,616,593,362,278,329,240
99139,1301,652,649,295,203,419,384
99140,475,241,234,137,98,142,98
99141,5240,2655,2585,1195,894,1630,1521
99143,650,334,316,143,88,212,207
99144,43,26,17,7,7,15,14
99146,56,30,26,11,6,20,19
99147,190,100,90,24,16,49,101
99148,2106,1048,1058,457,298,649,702
99149,208,105,103,51,30,61,66
99150,380,205,175,99,61,125,95
99151,164,83,81,40,31,50,43
99152,197,105,92,43,30,61,63
99153,467,229,238,102,60,170,135
99154,20,12,8,5,2,8,5
99155,1350,682,668,467,364,318,201
99156,8114,4077,4037,1930,1429,2503,2252
99157,697,361,336,174,114,207,202
99158,603,297,306,159,89,192,163
99159,1375,680,695,328,218,416,413
99160,149,75,74,25,36,57,31
99161,1400,704,696,326,267,478,329
99163,31404,16108,15296,8395,16683,3929,2397
99164,0,0,0,0,0,0,0
99166,3222,1628,1594,655,547,1004,1016
99167,625,340,285,121,85,200,219
99169,2459,1233,1226,569,435,728,727
99170,1072,546,526,271,199,332,270
99171,959,477,482,241,139,278,301
99173,1532,794,738,422,263,460,387
99174,44,22,22,6,4,14,20
99176,145,74,71,30,25,47,43
99179,437,225,212,102,91,142,102
99180,939,473,466,207,151,308,273
99181,1901,984,917,533,307,545,516
99185,1295,628,667,279,211,374,431
99201,13342,7094,6248,2356,4862,3921,2203
99202,21580,10696,10884,6304,7637,4603,3036
99203,20192,9518,10674,4864,4594,6002,4732
99204,6681,3281,3400,1174,2789,1828,890
99205,42137,20455,21682,10748,12887,11066,7436
99206,34802,17176,17626,9428,9043,9602,6729
99207,30854,15258,15596,8858,10278,7398,4320
99208,49193,23670,25523,13343,12318,13308,10224
99212,19197,9641,9556,4735,4932,5591,3939
99216,24362,11718,12644,6534,7016,6014,4798
99217,17423,8614,8809,4713,5058,4699,2953
99218,15531,7242,8289,4639,4153,3465,3274
99223,29273,14085,15188,7555,6850,8259,6609
99224,18289,9218,9071,4371,5005,5430,3483
99301,68191,34599,33592,25743,20673,14301,7474
99320,9201,4669,4532,2677,2039,2859,1626
99321,531,288,243,220,187,92,32
99322,217,109,108,50,22,69,76
99323,3684,1846,1838,1093,708,1177,706
99324,9202,4439,4763,2254,2887,1945,2116
99326,4956,3219,1737,1389,1755,1316,496
99328,3733,1842,1891,837,652,1086,1158
99329,160,81,79,32,37,54,37
99330,907,469,438,320,222,241,124
99333,50,29,21,15,12,13,10
99335,340,176,164,90,63,125,62
99336,48753,24447,24306,15348,15358,11048,6999
99337,29845,14991,14854,9073,6693,8602,5477
99338,11555,5788,5767,3500,2367,3803,1885
99341,884,465,419,253,178,247,206
99343,3040,1611,1429,1275,846,660,259
99344,16817,8568,8249,6889,4717,3321,1890
99345,213,115,98,78,40,72,23
99346,352,191,161,92,74,114,72
99347,2293,1127,1166,506,390,681,716
99348,1364,717,647,507,354,339,164
99349,8483,4641,3842,3570,2908,1331,674
99350,12979,6538,6441,4417,3230,3305,2027
99352,26975,13195,13780,7218,6274,7920,5563
99353,13306,6729,6577,4163,3084,4180,1879
99354,21343,10495,10848,5622,5365,5805,4551
99356,294,154,140,94,57,80,63
99357,4323,2308,2015,1823,1379,805,316
99359,158,82,76,18,22,50,68
99360,1350,659,691,401,266,426,257
99361,1902,955,947,506,317,635,444
99362,41010,21086,19924,10932,11234,10530,8314
99363,216,112,104,74,43,52,47
99371,311,170,141,62,48,109,92
99401,273,144,129,43,33,100,97
99402,1875,898,977,508,341,542,484
99403,19548,9451,10097,4734,4334,5396,5084
20135,140,71,69,40,32,38,30
24604,80,37,43,27,18,17,18
24701,20786,9853,10933,4835,4899,5752,5300
24712,2063,1006,1057,618,721,376,348
24714,257,132,125,59,56,87,55
24715,594,304,290,120,125,195,154
24716,508,260,248,117,110,144,137
24719,223,114,109,65,62,52,44
24724,66,31,35,14,14,13,25
24726,566,286,280,164,120,160,122
24729,149,76,73,25,30,47,47
24731,255,135,120,59,64,77,55
24733,853,413,440,204,187,251,211
24736,902,459,443,223,204,246,229
24737,243,128,115,65,59,51,68
24738,308,151,157,73,61,89,85
24740,30435,14398,16037,6909,7228,8491,7807
24747,3006,1514,1492,744,607,899,756
24801,3858,1979,1879,758,1022,1168,910
24808,675,322,353,149,145,211,170
24811,599,287,312,147,157,195,100
24813,511,267,244,129,115,151,116
24815,559,285,274,124,118,196,121
24816,151,71,80,31,41,48,31
24817,954,462,492,254,197,294,209
24818,1409,714,695,335,311,445,318
24822,955,479,476,236,227,258,234
24823,383,184,199,90,92,114,87
24826,150,73,77,37,31,40,42
24827,1501,729,772,359,358,484,300
24828,927,475,452,199,221,295,212
24830,139,69,70,22,20,41,56
24831,250,104,146,59,59,66,66
24834,412,195,217,99,94,123,96
24836,800,366,434,149,154,199,298
24839,1523,764,759,341,393,495,294
24843,158,79,79,48,29,55,26
24844,1810,880,930,387,402,569,452
24845,282,136,146,49,66,106,61
24846,244,139,105,59,64,87,34
24847,293,148,145,62,67,99,65
24848,262,123,139,70,63,81,48
24849,337,156,181,71,67,116,83
24850,1093,564,529,258,252,363,220
24851,419,228,191,97,97,135,90
24853,793,377,416,185,165,238,205
24854,550,280,270,157,140,178,75
24857,984,484,500,223,207,340,214
24860,552,262,290,115,113,181,143
24861,307,151,156,68,73,100,66
24862,651,339,312,159,148,205,139
24866,240,127,113,57,41,80,62
24867,409,196,213,88,70,118,133
24868,1686,777,909,413,397,473,403
24869,351,177,174,96,92,108,55
24870,2874,1393,1481,690,657,843,684
24871,309,160,149,72,56,80,101
24872,783,390,393,186,192,261,144
24873,600,286,314,109,128,199,164
24874,2729,1383,1346,576,616,832,705
24878,337,164,173,69,56,111,101
24879,657,332,325,155,159,209,134
24880,356,182,174,66,71,118,101
24881,601,305,296,127,134,194,146
24882,483,259,224,128,122,155,78
24884,265,125,140,59,54,79,73
24887,67,29,38,9,16,21,21
24888,167,85,82,37,41,49,40
24892,1513,752,761,342,370,448,353
24894,388,198,190,76,97,130,85
24898,198,84,114,59,53,41,45
24901,9128,4356,4772,1926,2121,2518,2563
24910,5383,2108,3275,946,1494,1782,1161
24915,590,297,293,90,105,214,181
24916,558,272,286,113,114,178,153
24918,1677,848,829,410,335,448,484
24920,346,181,165,66,82,98,100
24924,512,265,247,98,97,169,148
24925,935,467,468,227,202,285,221
24927,365,184,181,75,74,110,106
24931,1544,776,768,347,312,489,396
24934,503,253,250,89,86,167,161
24935,688,336,352,146,113,199,230
24938,1518,744,774,357,324,490,347
24941,1059,552,507,235,217,338,269
24944,401,210,191,85,60,130,126
24945,393,187,206,76,67,115,135
24946,1533,848,685,244,408,474,407
24951,1489,725,764,317,295,402,475
24954,3514,1738,1776,752,707,1071,984
24957,346,173,173,87,78,95,86
24962,186,72,114,70,24,42,50
24963,4095,2015,2080,1043,928,1061,1063
24966,1286,652,634,280,237,420,349
24970,4575,2173,2402,1093,972,1395,1115
24974,299,146,153,71,62,99,67
24976,1005,499,506,252,188,329,236
24977,441,216,225,115,92,114,120
24981,631,304,327,111,130,189,201
24983,2443,1176,1267,507,483,707,746
24984,185,91,94,27,31,66,61
24986,5216,2626,2590,1072,1218,1458,1468
24991,521,260,261,105,90,200,126
25002,112,59,53,22,25,37,28
25003,2782,1380,1402,636,676,871,599
25005,264,128,136,58,56,90,60
25007,604,301,303,154,125,202,123
25008,210,108,102,59,46,63,42
25009,1153,588,565,265,301,355,232
25011,800,403,397,187,170,259,184
25015,4691,2245,2446,1103,1079,1419,1090
25019,575,288,287,160,120,151,144
25021,305,160,145,76,80,82,67
25022,153,84,69,26,18,62,47
25024,586,291,295,159,157,153,117
25025,230,113,117,48,40,74,68
25028,381,190,191,97,93,115,76
25030,414,209,205,121,85,117,91
25031,615,293,322,134,142,160,179
25033,2234,1130,1104,532,510,679,513
25035,1112,536,576,228,259,323,302
25036,468,232,236,105,97,137,129
25039,1304,624,680,322,277,386,319
25040,546,270,276,115,120,151,160
25043,1659,851,808,414,402,453,390
25044,384,192,192,110,89,99,86
25045,5801,2883,2918,1375,1271,1785,1370
25047,411,205,206,111,89,130,81
25048,38,20,18,0,4,11,23
25049,630,314,316,203,156,163,108
25051,164,85,79,38,29,62,35
25053,4296,2112,2184,1051,1022,1300,923
25054,426,225,201,119,93,108,106
25057,337,151,186,73,67,115,82
25059,678,338,340,164,141,177,196
25060,618,313,305,151,150,160,157
25061,756,384,372,179,167,239,171
25062,230,116,114,61,46,64,59
25063,1797,905,892,461,352,505,479
25064,9962,4640,5322,2187,2613,2693,2469
25067,1120,549,571,264,233,336,287
25070,1683,810,873,421,399,451,412
25071,11697,5742,5955,2693,2687,3574,2743
25075,976,488,488,259,250,277,190
25076,298,146,152,65,56,106,71
25081,1251,650,601,344,290,361,256
25082,1673,849,824,422,361,540,350
25083,672,331,341,177,145,199,151
25085,830,398,432,179,178,254,219
25086,928,443,485,187,209,212,320
25088,164,76,88,36,31,64,33
25090,203,101,102,48,43,47,65
25093,207,91,116,65,52,63,27
25102,349,180,169,94,91,84,80
25103,366,196,170,80,77,96,113
25106,642,313,329,174,139,193,136
25107,739,374,365,153,181,243,162
25108,692,343,349,158,179,221,134
25109,661,319,342,150,153,216,142
25110,599,295,304,149,121,182,147
25111,694,341,353,199,158,192,145
25112,166,74,92,41,122,3,0
25113,957,457,500,207,204,246,300
25114,557,269,288,136,117,189,115
25115,90,48,42,19,22,17,32
25118,998,493,505,228,230,287,253
25119,444,212,232,128,92,120,104
25121,972,491,481,215,232,289,236
25123,3535,1833,1702,847,780,1078,830
25124,1214,600,614,283,256,445,230
25125,1011,514,497,257,243,299,212
25126,58,28,30,15,10,12,21
25130,3846,1873,1973,922,909,1123,892
25132,276,132,144,64,47,81,84
25133,922,451,471,257,207,275,183
25134,423,214,209,93,95,111,124
25136,1798,950,848,473,545,400,380
25139,440,214,226,105,119,120,96
25140,1012,534,478,232,222,308,250
25141,195,99,96,40,39,67,49
25142,416,205,211,106,104,119,87
25143,8579,4105,4474,1975,2203,2361,2040
25148,332,171,161,85,79,105,63
25149,242,125,117,52,55,75,60
25152,368,180,188,94,79,112,83
25154,868,430,438,223,221,257,167
25156,105,53,52,13,23,24,45
25159,5163,2562,2601,1283,1147,1610,1123
25160,303,163,140,83,54,98,68
25161,369,175,194,101,84,101,83
25162,571,271,300,133,145,143,150
25164,1257,614,643,327,279,400,251
25165,612,306,306,171,138,158,145
25168,2503,1259,1244,585,546,785,587
25169,516,248,268,132,131,170,83
25173,452,226,226,97,110,137,108
25174,420,214,206,113,99,113,95
25177,24084,11538,12546,5672,5796,6882,5734
25180,83,37,46,22,16,28,17
25181,1853,901,952,516,424,525,388
25183,73,40,33,21,13,26,13
25185,1042,1042,0,1,429,506,106
25186,881,402,479,170,178,233,300
25187,719,357,362,158,157,227,177
25193,477,241,236,118,127,134,98
25201,55,29,26,8,11,19,17
25202,1370,688,682,332,315,444,279
25203,89,49,40,30,21,26,12
25204,211,114,97,36,29,80,66
25205,391,213,178,97,88,124,82
25206,601,292,309,129,121,198,153
25208,992,493,499,258,225,293,216
25209,1227,606,621,288,284,350,305
25211,135,73,62,37,34,36,28
25213,5512,2699,2813,1470,1229,1749,1064
25214,614,304,310,134,127,183,170
25234,1200,595,605,295,267,338,300
25235,949,471,478,266,215,287,181
25239,1732,891,841,409,382,556,385
25241,1710,867,843,427,422,487,374
25243,899,455,444,217,195,263,224
25244,732,379,353,180,137,239,176
25245,739,364,375,192,144,243,160
25247,509,261,248,133,139,140,97
25248,3090,1589,1501,762,647,975,706
25251,429,211,218,104,88,134,103
25252,1071,541,530,261,219,335,256
25253,2051,1029,1022,495,448,685,423
25259,699,354,345,165,161,207,166
25260,1577,765,812,373,330,437,437
25261,335,171,164,82,75,102,76
25262,898,459,439,213,205,246,234
25264,441,228,213,101,100,144,96
25265,1564,754,810,375,359,422,408
25266,797,417,380,211,158,219,209
25267,758,372,386,160,151,237,210
25268,871,462,409,183,176,262,250
25270,972,484,488,213,178,295,286
25271,9304,4473,4831,2351,2187,2562,2204
25275,2287,1142,1145,539,515,723,510
25276,7752,3780,3972,1904,1712,2284,1852
25285,595,299,296,156,132,191,116
25286,1692,842,850,383,350,550,409
25287,1272,427,845,182,481,376,233
25301,2771,1305,1466,332,874,886,679
25302,15078,7160,7918,3240,3749,4562,3527
25303,7112,3312,3800,1578,1839,2146,1549
25304,8773,4051,4722,1794,2243,2320,2416
25305,0,0,0,0,0,0,0
25306,6417,3098,3319,1477,1421,1927,1592
25309,13356,6382,6974,3019,3183,3939,3215
25311,10815,5188,5627,2475,2759,3278,2303
25312,14886,7181,7705,3618,3537,4534,3197
25313,13436,6558,6878,3150,3538,4056,2692
25314,14542,7047,7495,3599,3015,4444,3484
25315,3255,1488,1767,723,696,969,867
25320,6084,2961,3123,1451,1355,1858,1420
25401,14622,7166,7456,3849,3960,3796,3017
25403,12591,6199,6392,3614,3191,3829,1957
25404,19551,9560,9991,5328,5493,5415,3315
25405,12029,6192,5837,3278,3289,3350,2112
25411,12633,6246,6387,2850,2517,3898,3368
25413,7508,3735,3773,2127,2003,2274,1104
25414,17024,8317,8707,4796,3976,5173,3079
25419,9251,4619,4632,2259,2110,3031,1851
25420,4024,2019,2005,1098,954,1384,588
25422,1700,885,815,296,275,633,496
25425,12835,6561,6274,3423,2956,4294,2162
25427,14322,7234,7088,3833,3287,4519,2683
25428,10776,5255,5521,3233,3054,2931,1558
25430,8112,4079,4033,2142,1865,2667,1438
25431,453,234,219,107,99,135,112
25432,121,62,59,30,28,33,30
25434,2521,1288,1233,576,556,762,627
25437,212,117,95,50,40,63,59
25438,6266,3030,3236,1765,1850,1651,1000
25442,1925,950,975,513,415,634,363
25443,7445,3555,3890,1837,2238,1794,1576
25444,605,312,293,154,121,174,156
25446,1463,728,735,420,296,487,260
25501,1130,568,562,294,255,319,262
25502,1034,508,526,247,252,295,240
25503,729,371,358,197,194,177,161
25504,12661,6289,6372,2889,3316,3494,2962
25505,477,244,233,115,103,136,123
25506,5037,2528,2509,1253,1118,1566,1100
25507,987,381,606,203,188,245,351
25508,9837,4887,4950,2247,2418,3069,2103
25510,5074,2487,2587,1299,1210,1434,1131
25511,1092,563,529,292,242,317,241
25512,1237,637,600,321,264,358,294
25514,4024,2007,2017,1018,947,1201,858
25515,2335,1141,1194,546,523,725,541
25517,2071,1060,1011,634,471,585,381
25520,1561,768,793,409,336,451,365
25521,1101,573,528,333,268,313,187
25523,2647,1274,1373,618,568,775,686
25524,3486,1768,1718,849,878,1055,704
25526,21902,10649,11253,5866,5119,6534,4383
25529,1013,526,487,294,227,284,208
25530,5877,2790,3087,1413,1385,1663,1416
25534,282,147,135,44,67,96,75
25535,2783,1385,1398,637,632,802,712
25537,1993,980,1013,444,425,586,538
25540,290,143,147,75,60,97,58
25541,9350,4528,4822,2263,2053,2814,2220
25545,4512,2200,2312,1146,1049,1339,978
25547,969,480,489,212,232,301,224
25550,9077,4260,4817,2215,1992,2552,2318
25555,2325,1150,1175,653,527,609,536
25557,1754,863,891,427,401,539,387
25559,2152,1068,1084,521,475,663,493
25560,7997,3922,4075,2022,1796,2448,1731
25564,1250,621,629,325,301,368,256
25565,651,340,311,167,154,205,125
25567,924,483,441,241,215,268,200
25570,6640,3237,3403,1673,1519,1862,1586
25571,2206,1084,1122,569,506,659,472
25573,970,473,497,235,218,294,223
25601,5206,2429,2777,1131,1341,1462,1272
25606,964,463,501,221,239,353,151
25607,1140,546,594,261,247,403,229
25608,1004,497,507,205,237,343,219
25611,682,346,336,172,172,197,141
25617,999,499,500,231,225,273,270
25621,2155,1080,1075,463,480,750,462
25624,480,231,249,93,108,150,129
25625,1452,791,661,253,473,448,278
25628,539,251,288,142,151,154,92
25630,683,337,346,178,150,245,110
25632,834,428,406,222,189,255,168
25634,771,389,382,206,195,232,138
25635,1227,618,609,280,292,346,309
25637,936,466,470,166,228,338,204
25638,1148,575,573,272,257,331,288
25639,608,305,303,87,115,199,207
25644,536,270,266,132,139,167,98
25646,940,438,502,205,204,292,239
25647,768,369,399,159,178,246,185
25649,1397,688,709,325,329,451,292
25650,547,278,269,132,117,167,131
25651,737,376,361,188,170,238,141
25652,1608,771,837,422,403,433,350
25653,459,225,234,97,107,137,118
25654,310,144,166,67,58,89,96
25661,6837,3193,3644,1530,1607,2016,1684
25666,654,329,325,197,161,194,102
25669,887,436,451,225,215,287,160
25670,5829,2922,2907,1465,1479,1750,1135
25671,1286,649,637,328,334,394,230
25672,408,207,201,117,97,121,73
25674,3202,1593,1609,888,824,907,583
25676,1250,628,622,352,366,353,179
25678,1595,765,830,335,365,521,374
25688,448,200,248,148,130,128,42
25690,249,124,125,59,59,83,48
25692,1021,493,528,277,248,315,181
25696,295,142,153,63,73,100,59
25699,200,95,105,52,54,60,34
25701,23284,11513,11771,4567,7268,5962,5487
25702,7788,3757,4031,1768,2113,2128,1779
25703,6751,3235,3516,2101,3333,841,476
25704,16441,7944,8497,3990,4051,4665,3735
25705,20711,9954,10757,4800,5710,5395,4806
25801,33590,15851,17739,7635,8171,9391,8393
25810,261,130,131,69,65,78,49
25811,154,80,74,36,33,46,39
25812,1902,934,968,416,405,533,548
25813,8063,5185,2878,1288,3100,2331,1344
25817,784,398,386,195,213,214,162
25818,472,217,255,93,151,123,105
25820,437,226,211,99,93,139,106
25823,2176,1052,1124,503,479,641,553
25825,2390,1169,1221,576,545,793,476
25826,296,149,147,79,54,86,77
25827,2488,1228,1260,597,563,691,637
25831,1421,711,710,335,319,421,346
25832,3994,1941,2053,984,864,1123,1023
25836,488,233,255,122,100,139,127
25837,391,193,198,100,95,96,100
25839,691,359,332,197,202,179,113
25840,8179,4090,4089,1921,1907,2524,1827
25841,575,293,282,123,122,178,152
25843,791,410,381,154,147,263,227
25844,1417,688,729,370,319,428,300
25845,627,311,316,157,155,192,123
25846,363,190,173,76,74,94,119
25848,443,227,216,100,99,165,79
25849,266,126,140,74,51,70,71
25853,182,86,96,51,44,49,38
25854,1101,545,556,241,242,380,238
25855,209,80,129,34,29,40,106
25857,308,143,165,68,67,95,78
25862,266,121,145,63,65,70,68
25864,309,159,150,90,78,86,55
25865,1475,738,737,368,347,422,338
25868,432,218,214,103,88,144,97
25870,103,48,55,20,20,27,36
25871,695,327,368,196,178,179,142
25873,607,308,299,132,128,170,177
25875,486,250,236,142,104,136,104
25876,128,64,64,21,19,51,37
25878,930,458,472,219,209,263,239
25879,359,183,176,79,93,116,71
25880,6928,3394,3534,1787,1871,1905,1365
25882,2033,1004,1029,519,463,564,487
25901,11920,5658,6262,2865,2772,3421,2862
25902,420,202,218,93,82,127,118
25904,365,192,173,75,89,120,81
25906,287,151,136,64,62,84,77
25907,123,56,67,28,29,32,34
25908,172,96,76,37,43,57,35
25911,55,27,28,13,10,21,11
25913,397,197,200,105,106,110,76
25915,311,160,151,82,79,81,69
25916,202,96,106,51,50,64,37
25917,2139,1047,1092,496,487,687,469
25918,4430,2202,2228,1181,1064,1179,1006
25920,221,102,119,54,62,59,46
25921,2157,1038,1119,510,524,610,513
25922,299,154,145,79,55,94,71
25928,375,185,190,93,71,133,78
25932,339,172,167,96,84,104,55
25936,43,23,20,9,6,19,9
25938,1287,643,644,333,280,391,283
25942,162,75,87,37,37,49,39
25951,6208,3007,3201,1344,1263,1739,1862
25958,851,415,436,222,164,249,216
25962,3806,1808,1998,822,781,1105,1098
25969,973,492,481,232,212,307,222
25971,1130,543,587,283,246,322,279
25972,299,160,139,73,66,87,73
25976,2663,1325,1338,562,528,797,776
25977,155,74,81,26,29,45,55
25978,606,314,292,137,116,164,189
25979,893,421,472,205,152,285,251
25981,951,486,465,214,181,284,272
25984,1886,930,956,458,398,554,476
25985,430,213,217,87,71,145,127
25989,280,132,148,80,71,64,65
26003,43002,20460,22542,9600,9653,12532,11217
26030,516,248,268,135,114,158,109
26031,1755,831,924,435,432,475,413
26032,1243,641,602,365,531,190,157
26033,3044,1492,1552,735,652,921,736
26034,4905,2351,2554,1162,997,1477,1269
26035,2491,1256,1235,584,502,770,635
26036,425,211,214,99,94,131,101
26037,6642,3161,3481,1479,1361,1971,1831
26038,2855,1351,1504,552,523,887,893
26039,1061,540,521,297,236,333,195
26040,2103,1020,1083,494,502,586,521
26041,16183,7902,8281,3705,3502,4815,4161
26047,6222,3080,3142,1370,1214,2067,1571
26050,1575,794,781,409,362,437,367
26055,1756,879,877,418,353,576,409
26056,93,45,48,22,23,31,17
26059,3082,1540,1542,773,707,940,662
26060,1881,941,940,390,398,657,436
26062,21801,10366,11435,4657,4579,6683,5882
26070,8441,4149,4292,1802,1730,2591,2318
26074,1184,549,635,484,499,123,78
26075,505,257,248,118,118,142,127
26101,29999,14402,15597,7535,7537,8436,6491
26104,16769,7988,8781,3779,3838,4758,4394
26105,12333,5809,6524,2719,2728,3483,3403
26133,1415,716,699,347,275,480,313
26134,888,397,491,222,166,216,284
26136,644,320,324,119,125,208,192
26137,939,477,462,203,189,298,249
26138,127,71,56,39,20,34,34
26141,364,187,177,60,60,136,108
26142,2574,1272,1302,671,572,830,501
26143,4547,2241,2306,1075,973,1473,1026
26146,1003,500,503,216,191,329,267
26147,2188,1065,1123,457,452,651,628
26148,245,132,113,54,50,82,59
26149,2452,1186,1266,568,475,798,611
26150,6309,3080,3229,1658,1417,1920,1314
26151,558,283,275,111,128,162,157
26152,56,29,27,11,12,20,13
26155,8823,4269,4554,2050,1740,2621,2412
26159,2745,1312,1433,612,583,806,744
26160,960,489,471,230,174,315,241
26161,480,268,212,93,94,152,141
26164,8262,4030,4232,2042,1803,2305,2112
26167,865,429,436,243,191,234,197
26169,842,431,411,187,180,273,202
26170,6137,3380,2757,1391,1505,1905,1336
26175,3326,1615,1711,775,650,1020,881
26178,587,296,291,127,99,191,170
26180,2284,1164,1120,592,480,739,473
26181,6127,3088,3039,1466,1202,1945,1514
26184,2361,1165,1196,619,562,730,450
26187,5982,2869,3113,1445,1195,1860,1482
26201,19701,9594,10107,4809,4882,5418,4592
26202,641,312,329,142,117,217,165
26203,198,104,94,41,42,73,42
26205,3690,1788,1902,935,805,1038,912
26206,2976,1450,1526,745,675,846,710
26208,973,506,467,265,234,265,209
26209,112,57,55,16,24,41,31
26215,167,87,80,39,37,49,42
26217,354,178,176,82,72,113,87
26218,2583,1322,1261,664,555,788,576
26222,454,227,227,96,70,154,134
26224,221,119,102,45,34,75,67
26228,109,59,50,17,23,36,33
26230,124,68,56,29,19,44,32
26234,1454,730,724,330,271,469,384
26236,29,12,17,5,6,9,9
26237,571,304,267,158,124,153,136
26238,739,376,363,161,143,230,205
26241,14591,7034,7557,3362,3183,4018,4028
26250,5570,2888,2682,1323,1358,1625,1264
26253,3490,1712,1778,867,702,1087,834
26254,303,153,150,62,64,91,86
26257,957,472,485,262,219,271,205
26259,176,85,91,39,39,46,52
26260,1377,700,677,276,248,444,409
26261,2701,1303,1398,576,504,750,871
26263,316,164,152,53,67,89,107
26264,642,329,313,150,146,189,157
26266,252,125,127,68,64,55,65
26267,369,214,155,93,79,120,77
26268,82,40,42,14,23,17,28
26269,1018,506,512,268,210,278,262
26270,755,386,369,163,170,241,181
26271,383,193,190,70,77,111,125
26273,2041,1602,439,230,900,648,263
26275,744,370,374,220,184,212,128
26276,356,183,173,77,66,124,89
26278,591,296,295,131,142,188,130
26280,1710,845,865,432,339,523,416
26282,60,29,31,12,14,20,14
26283,1734,903,831,386,345,554,449
26285,304,153,151,69,61,96,78
26287,3131,1572,1559,719,603,954,855
26288,3603,1767,1836,792,730,1101,980
26291,165,95,70,31,43,67,24
26292,836,397,439,138,170,215,313
26293,600,288,312,133,124,190,153
26294,729,364,365,124,144,257,204
26296,177,91,86,25,27,71,54
26298,96,49,47,20,15,27,34
26301,30435,14648,15787,7346,7528,8464,7097
26320,1000,507,493,222,204,298,276
26321,354,186,168,83,71,107,93
26323,602,293,309,159,167,168,108
26325,320,166,154,80,63,102,75
26327,83,36,47,23,13,29,18
26330,14377,6970,7407,3506,3136,4354,3381
26335,1378,679,699,333,295,423,327
26337,1218,632,586,305,255,373,285
26338,629,317,312,139,142,200,148
26339,255,133,122,59,47,81,68
26342,509,266,243,95,94,173,147
26343,445,230,215,117,105,122,101
26346,972,497,475,224,208,324,216
26347,2068,1043,1025,519,489,634,426
26348,196,93,103,40,38,61,57
26349,132,69,63,37,36,38,21
26351,5120,3487,1633,823,2233,1327,737
26354,11135,5664,5471,2486,2695,3255,2699
26361,263,125,138,74,71,66,52
26362,3378,1621,1757,778,690,983,927
26366,144,72,72,39,33,42,30
26369,762,372,390,201,166,207,188
26372,686,351,335,152,134,211,189
26374,1375,696,679,310,352,425,288
26376,463,241,222,120,96,117,130
26377,700,367,333,173,141,219,167
26378,3820,1842,1978,901,827,1103,989
26384,520,266,254,122,117,144,137
26385,3872,1930,1942,961,864,1198,849
26386,2411,1218,1193,591,571,757,492
26404,458,211,247,112,96,146,104
26405,1179,610,569,267,261,365,286
26408,2852,1424,1428,641,621,986,604
26410,1037,518,519,217,255,322,243
26411,707,370,337,139,130,243,195
26412,546,283,263,124,115,159,148
26415,4016,2190,1826,874,1161,1189,792
26416,7529,3650,3879,1888,1856,2000,1785
26419,1131,581,550,266,227,360,278
26421,262,132,130,61,58,83,60
26422,606,306,300,128,129,177,172
26424,318,152,166,88,68,98,64
26425,1216,597,619,253,239,399,325
26426,7003,3568,3435,1762,1513,2059,1669
26430,466,221,245,129,118,129,90
26431,5950,2911,3039,1399,1410,1733,1408
26435,98,46,52,21,24,21,32
26436,204,101,103,54,48,59,43
26437,645,327,318,174,146,195,130
26438,176,77,99,41,24,61,50
26440,1135,589,546,283,263,346,243
26443,258,124,134,65,61,70,62
26444,3639,1816,1823,851,801,1148,839
26447,1055,522,533,260,240,315,240
26448,1421,744,677,370,329,462,260
26451,685,348,337,180,167,207,131
26452,9676,4749,4927,2176,2189,2887,2424
26456,3734,1871,1863,925,737,1081,991
26501,19616,10383,9233,3725,6809,5573,3509
26505,38772,20491,18281,9125,20748,4828,4071
26508,29170,14398,14772,7482,8534,8449,4705
26519,1836,955,881,433,399,578,426
26520,778,393,385,148,152,268,210
26521,346,169,177,88,68,99,91
26525,7064,4177,2887,1193,2572,2236,1063
26534,789,370,419,185,208,215,181
26537,5721,2706,3015,1340,1287,1625,1469
26541,2624,1318,1306,635,604,811,574
26542,2547,1259,1288,580,606,774,587
26543,252,119,133,72,65,60,55
26547,2376,1210,1166,608,656,678,434
26554,41369,20188,21181,9515,11095,11287,9472
26559,1269,621,648,293,314,351,311
26560,227,118,109,48,48,63,68
26562,634,329,305,135,122,179,198
26563,381,195,186,109,102,101,69
26568,679,315,364,181,159,182,157
26570,3595,1801,1794,865,767,1070,893
26571,1833,928,905,414,410,539,470
26572,136,70,66,30,31,34,41
26574,664,324,340,138,172,182,172
26575,827,412,415,178,195,230,224
26576,608,290,318,154,156,169,129
26581,1104,558,546,268,227,332,277
26582,5335,2569,2766,1263,1130,1631,1311
26585,479,244,235,96,91,154,138
26586,209,100,109,58,33,67,51
26587,432,220,212,97,100,139,96
26588,2611,1267,1344,589,582,793,647
26590,791,395,396,210,163,234,184
26591,1511,760,751,352,369,461,329
26601,4898,2545,2353,1063,1165,1508,1162
26610,1090,566,524,243,240,327,280
26611,224,110,114,47,54,63,60
26615,245,124,121,56,55,72,62
26617,187,90,97,32,39,57,59
26619,606,303,303,156,157,171,122
26621,757,377,380,194,161,235,167
26623,1189,592,597,299,250,335,305
26624,2950,1413,1537,648,637,869,796
26627,447,215,232,107,93,145,102
26629,309,156,153,71,61,102,75
26631,352,188,164,74,75,114,89
26636,487,248,239,120,125,145,97
26638,178,94,84,40,37,50,51
26651,9650,4696,4954,2256,2231,2917,2246
26656,401,188,213,110,99,92,100
26660,255,122,133,55,49,96,55
26662,1154,568,586,286,261,359,248
26676,435,222,213,84,93,142,116
26678,1247,622,625,306,298,388,255
26679,1896,979,917,424,421,655,396
26680,340,165,175,82,79,93,86
26681,1486,735,751,347,332,414,393
26684,116,54,62,29,22,37,28
26690,584,300,284,137,147,175,125
26691,417,219,198,111,85,125,96
26704,5663,2950,2713,1477,1388,1666,1132
26705,1077,551,526,246,216,335,280
26707,344,180,164,75,84,101,84
26710,2133,1111,1022,551,445,659,478
26711,2655,1354,1301,623,613,892,527
26714,482,254,228,92,80,180,130
26716,706,370,336,146,139,221,200
26717,1170,629,541,280,288,347,255
26719,2785,1351,1434,647,611,814,713
26720,174,82,92,39,35,58,42
26722,599,313,286,111,117,184,187
26726,13306,6543,6763,3505,2966,3596,3239
26731,382,186,196,107,90,105,80
26739,889,441,448,180,188,275,246
26743,1613,838,775,379,351,530,353
26750,891,423,468,244,228,235,184
26753,6254,3075,3179,1414,1360,1863,1617
26755,833,427,406,190,163,279,201
26757,6464,3081,3383,1616,1323,1760,1765
26761,685,341,344,172,154,221,138
26763,1540,805,735,386,335,458,361
26764,4220,2089,2131,969,873,1259,1119
26767,768,375,393,143,159,244,222
26801,1118,543,575,217,212,349,340
26802,1357,720,637,332,392,345,288
26804,709,364,345,167,147,202,193
26807,2947,1448,1499,603,496,894,954
26808,967,484,483,242,179,331,215
26810,329,189,140,54,47,110,118
26812,1705,844,861,328,354,541,482
26814,415,215,200,83,61,138,133
26815,646,330,316,128,104,214,200
26817,443,221,222,117,99,134,93
26818,709,346,363,229,180,194,106
26823,198,104,94,41,34,67,56
26833,2309,1186,1123,571,540,634,564
26836,6578,3319,3259,1658,1619,1876,1425
26845,898,468,430,219,206,290,183
26847,6277,3066,3211,1475,1228,1862,1712
26851,2180,1114,1066,480,448,664,588
26852,869,463,406,215,179,275,200
26855,826,414,412,182,156,280,208
26865,248,126,122,57,40,75,76
26866,929,469,460,178,165,321,265
26884,625,315,310,122,122,171,210
53001,1901,981,920,467,417,641,376
53002,2299,1199,1100,580,528,802,389
53003,141,69,72,26,35,35,45
53004,3330,1712,1618,1004,796,1041,489
53005,19425,9578,9847,4745,3217,6402,5061
53006,1779,925,854,477,366,612,324
53007,1841,874,967,364,486,542,449
53010,7681,3810,3871,1900,1501,2647,1633
53011,2260,1197,1063,547,424,807,482
53012,18097,8767,9330,4813,3147,6095,4042
53013,3308,1675,1633,930,674,1032,672
53014,7962,4005,3957,2023,1762,2500,1677
53015,2609,1363,1246,691,537,839,542
53016,384,198,186,98,96,132,58
53017,5538,2831,2707,1417,873,2186,1062
53018,7899,4121,3778,2547,1120,2683,1549
53019,2027,1053,974,556,473,635,363
53020,3500,1783,1717,753,614,1330,803
53021,4709,2436,2273,1285,1067,1575,782
53022,18920,9245,9675,5230,3831,6335,3524
53023,1496,754,742,394,291,530,281
53024,16579,8126,8453,4171,3689,5267,3452
53027,22041,11005,11036,5936,5136,6760,4209
53029,20799,10259,10540,6211,3962,7297,3329
53031,43,24,19,19,11,11,2
53032,4757,2400,2357,1240,1125,1460,932
53033,4885,2519,2366,1180,781,1873,1051
53034,1811,945,866,433,438,579,361
53035,2406,1235,1171,624,557,826,399
53036,2720,1363,1357,774,743,785,418
53037,9260,4579,4681,2442,2218,2956,1644
53038,4013,2002,2011,1117,1153,1129,614
53039,4863,2646,2217,1112,1261,1527,963
53040,8064,4024,4040,2139,1793,2606,1526
53042,6690,3313,3377,1770,1405,2102,1413
53044,2297,1086,1211,725,328,777,467
53045,21686,10280,11406,5621,3175,6926,5964
53046,1107,555,552,249,242,383,233
53047,78,39,39,20,20,24,14
53048,3364,1701,1663,887,848,999,630
53049,2451,1291,1160,573,516,829,533
53050,6986,3513,3473,1771,1561,2200,1454
53051,35651,17198,18453,8842,7401,11126,8282
53057,1928,1056,872,606,320,529,473
53058,3243,1636,1607,836,601,1139,667
53059,1767,908,859,416,356,643,352
53061,5196,2615,2581,1281,1060,1526,1329
53063,1552,821,731,390,319,549,294
53065,2226,1111,1115,621,429,766,410
53066,33830,16648,17182,9250,6876,10854,6850
53069,697,368,329,129,146,268,154
53070,4713,2374,2339,1358,933,1442,980
53072,23907,11613,12294,5983,4781,8081,5062
53073,15757,8352,7405,3750,3948,4860,3199
53074,12880,6314,6566,3158,3256,3876,2590
53075,3345,1719,1626,857,709,1155,624
53076,3648,1856,1792,1032,622,1345,649
53078,1912,995,917,470,363,728,351
53079,1413,705,708,336,282,483,312
53080,5715,2920,2795,1497,1330,1900,988
53081,43129,21397,21732,11758,11426,11595,8350
53083,20362,10073,10289,5469,4404,6452,4037
53085,11267,5534,5733,2676,2383,3586,2622
53086,8255,4096,4159,2310,1829,2797,1319
53088,379,201,178,75,100,122,82
53089,18568,9231,9337,5323,3714,6284,3247
53090,21873,10880,10993,5970,5436,6655,3812
53091,2018,1033,985,484,444,683,407
53092,20024,9634,10390,4965,2798,6727,5534
53093,1981,1006,975,539,429,643,370
53094,19169,9478,9691,5758,5067,5069,3275
53095,27139,13191,13948,6904,5991,7954,6290
53097,6319,3074,3245,2006,1311,1949,1053
53098,11965,5837,6128,2923,2569,3520,2953
53103,3724,1901,1823,910,683,1358,773
53104,5426,2711,2715,1404,1027,1906,1089
53105,29225,14464,14761,7841,6214,9496,5674
53108,3329,1717,1612,773,592,1225,739
53110,18320,8993,9327,4308,4792,5394,3826
53114,2678,1372,1306,757,658,839,424
53115,15788,7882,7906,4371,3760,4488,3169
53118,7202,3557,3645,1844,1177,2555,1626
53119,5608,2820,2788,1679,1109,2042,778
53120,9679,4860,4819,2508,2193,3049,1929
53121,19045,9599,9446,5362,4493,5764,3426
53122,5985,2754,3231,1531,703,1965,1786
53125,1895,917,978,389,250,657,599
53126,6431,3301,3130,1656,1184,2349,1242
53128,8947,4573,4374,2756,2359,2623,1209
53129,13973,6514,7459,3339,2739,3929,3966
53130,7755,3693,4062,1802,1710,2380,1863
53132,34863,17850,17013,8359,8312,11344,6848
53137,1702,873,829,450,321,602,329
53139,2802,1415,1387,718,581,1057,446
53140,30017,14806,15211,8778,8870,7363,5006
53142,32375,15780,16595,9465,8238,9341,5331
53143,23264,11343,11921,7190,6399,6172,3503
53144,27256,13570,13686,7930,8228,7300,3798
53146,7458,3759,3699,1850,1302,2608,1698
53147,16457,8125,8332,4069,3558,4969,3861
53149,19057,9559,9498,5431,3733,6577,3316
53150,24850,12249,12601,6689,4754,8556,4851
53151,31987,15420,16567,7302,6652,10571,7462
53153,2328,1167,1161,658,452,843,375
53154,34451,16931,17520,8889,9695,10328,5539
53156,2992,1488,1504,754,658,971,609
53158,15917,7873,8044,4621,3316,5404,2576
53167,399,215,184,99,94,134,72
53168,8643,4380,4263,2352,2042,2973,1276
53170,2380,1222,1158,728,571,745,336
53172,21156,10373,10783,5102,5399,6301,4354
53177,8329,5012,3317,1691,2698,2615,1325
53178,2626,1313,1313,588,551,925,562
53179,6310,3259,3051,1855,1527,2167,761
53181,7357,3711,3646,1988,1692,2392,1285
53182,9412,4569,4843,2398,2039,3169,1806
53183,2815,1412,1403,787,481,1058,489
53184,4271,2066,2205,1248,958,1219,846
53185,18551,9393,9158,5116,3514,6629,3292
53186,33592,16231,17361,8467,10399,8735,5991
53188,35195,17499,17696,8976,9719,10196,6304
53189,26228,13036,13192,7414,5912,8680,4222
53190,19200,9778,9422,5358,7757,3492,2593
53191,2842,1381,1461,692,574,830,746
53192,217,118,99,53,42,78,44
53195,114,59,55,25,17,34,38
53202,23386,12415,10971,1589,13541,4362,3894
53203,938,521,417,57,593,222,66
53204,42355,22148,20207,15889,14789,8481,3196
53205,10050,4559,5491,3969,2629,2211,1241
53206,28210,13003,15207,10912,6993,6539,3766
53207,35149,17536,17613,7517,11992,10068,5572
53208,31133,15096,16037,10436,9501,8059,3137
53209,46917,21276,25641,15077,11653,12131,8056
53210,28126,12945,15181,10565,8039,6882,2640
53211,35406,17711,17695,7849,15557,6949,5051
53212,30416,14961,15455,8881,11550,6824,3161
53213,26020,12254,13766,6098,7772,7541,4609
53214,34725,17244,17481,8155,11218,9537,5815
53215,60953,30559,30394,22259,19491,13071,6132
53216,32264,14235,18029,10978,8084,8726,4476
53217,29192,14008,15184,7859,5533,9204,6596
53218,40625,18547,22078,15452,10934,9695,4544
53219,33880,16536,17344,7790,9946,9538,6606
53220,26303,12575,13728,5539,7154,7281,6329
53221,37701,18295,19406,9396,10016,10003,8286
53222,25165,11581,13584,6356,7345,6880,4584
53223,29230,13258,15972,7978,7199,7623,6430
53224,21284,9875,11409,7526,5884,5046,2828
53225,25706,11703,14003,8725,7234,6022,3725
53226,18370,8587,9783,4294,5076,4759,4241
53227,23357,11215,12142,4847,6818,6366,5326
53228,14369,6755,7614,3027,3325,4155,3862
53233,16453,9160,7293,4237,9237,2213,766
53235,9270,4515,4755,1660,2744,2720,2146
53295,359,337,22,0,45,205,109
53402,33174,16053,17121,9192,7785,9783,6414
53403,27432,13620,13812,8171,7581,7357,4323
53404,15658,7910,7748,5174,4431,3848,2205
53405,25193,12184,13009,6860,6548,7180,4605
53406,25845,12181,13664,6225,5681,7467,6472
53501,23,14,9,7,6,10,0
53502,2421,1228,1193,611,561,771,478
53503,1947,998,949,512,474,635,326
53504,2084,1078,1006,534,415,673,462
53505,354,187,167,93,62,128,71
53506,1125,574,551,280,242,342,261
53507,2196,1115,1081,639,565,674,318
53508,5262,2657,2605,1503,1282,1684,793
53510,1482,712,770,442,350,383,307
53511,48929,23670,25259,14334,12399,13097,9099
53515,2268,1160,1108,527,449,800,492
53516,2152,1085,1067,567,425,736,424
53517,1752,870,882,479,318,665,290
53518,1330,699,631,315,247,425,343
53520,6810,3342,3468,1795,1393,2086,1536
53521,3656,1884,1772,1025,791,1299,541
53522,1085,552,533,287,225,360,213
53523,4949,2495,2454,1213,919,1807,1010
53525,4052,2005,2047,1195,870,1181,806
53526,565,287,278,141,133,177,114
53527,9963,4972,4991,3106,2266,3278,1313
53528,5734,2890,2844,1571,1250,1912,1001
53529,2031,1093,938,586,509,631,305
53530,4566,2337,2229,1310,1010,1280,966
53531,4338,2259,2079,1190,1095,1426,627
53532,13606,6658,6948,3997,3284,4285,2040
53533,7276,3537,3739,2020,1574,2199,1483
53534,11512,5857,5655,3053,2670,3537,2252
53536,8503,4246,4257,2537,2059,2495,1412
53537,781,371,410,197,176,225,183
53538,18468,9150,9318,4627,4358,5610,3873
53540,169,92,77,55,44,44,26
53541,861,447,414,206,174,306,175
53543,1641,843,798,412,351,523,355
53544,800,403,397,211,156,268,165
53545,23117,11396,11721,5893,6187,6297,4740
53546,30648,15008,15640,8219,7790,8734,5905
53548,18558,9234,9324,5220,4636,5503,3199
53549,10414,5202,5212,2712,2593,2915,2194
53550,1239,616,623,342,256,421,220
53551,8273,4061,4212,2145,2024,2436,1668
53553,624,310,314,199,140,183,102
53554,1134,564,570,365,266,288,215
53555,8465,4270,4195,2258,1610,2863,1734
53556,2594,1363,1231,707,575,786,526
53557,482,253,229,115,104,177,86
53558,10742,5323,5419,2929,2308,3674,1831
53559,6063,3116,2947,1836,1406,1859,962
53560,3458,1764,1694,864,767,1193,634
53561,1618,825,793,285,264,574,495
53562,23627,11473,12154,5878,5990,7310,4449
53563,10728,5349,5379,2966,2483,3311,1968
53565,4765,2387,2378,1266,976,1447,1076
53566,15217,7402,7815,3819,3345,4419,3634
53569,1155,596,559,323,250,361,221
53570,2627,1322,1305,674,542,893,518
53571,280,150,130,74,76,91,39
53572,9970,4877,5093,3012,2217,3060,1681
53573,3062,1531,1531,726,677,917,742
53574,3877,1929,1948,1071,806,1226,774
53575,15494,7961,7533,4188,3567,5364,2375
53576,2319,1127,1192,689,481,729,420
53577,1371,708,663,356,296,437,282
53578,5924,2876,3048,1634,1432,1702,1156
53579,1760,911,849,485,360,593,322
53580,564,275,289,167,126,168,103
53581,10699,5228,5471,2803,2271,2988,2637
53582,1079,571,508,267,252,367,193
53583,5747,2814,2933,1495,1256,1785,1211
53585,2215,1126,1089,647,541,668,359
53586,2284,1152,1132,656,467,702,459
53587,1290,678,612,356,248,424,262
53588,4077,2037,2040,1000,776,1315,986
53589,19427,9435,9992,4990,4203,6321,3913
53590,36294,17736,18558,10815,10432,10100,4947
53593,19225,9510,9715,5678,4178,6461,2908
53594,5144,2602,2542,1380,1198,1633,933
53597,16844,8244,8600,5238,3180,5442,2984
53598,2511,1238,1273,686,710,723,392
53599,69,36,33,14,16,19,20
53702,50,24,26,2,2,12,34
53703,27958,14990,12968,2532,20517,3259,1650
53704,44034,21600,22434,9547,15178,12635,6674
53705,23494,11133,12361,4331,8109,5806,5248
53706,5133,2427,2706,4058,1074,0,1
53711,45728,22167,23561,11609,13226,12712,8181
53713,22146,11329,10817,6291,8884,4883,2088
53714,16463,8063,8400,3825,5076,4694,2868
53715,12136,6329,5807,2261,7793,1317,765
53716,18419,8951,9468,4004,4560,5796,4059
53717,11962,5642,6320,2541,3705,3284,2432
53718,11753,5519,6234,2616,3971,2864,2302
53719,28487,13905,14582,6750,12467,6474,2796
53726,5177,2694,2483,721,3101,797,558
53792,0,0,0,0,0,0,0
53801,878,455,423,185,139,282,272
53802,58,31,27,9,10,15,24
53803,1306,661,645,356,279,381,290
53804,1372,700,672,403,286,375,308
53805,5269,2850,2419,1256,1362,1558,1093
53806,1831,946,885,432,318,557,524
53807,4843,2416,2427,1308,1031,1379,1125
53808,1049,520,529,267,249,258,275
53809,4120,2098,2022,1262,972,1059,827
53810,429,219,210,110,68,148,103
53811,3371,1592,1779,829,676,952,914
53813,6075,2969,3106,1590,1331,1696,1458
53816,810,454,356,251,165,251,143
53817,205,110,95,56,46,55,48
53818,15091,8324,6767,4212,5828,2789,2262
53820,2532,1309,1223,638,491,808,595
53821,8456,4394,4062,1995,1879,2485,2097
53825,487,262,225,145,97,155,90
53826,1332,679,653,399,283,423,227
53827,292,163,129,79,62,88,63
53901,14445,7657,6788,3352,3768,4301,3024
53910,3508,1693,1815,847,647,1001,1013
53911,1351,684,667,348,390,382,231
53913,19881,9867,10014,4919,5093,5685,4184
53916,22507,11102,11405,6046,5200,6495,4766
53919,2629,1358,1271,762,532,856,479
53920,414,207,207,74,60,140,140
53922,1036,527,509,257,194,394,191
53923,2098,1082,1016,678,447,600,373
53924,1360,715,645,351,250,439,320
53925,7781,3854,3927,1993,1856,2375,1557
53926,1628,817,811,667,335,369,257
53928,128,67,61,37,36,36,19
53929,2782,1408,1374,719,592,779,692
53930,1285,656,629,334,276,427,248
53931,237,121,116,61,66,66,44
53932,2573,1284,1289,781,633,771,388
53933,4117,2792,1325,563,1447,1311,796
53934,4396,2221,2175,829,711,1316,1540
53935,307,151,156,84,87,74,62
53936,1610,837,773,384,293,502,431
53937,1053,557,496,321,223,302,207
53939,244,135,109,53,60,79,52
53941,2932,1506,1426,756,605,861,710
53943,1065,539,526,296,224,318,227
53944,2224,1148,1076,498,529,688,509
53946,4386,2184,2202,1107,841,1236,1202
53947,137,68,69,22,15,46,54
53948,8414,4277,4137,1999,1883,2596,1936
53949,6011,3086,2925,1194,1009,1911,1897
53950,5449,3267,2182,1018,1339,1747,1345
53951,2601,1368,1233,750,639,799,413
53952,4377,2858,1519,633,1496,1332,916
53953,282,141,141,77,62,92,51
53954,6926,3512,3414,1826,1458,2148,1494
53955,5692,2896,2796,1423,1181,1917,1171
53956,3397,1704,1693,950,689,984,774
53959,13384,6562,6822,3701,3227,3750,2706
53960,3268,1650,1618,798,720,1109,641
53961,837,420,417,224,173,278,162
53963,13910,8270,5640,2973,4540,4016,2381
53964,3604,1779,1825,886,694,1097,927
53965,10398,5235,5163,2398,2490,3097,2413
53968,2329,1162,1167,574,481,733,541
53969,419,181,238,68,87,75,189
54001,8155,3981,4174,2044,1538,2423,2150
54002,6278,3107,3171,1824,1729,1733,992
54003,1013,522,491,265,202,367,179
54004,2317,1193,1124,676,528,702,411
54005,3056,1575,1481,854,683,975,544
54006,743,375,368,162,162,230,189
54007,1188,617,571,302,261,419,206
54009,2509,1279,1230,722,624,735,428
54010,50,36,14,7,19,15,9
54011,6819,3426,3393,1910,1662,1978,1269
54013,3475,1770,1705,991,804,1083,597
54014,2232,1156,1076,538,478,759,457
54015,3586,1796,1790,1165,1086,911,424
54016,30108,14961,15147,8897,7258,9516,4437
54017,16743,8386,8357,4933,4584,4745,2481
54020,7260,3611,3649,2128,1708,2274,1150
54021,6622,3373,3249,1883,1617,2142,980
54022,22358,10764,11594,6214,7689,5597,2858
54023,3833,1936,1897,1154,1090,1124,465
54024,4811,2353,2458,1172,952,1561,1126
54025,6864,3471,3393,2167,1891,2063,743
54026,1809,941,868,487,395,603,324
54027,989,527,462,249,230,322,188
54028,2493,1270,1223,721,578,714,480
54082,1696,892,804,451,330,605,310
54101,2751,1410,1341,700,557,1058,436
54102,875,456,419,150,108,311,306
54103,418,213,205,100,64,135,119
54104,1051,549,502,157,103,308,483
54106,4997,2598,2399,1384,1165,1599,849
54107,3727,1913,1814,1117,834,1086,690
54110,5338,2683,2655,1477,1269,1562,1030
54111,2132,1069,1063,445,372,708,607
54112,2284,1164,1120,586,520,681,497
54113,3325,1663,1662,1007,721,941,656
54114,5178,2638,2540,922,809,1551,1896
54115,41178,19987,21191,11986,11201,11674,6317
54119,1083,528,555,276,466,189,152
54120,245,133,112,33,37,88,87
54121,2982,1526,1456,587,467,1039,889
54123,238,107,131,72,61,67,38
54124,3881,1972,1909,940,809,1204,928
54125,519,269,250,81,78,182,178
54126,3625,1877,1748,1051,843,1152,579
54127,76,34,42,28,22,16,10
54128,1778,879,899,441,353,505,479
54129,3477,1795,1682,927,691,1137,722
54130,25108,12574,12534,7111,6700,7317,3980
54135,3096,1550,1546,1134,691,765,506
54136,6406,3114,3292,1697,1646,1747,1316
54137,1115,565,550,310,241,332,232
54138,821,419,402,119,99,248,355
54139,3096,1620,1476,809,669,1015,603
54140,8533,4248,4285,2324,2313,2472,1424
54141,2549,1329,1220,652,549,939,409
54143,15225,7369,7856,3711,3337,4648,3529
54149,1184,612,572,163,171,353,497
54150,1037,483,554,397,250,270,120
54151,3556,1776,1780,834,670,1216,836
54153,7252,3629,3623,1848,1604,2250,1550
54154,5548,2738,2810,1438,1341,1633,1136
54155,5451,2723,2728,1695,1030,1706,1020
54156,1535,800,735,317,241,498,479
54157,5986,2923,3063,1493,1248,1782,1463
54159,1434,749,685,321,252,482,379
54160,253,127,126,76,57,70,50
54161,2696,1384,1312,607,512,788,789
54162,9065,4592,4473,2819,2039,2840,1367
54165,7539,3770,3769,2186,1748,2338,1267
54166,17002,8289,8713,4013,3602,4856,4531
54169,2600,1297,1303,761,535,890,414
54170,3730,1944,1786,1005,807,1243,675
54171,3362,1730,1632,1044,640,1302,376
54173,4095,2104,1991,1146,842,1503,604
54174,3013,1533,1480,648,511,950,904
54175,1018,543,475,133,89,311,485
54177,2898,1483,1415,616,468,913,901
54180,2861,1468,1393,960,782,784,335
54201,5345,2657,2688,1207,1073,1654,1411
54202,1240,619,621,180,176,383,501
54204,1819,925,894,476,346,597,400
54205,2177,1106,1071,638,487,647,405
54207,176,94,82,48,46,51,31
54208,6061,3116,2945,1661,1306,1979,1115
54209,1195,610,585,202,167,380,446
54210,897,428,469,143,124,231,399
54211,277,128,149,44,33,70,130
54212,997,487,510,166,132,297,402
54213,1276,637,639,334,270,425,247
54214,334,166,168,93,72,104,65
54216,6276,3236,3040,1488,1330,1893,1565
54217,7405,3763,3642,2089,1688,2184,1444
54220,40220,19590,20630,9766,8961,11812,9681
54227,1568,823,745,402,299,586,281
54228,2682,1380,1302,626,510,908,638
54229,4306,2166,2140,1171,936,1464,735
54230,4782,2488,2294,1309,976,1618,879
54232,779,391,388,191,180,230,178
54234,1614,732,882,214,173,422,805
54235,17203,8479,8724,3627,3284,5481,4811
54241,14884,7377,7507,3524,3078,4657,3625
54245,2259,1130,1129,614,475,707,463
54246,708,346,362,116,70,200,322
54247,2339,1212,1127,578,445,839,477
54301,22742,11281,11461,5858,6161,6411,4312
54302,30611,15230,15381,9125,9588,7297,4601
54303,27041,13086,13955,7227,8507,6737,4570
54304,28153,13653,14500,6748,7790,7705,5910
54307,1092,1089,3,43,797,229,23
54311,33580,16458,17122,9447,9647,9431,5055
54313,35897,17849,18048,10443,7303,12412,5739
54401,30702,15235,15467,7956,7632,8757,6357
54403,24272,12061,12211,6255,5937,6836,5244
54405,3032,1531,1501,886,724,729,693
54406,3469,1760,1709,976,730,1131,632
54407,1515,795,720,350,289,545,331
54408,1068,549,519,269,238,351,210
54409,13238,6528,6710,3329,2834,3833,3242
54410,2392,1200,1192,695,538,731,428
54411,5406,2803,2603,1679,1164,1590,973
54412,2181,1149,1032,600,471,705,405
54413,191,105,86,35,29,60,67
54414,3404,1777,1627,921,749,1036,698
54416,1684,833,851,461,351,473,399
54417,46,27,19,5,8,16,17
54418,1080,560,520,264,197,408,211
54420,1307,699,608,438,305,357,207
54421,3455,1732,1723,1039,819,898,699
54422,1209,630,579,449,316,261,183
54423,2343,1210,1133,605,451,832,455
54424,1651,854,797,315,261,583,492
54425,2036,1063,973,626,543,532,335
54426,4479,2297,2182,1365,1010,1292,812
54427,1099,583,516,241,252,378,228
54428,1127,568,559,204,179,306,438
54430,135,70,65,23,25,52,35
54433,1845,960,885,517,335,542,451
54435,2010,1046,964,470,333,702,505
54436,2203,1113,1090,787,431,603,382
54437,3077,1558,1519,1027,641,791,618
54440,2964,1537,1427,723,687,970,584
54441,828,408,420,244,156,306,122
54442,1177,688,489,360,180,377,260
54443,2137,1070,1067,556,444,719,418
54446,3123,1622,1501,1094,695,770,564
54447,498,283,215,128,97,154,119
54448,4249,2142,2107,1098,813,1461,877
54449,26418,12779,13639,6400,6189,7799,6030
54450,436,223,213,117,118,106,95
54451,11755,5934,5821,3106,2528,3629,2492
54452,19360,9596,9764,4918,4087,6018,4337
54454,1279,677,602,363,272,433,211
54455,17029,8621,8408,4657,3864,5405,3103
54456,6085,3053,3032,1559,1172,1800,1554
54457,8539,4338,4201,1938,1445,2566,2590
54458,124,62,62,40,17,42,25
54459,1148,595,553,251,205,348,344
54460,2746,1364,1382,873,536,691,646
54462,348,182,166,59,58,112,119
54463,684,363,321,100,92,263,229
54465,536,275,261,60,51,174,251
54466,2815,1453,1362,705,569,886,655
54467,13635,6723,6912,3727,3707,3951,2250
54469,1792,852,940,476,346,479,491
54470,2068,1053,1015,523,412,601,532
54471,1854,934,920,488,351,712,303
54473,2700,1395,1305,697,546,887,570
54474,4019,1977,2042,988,898,1199,934
54475,1482,773,709,385,281,479,337
54476,18580,9260,9320,5349,4922,5131,3178
54479,4119,2050,2069,1236,1018,1172,693
54480,1332,678,654,394,317,363,258
54481,29340,14380,14960,7108,11195,6097,4940
54482,8955,4532,4423,2279,1840,2981,1855
54484,4984,2546,2438,1466,1109,1498,911
54485,322,179,143,70,59,97,96
54486,2290,1156,1134,513,438,742,597
54487,9594,4799,4795,1977,1541,3253,2823
54488,1262,657,605,453,281,339,189
54489,1550,786,764,408,351,465,326
54490,893,455,438,184,219,301,189
54491,1652,878,774,299,236,549,568
54493,668,351,317,137,105,217,209
54494,27126,13341,13785,6514,5307,8556,6749
54495,7637,3762,3875,2027,1815,2215,1580
54498,2421,1233,1188,803,485,704,429
54499,3223,1599,1624,863,661,921,778
54501,20019,9896,10123,4527,4145,6397,4950
54511,1216,652,564,281,239,367,329
54512,833,427,406,127,88,278,340
54513,478,247,231,92,85,152,149
54514,1717,894,823,363,270,609,475
54515,472,248,224,103,83,174,112
54517,112,62,50,3,12,40,57
54519,1231,643,588,232,184,374,441
54520,4141,2077,2064,1135,888,1131,987
54521,7509,3817,3692,1390,1276,2382,2461
54524,670,348,322,140,105,229,196
54525,279,125,154,68,61,85,65
54526,919,474,445,275,191,265,188
54527,1081,554,527,241,201,323,316
54529,1133,588,545,180,172,387,394
54530,868,488,380,153,182,307,226
54531,1454,753,701,268,195,482,509
54534,2459,1188,1271,482,419,772,786
54536,184,88,96,38,28,69,49
54537,561,290,271,139,111,170,141
54538,3137,1590,1547,993,660,777,707
54539,1383,774,609,208,202,475,498
54540,931,493,438,145,116,305,365
54541,1552,812,740,401,336,413,402
54542,470,242,228,47,51,168,204
54545,736,373,363,91,82,232,331
54546,1266,651,615,293,242,392,339
54547,1392,713,679,172,156,442,622
54548,4626,2271,2355,836,756,1443,1591
54550,685,363,322,164,120,240,161
54552,4416,2222,2194,878,674,1448,1416
54554,1110,556,554,158,155,321,476
54555,4872,2463,2409,981,827,1619,1445
54556,1298,636,662,339,263,408,288
54557,925,460,465,114,84,251,476
54558,2177,1105,1072,371,335,628,843
54559,795,404,391,243,174,219,159
54560,589,301,288,111,84,202,192
54561,35,18,17,3,2,11,19
54562,1948,986,962,346,304,588,710
54563,720,374,346,175,135,210,200
54564,387,221,166,53,55,141,138
54565,60,34,26,12,11,22,15
54566,1496,719,777,387,291,410,408
54568,5198,2536,2662,1028,837,1557,1776
54601,49282,23527,25755,11787,17319,11053,9123
54603,14305,7170,7135,3356,4214,4022,2713
54610,1624,846,778,300,300,531,493
54611,1307,640,667,409,305,339,254
54612,5152,2697,2455,1481,1302,1430,939
54613,1826,989,837,296,266,571,693
54614,2947,1529,1418,844,637,889,577
54615,10742,5904,4838,2507,2756,3101,2378
54616,2601,1303,1298,715,536,697,653
54618,2262,1140,1122,621,494,655,492
54619,3923,1959,1964,1501,876,940,606
54621,1147,578,569,331,198,375,243
54622,2121,1066,1055,456,421,653,591
54623,1930,1006,924,520,370,601,439
54624,1383,722,661,316,229,477,361
54625,240,131,109,51,61,87,41
54626,1215,643,572,303,218,395,299
54627,1819,939,880,437,349,591,442
54628,1092,566,526,218,156,347,371
54629,2576,1345,1231,606,536,791,643
54630,3770,1877,1893,948,794,1226,802
54631,1844,914,930,467,317,550,510
54632,1247,652,595,352,208,405,282
54634,4258,2142,2116,1444,853,1126,835
54635,1799,928,871,424,358,592,425
54636,13737,6854,6883,4350,3377,4015,1995
54637,187,85,102,49,35,48,55
54638,1487,767,720,431,267,436,353
54639,2397,1234,1163,649,527,655,566
54641,2,1,1,0,0,2,0
54642,2125,1094,1031,596,420,657,452
54643,12,5,7,1,3,1,7
54644,1434,750,684,393,315,448,278
54645,81,41,40,24,17,26,14
54646,3899,1974,1925,1045,668,1157,1029
54648,1737,888,849,585,393,474,285
54650,23377,11397,11980,6284,5630,6676,4787
54651,1382,695,687,457,282,352,291
54652,953,466,487,254,185,279,235
54653,894,476,418,262,207,301,124
54654,153,79,74,40,35,39,39
54655,1778,885,893,404,334,530,510
54656,17377,8759,8618,4679,4087,5130,3481
54657,411,220,191,131,91,128,61
54658,2501,1268,1233,618,413,895,575
54659,1409,722,687,426,332,388,263
54660,15688,7932,7756,4272,3614,4580,3222
54661,3415,1727,1688,825,805,1066,719
54664,1516,755,761,416,273,449,378
54665,8427,4073,4354,2159,1686,2408,2174
54666,2593,1362,1231,625,515,855,598
54667,4599,2299,2300,1365,903,1327,1004
54669,7619,3700,3919,2144,1671,2292,1512
54670,1878,975,903,762,380,467,269
54701,38803,18298,20505,10499,11962,9044,7298
54703,42272,21321,20951,10021,15091,10486,6674
54720,7039,3324,3715,1898,1813,1865,1463
54721,1373,733,640,346,293,433,301
54722,4016,2044,1972,1231,861,1085,839
54723,1191,602,589,298,257,400,236
54724,7174,3533,3641,1938,1637,2081,1518
54725,2897,1451,1446,738,658,896,605
54726,1690,874,816,478,373,509,330
54727,4915,2509,2406,1392,1060,1492,971
54728,6139,3036,3103,1345,1152,1881,1761
54729,31469,15999,15470,8109,7726,9333,6301
54730,4903,2477,2426,1273,1021,1562,1047
54731,802,409,393,261,131,239,171
54732,2924,1504,1420,743,592,878,711
54733,1340,697,643,353,279,399,309
54734,856,441,415,214,179,287,176
54736,4127,2088,2039,1090,853,1289,895
54737,487,251,236,109,88,148,142
54738,3149,1629,1520,886,588,1027,648
54739,4950,2565,2385,1523,1225,1524,678
54740,2056,1068,988,487,482,590,497
54741,1577,793,784,456,322,435,364
54742,4459,2214,2245,1255,876,1427,901
54745,2261,1162,1099,474,350,703,734
54746,746,393,353,204,179,205,158
54747,2534,1337,1197,657,623,775,479
54748,1217,635,582,293,250,427,247
54749,1231,656,575,309,255,420,247
54750,1062,547,515,268,195,358,241
54751,25642,12833,12809,6695,9303,5459,4185
54754,1552,781,771,332,293,488,439
54755,7502,3671,3831,2105,1582,2212,1603
54756,916,472,444,195,158,295,268
54757,3314,1717,1597,893,683,977,761
54758,4626,2313,2313,1284,999,1314,1029
54759,1533,757,776,302,260,477,494
54760,255,119,136,37,40,68,110
54761,1216,624,592,306,248,352,310
54762,1246,608,638,318,272,357,299
54763,1134,565,569,300,237,348,249
54765,24,12,12,2,5,7,10
54766,1707,869,838,515,329,508,355
54767,3221,1638,1583,853,715,1049,604
54768,5990,3769,2221,1356,1896,1724,1014
54769,502,269,233,95,81,178,148
54770,2101,1104,997,589,425,639,448
54771,4286,2112,2174,1391,958,1080,857
54772,1103,580,523,323,255,346,179
54773,3336,1674,1662,905,687,988,756
54801,6493,3168,3325,1503,1213,1962,1815
54805,1471,764,707,398,340,415,318
54806,11810,5836,5974,3042,2853,3425,2490
54810,2512,1299,1213,530,488,793,701
54812,5728,2939,2789,1486,1388,1582,1272
54813,601,327,274,129,101,208,163
54814,2478,1243,1235,610,465,764,639
54817,2188,1118,1070,396,318,706,768
54819,2544,1281,1263,567,402,837,738
54820,864,462,402,213,142,289,220
54821,1276,678,598,179,159,443,495
54822,4516,2229,2287,1215,1086,1296,919
54824,2271,1154,1117,604,482,731,454
54826,807,408,399,169,135,261,242
54827,221,112,109,20,24,83,94
54828,678,352,326,166,138,196,178
54829,5236,2617,2619,1242,956,1498,1540
54830,2752,1409,1343,413,340,772,1227
54832,412,214,198,87,43,155,127
54835,1018,522,496,211,164,354,289
54836,1080,577,503,277,227,370,206
54837,3778,1916,1862,879,692,1214,993
54838,1103,609,494,154,170,376,403
54839,302,154,148,66,46,109,81
54840,4643,2356,2287,1187,889,1452,1115
54841,259,135,124,67,74,70,48
54842,185,96,89,48,40,80,17
54843,11487,5699,5788,2837,2187,3401,3062
54844,267,148,119,36,20,85,126
54845,147,68,79,25,24,49,49
54846,547,284,263,139,129,155,124
54847,2222,1140,1082,450,361,778,633
54848,6141,2963,3178,1541,1194,1775,1631
54849,1967,1027,940,484,306,695,482
54850,261,143,118,43,52,95,71
54853,4009,2014,1995,956,754,1234,1065
54854,990,492,498,272,198,328,192
54855,774,408,366,305,168,176,125
54856,1616,851,765,433,305,486,392
54857,62,34,28,3,14,29,16
54858,1518,774,744,381,347,424,366
54859,1896,978,918,391,277,573,655
54861,150,62,88,43,48,41,18
54862,261,140,121,47,41,84,89
54864,1322,669,653,369,301,411,241
54865,440,233,207,62,54,158,166
54867,435,232,203,105,70,147,113
54868,15512,7531,7981,3765,3513,4432,3802
54870,1486,767,719,270,226,483,507
54871,3105,1490,1615,779,598,859,869
54872,2581,1293,1288,587,487,766,741
54873,2799,1446,1353,570,449,883,897
54874,3646,1871,1775,968,720,1216,742
54875,1055,574,481,187,202,369,297
54876,1551,813,738,325,247,467,512
54880,30772,15147,15625,7573,8868,8408,5923
54888,1345,676,669,243,218,460,424
54889,2742,1394,1348,648,580,822,692
54891,3389,1697,1692,730,601,1190,868
54893,3767,1869,1898,830,622,1126,1189
54895,910,481,429,183,154,314,259
54896,1478,768,710,241,185,467,585
54901,37710,19867,17843,9099,14317,9006,5288
54902,22375,10912,11463,5132,5942,6019,5282
54904,20623,10078,10545,5383,4358,6659,4223
54909,2181,1162,1019,572,457,706,446
54911,26674,13206,13468,6785,7693,6937,5259
54913,17629,8812,8817,5065,4183,5768,2613
54914,30475,14985,15490,7761,8903,8428,5383
54915,41855,20684,21171,12600,10655,12621,5979
54921,1326,701,625,348,296,456,226
54922,1514,805,709,416,318,503,277
54923,8733,4339,4394,2344,1855,2606,1928
54927,538,268,270,139,116,181,102
54928,450,230,220,113,117,116,104
54929,8746,4317,4429,2186,1873,2579,2108
54930,1786,940,846,454,335,484,513
54931,260,129,131,73,68,80,39
54932,1185,582,603,324,226,384,251
54933,231,126,105,61,38,70,62
54934,148,83,65,36,31,48,33
54935,41651,20199,21452,10718,11481,10981,8471
54937,19112,9203,9909,4554,4277,6208,4073
54940,4020,2093,1927,857,723,1437,1003
54941,2613,1326,1287,465,447,840,861
54942,8580,4311,4269,2767,2056,2762,995
54943,1923,965,958,379,325,585,634
54944,8257,4147,4110,2446,1712,2831,1268
54945,3545,1769,1776,797,627,1124,997
54946,108,76,32,0,2,3,103
54947,2601,1344,1257,621,457,970,553
54948,320,165,155,89,52,106,73
54949,3430,1768,1662,912,814,1023,681
54950,3083,1517,1566,778,650,897,758
54952,25729,12769,12960,6946,6912,7397,4474
54956,42696,21016,21680,11423,10825,13114,7334
54960,2800,1442,1358,491,419,927,963
54961,14266,7239,7027,3801,3215,4503,2747
54962,1110,569,541,252,198,378,282
54963,6917,3516,3401,1868,1501,2171,1377
54964,1022,531,491,233,184,390,215
54965,1344,682,662,292,222,475,355
54966,2008,996,1012,569,450,569,420
54967,434,209,225,111,90,145,88
54968,2779,1395,1384,568,459,923,829
54970,3902,2461,1441,644,1111,1298,849
54971,10827,5267,5560,2813,2632,2991,2391
54974,1581,774,807,452,346,492,291
54977,1337,695,642,333,241,443,320
54979,1472,755,717,338,281,532,321
54980,149,74,75,28,24,64,33
54981,15426,7819,7607,3560,3099,4484,4283
54982,7117,3618,3499,1667,1385,2002,2063
54983,4642,2373,2269,1224,949,1462,1007
54984,2989,1462,1527,533,422,951,1083
54985,836,784,52,32,364,399,41
54986,4770,2378,2392,1119,796,1683,1172
57717,70,41,29,12,9,26,23
82001,35484,17619,17865,9587,11003,8940,5954
82005,417,318,99,88,327,2,0
82007,19096,9673,9423,5665,5625,4993,2813
82009,31703,15690,16013,8104,6571,9994,7034
82050,401,203,198,128,91,113,69
82051,60,32,28,14,10,21,15
82052,23,12,11,4,0,14,5
82053,1524,765,759,399,324,526,275
82054,920,469,451,279,196,287,158
82055,285,156,129,37,29,105,114
82058,52,31,21,7,7,21,17
82059,135,69,66,20,13,53,49
82060,372,188,184,109,88,112,63
82061,39,22,17,3,6,22,8
82063,71,35,36,8,14,20,29
82070,19766,10250,9516,5244,7680,4167,2675
82072,15533,8102,7431,3322,7609,2806,1796
82073,72,43,29,72,0,0,0
82081,60,35,25,12,15,10,23
82082,1587,824,763,411,300,493,383
82083,373,202,171,97,61,129,86
82084,16,8,8,3,2,4,7
82190,369,198,171,56,87,188,38
82201,6467,3214,3253,1438,1215,1937,1877
82210,399,201,198,108,52,128,111
82212,474,258,216,90,69,154,161
82213,513,262,251,84,60,195,174
82214,1302,632,670,306,255,384,357
82215,132,69,63,18,23,48,43
82217,107,50,57,24,13,32,38
82219,48,26,22,8,4,14,22
82221,635,330,305,195,210,116,114
82222,107,68,39,18,15,41,33
82223,996,486,510,239,178,312,267
82224,23,10,13,5,4,4,10
82225,2067,930,1137,426,497,640,504
82227,241,130,111,52,32,56,101
82229,74,33,41,11,14,25,24
82240,10235,5357,4878,2454,2335,2817,2629
82242,39,18,21,6,7,12,14
82243,187,98,89,50,34,66,37
82244,478,254,224,103,71,180,124
82301,9584,5242,4342,2655,2850,2683,1396
82321,717,378,339,193,160,235,129
82322,106,58,48,20,23,34,29
82323,186,101,85,42,50,52,42
82324,268,132,136,63,49,84,72
82325,878,470,408,151,133,296,298
82327,929,477,452,247,213,244,225
82329,359,193,166,79,68,99,113
82331,2286,1189,1097,466,412,782,626
82332,97,62,35,17,30,33,17
82334,501,264,237,131,113,163,94
82335,21,11,10,2,2,10,7
82336,498,288,210,135,121,181,61
82401,7866,3910,3956,2218,1628,2192,1828
82410,1760,893,867,378,326,503,553
82411,664,352,312,273,108,161,122
82412,626,318,308,202,140,151,133
82414,15011,7402,7609,3323,3057,4627,4004
82420,783,388,395,258,156,207,162
82421,448,233,215,127,80,130,111
82422,105,55,50,34,29,17,25
82423,233,121,112,54,50,60,69
82426,2644,1351,1293,686,516,822,620
82428,139,73,66,20,30,43,46
82430,100,41,59,34,29,25,12
82431,3552,1728,1824,1076,761,844,871
82432,315,165,150,84,57,96,78
82433,789,412,377,175,147,242,225
82434,156,86,70,50,31,39,36
82435,11738,5864,5874,3195,2846,3061,2636
82440,145,69,76,39,37,34,35
82441,250,131,119,42,39,83,86
82442,732,377,355,145,131,203,253
82443,4697,2329,2368,1020,852,1408,1417
82450,177,91,86,13,20,64,80
82501,19408,9741,9667,5663,4862,5117,3766
82510,423,203,220,155,116,91,61
82512,210,115,95,50,46,54,60
82513,1879,974,905,298,294,680,607
82514,1645,778,867,629,435,340,241
82515,446,221,225,119,103,137,87
82516,496,248,248,154,97,142,103
82520,13535,6689,6846,3711,3097,3901,2826
82523,868,443,425,207,156,271,234
82601,27400,13836,13564,7374,7999,7482,4545
82604,25882,13133,12749,6728,6676,7639,4839
82609,15730,7764,7966,4161,4139,4348,3082
82620,210,108,102,33,31,71,75
82630,10,7,3,3,5,1,1
82633,9592,4838,4754,2712,2334,2880,1666
82635,207,115,92,41,35,77,54
82636,3981,2024,1957,1162,1136,1126,557
82637,4136,2134,2002,1111,895,1170,960
82638,17,9,8,4,0,5,8
82639,805,424,381,192,179,246,188
82640,29,16,13,1,3,15,10
82642,94,51,43,8,16,40,30
82643,469,235,234,157,124,137,51
82644,1480,722,758,412,395,386,287
82646,20,9,11,7,3,4,6
82648,56,27,29,14,13,17,12
82649,1120,569,551,292,238,339,251
82701,5425,2888,2537,1255,1302,1629,1239
82710,243,124,119,39,33,68,103
82711,110,59,51,29,12,36,33
82712,264,145,119,64,59,75,66
82714,95,49,46,10,18,34,33
82715,0,0,0,0,0,0,0
82716,18747,9856,8891,5463,5863,5284,2137
82718,23003,12020,10983,7382,7067,6646,1908
82720,955,509,446,255,171,320,209
82721,3078,1564,1514,922,697,926,533
82723,278,143,135,64,42,107,65
82725,207,107,100,39,34,81,53
82727,1838,1003,835,579,485,549,225
82729,2251,1144,1107,501,425,663,662
82730,1566,797,769,409,352,486,319
82731,135,73,62,27,23,49,36
82732,2154,1174,980,723,579,720,132
82801,24546,12250,12296,6129,5837,7139,5441
82831,216,121,95,55,37,76,48
82832,618,320,298,135,107,244,132
82833,225,118,107,34,31,85,75
82834,7585,3843,3742,1820,1592,2177,1996
82835,318,153,165,80,59,117,62
82836,1073,535,538,279,192,363,239
82837,29,13,16,9,6,7,7
82838,268,139,129,52,32,118,66
82839,1153,582,571,361,270,303,219
82842,843,429,414,131,114,290,308
82844,35,16,19,7,4,8,16
82845,37,19,18,6,7,17,7
82901,27971,14624,13347,8321,8832,7336,3482
82922,257,131,126,32,44,100,81
82923,558,304,254,120,150,183,105
82925,304,172,132,50,48,114,92
82929,70,34,36,27,29,12,2
82930,14579,7342,7237,4683,3862,4077,1957
82932,836,419,417,251,197,259,129
82933,759,379,380,215,165,242,137
82934,185,103,82,47,46,61,31
82935,13121,6776,6345,4036,3452,3793,1840
82936,49,25,24,15,6,18,10
82937,3654,1859,1795,1286,866,999,503
82938,227,116,111,61,43,64,59
82939,1861,941,920,625,449,521,266
82941,5028,2676,2352,1378,1440,1475,735
82942,123,74,49,19,32,53,19
82943,301,158,143,73,69,106,53
82944,216,116,100,70,34,72,40
82945,351,188,163,104,69,123,55
83001,15851,8350,7501,3294,5925,4439,2193
83011,240,116,124,57,71,74,38
83012,180,89,91,39,40,83,18
83013,395,217,178,63,93,138,101
83014,3595,1856,1739,707,992,1140,756
83025,400,218,182,48,133,109,110
83101,3104,1623,1481,835,787,957,525
83110,4307,2154,2153,1541,945,1059,762
83111,465,230,235,153,109,119,84
83112,666,331,335,210,113,216,127
83113,3278,1835,1443,837,927,1031,483
83114,828,431,397,343,175,172,138
83115,830,437,393,201,190,268,171
83116,728,361,367,170,177,215,166
83118,1139,578,561,359,274,363,143
83119,172,86,86,55,29,46,42
83120,359,191,168,117,91,99,52
83121,14,7,7,3,3,3,5
83122,494,256,238,178,125,124,67
83123,711,382,329,197,164,236,114
83124,137,78,59,36,22,60,19
83126,334,181,153,105,62,89,78
83127,3041,1564,1477,807,677,774,783
83128,1601,846,755,354,464,574,209
83414,544,288,256,171,80,178,115
